COUNTY,DATE STAMP,FEMALE,MALE,SEX UNKNOWN,SUM CASES
NON-GEORGIA RESIDENT,4/16/2020,220,222,69,511
NON-GEORGIA RESIDENT,4/17/2020,233,242,72,547
NON-GEORGIA RESIDENT,4/18/2020,237,246,77,560
NON-GEORGIA RESIDENT,4/19/2020,245,253,83,581
NON-GEORGIA RESIDENT,4/20/2020,254,261,91,606
NON-GEORGIA RESIDENT,4/21/2020,259,275,102,636
NON-GEORGIA RESIDENT,4/22/2020,266,282,109,657
NON-GEORGIA RESIDENT,4/23/2020,276,291,110,677
NON-GEORGIA RESIDENT,4/24/2020,287,300,122,709
NON-GEORGIA RESIDENT,4/25/2020,293,304,128,725
NON-GEORGIA RESIDENT,4/26/2020,296,309,128,733
NON-GEORGIA RESIDENT,4/27/2020,302,320,132,754
NON-GEORGIA RESIDENT,4/28/2020,310,328,134,772
NON-GEORGIA RESIDENT,4/29/2020,325,346,134,805
NON-GEORGIA RESIDENT,4/30/2020,331,356,137,824
NON-GEORGIA RESIDENT,5/1/2020,337,371,141,849
NON-GEORGIA RESIDENT,5/2/2020,342,374,141,857
NON-GEORGIA RESIDENT,5/3/2020,345,382,141,868
NON-GEORGIA RESIDENT,5/4/2020,355,514,147,1016
NON-GEORGIA RESIDENT,5/5/2020,358,519,149,1026
NON-GEORGIA RESIDENT,5/6/2020,366,527,154,1047
NON-GEORGIA RESIDENT,5/7/2020,373,532,161,1066
NON-GEORGIA RESIDENT,5/8/2020,379,542,162,1083
NON-GEORGIA RESIDENT,5/9/2020,383,545,162,1090
NON-GEORGIA RESIDENT,5/10/2020,386,553,165,1104
NON-GEORGIA RESIDENT,5/11/2020,394,647,174,1215
NON-GEORGIA RESIDENT,5/12/2020,404,656,184,1244
NON-GEORGIA RESIDENT,5/13/2020,409,662,198,1269
NON-GEORGIA RESIDENT,5/14/2020,416,669,204,1289
NON-GEORGIA RESIDENT,5/15/2020,427,685,214,1326
NON-GEORGIA RESIDENT,5/16/2020,429,694,217,1340
NON-GEORGIA RESIDENT,5/17/2020,433,695,218,1346
NON-GEORGIA RESIDENT,5/18/2020,445,703,233,1381
NON-GEORGIA RESIDENT,5/19/2020,459,722,236,1417
NON-GEORGIA RESIDENT,5/20/2020,474,733,243,1450
NON-GEORGIA RESIDENT,5/21/2020,487,744,248,1479
NON-GEORGIA RESIDENT,5/22/2020,498,765,249,1512
NON-GEORGIA RESIDENT,5/23/2020,499,772,252,1523
NON-GEORGIA RESIDENT,5/24/2020,502,785,252,1539
NON-GEORGIA RESIDENT,5/25/2020,504,788,252,1544
NON-GEORGIA RESIDENT,5/26/2020,525,806,255,1586
NON-GEORGIA RESIDENT,5/27/2020,543,821,257,1621
NON-GEORGIA RESIDENT,5/28/2020,554,834,262,1650
NON-GEORGIA RESIDENT,5/29/2020,571,853,279,1703
NON-GEORGIA RESIDENT,5/30/2020,580,859,281,1720
NON-GEORGIA RESIDENT,5/31/2020,588,864,282,1734
NON-GEORGIA RESIDENT,6/1/2020,613,891,285,1789
NON-GEORGIA RESIDENT,6/2/2020,632,910,287,1829
NON-GEORGIA RESIDENT,6/3/2020,645,926,288,1859
NON-GEORGIA RESIDENT,6/4/2020,665,937,291,1893
NON-GEORGIA RESIDENT,6/5/2020,678,951,293,1922
NON-GEORGIA RESIDENT,6/6/2020,685,957,294,1936
NON-GEORGIA RESIDENT,6/7/2020,687,968,294,1949
NON-GEORGIA RESIDENT,6/8/2020,702,995,298,1995
NON-GEORGIA RESIDENT,6/9/2020,713,1014,304,2031
NON-GEORGIA RESIDENT,6/10/2020,726,1041,304,2071
NON-GEORGIA RESIDENT,6/11/2020,743,1055,304,2102
NON-GEORGIA RESIDENT,6/12/2020,759,1071,306,2136
NON-GEORGIA RESIDENT,6/13/2020,766,1080,310,2156
NON-GEORGIA RESIDENT,6/14/2020,774,1090,310,2174
NON-GEORGIA RESIDENT,6/15/2020,791,1116,312,2219
NON-GEORGIA RESIDENT,6/16/2020,809,1145,314,2268
NON-GEORGIA RESIDENT,6/17/2020,840,1183,321,2344
NON-GEORGIA RESIDENT,6/18/2020,862,1211,324,2397
NON-GEORGIA RESIDENT,6/19/2020,885,1244,329,2458
NON-GEORGIA RESIDENT,6/20/2020,894,1264,332,2490
NON-GEORGIA RESIDENT,6/21/2020,904,1278,348,2530
NON-GEORGIA RESIDENT,6/22/2020,944,1316,350,2610
NON-GEORGIA RESIDENT,6/23/2020,988,1363,366,2717
NON-GEORGIA RESIDENT,6/24/2020,1029,1396,377,2802
NON-GEORGIA RESIDENT,6/25/2020,1088,1452,403,2943
NON-GEORGIA RESIDENT,6/26/2020,1132,1502,423,3057
NON-GEORGIA RESIDENT,6/27/2020,1168,1541,465,3174
NON-GEORGIA RESIDENT,6/28/2020,1185,1558,496,3239
NON-GEORGIA RESIDENT,6/29/2020,1266,1659,549,3474
NON-GEORGIA RESIDENT,6/30/2020,1350,1750,603,3703
NON-GEORGIA RESIDENT,7/1/2020,1432,1827,680,3939
NON-GEORGIA RESIDENT,7/2/2020,1516,1923,780,4219
NON-GEORGIA RESIDENT,7/3/2020,1568,1983,820,4371
NON-GEORGIA RESIDENT,7/4/2020,1587,2012,827,4426
NON-GEORGIA RESIDENT,7/5/2020,1612,2038,838,4488
NON-GEORGIA RESIDENT,7/6/2020,1781,2201,1024,5006
NON-GEORGIA RESIDENT,7/7/2020,1897,2311,1167,5375
NON-GEORGIA RESIDENT,7/8/2020,2013,2476,1209,5698
NON-GEORGIA RESIDENT,7/9/2020,2136,2616,1256,6008
NON-GEORGIA RESIDENT,7/10/2020,2236,2705,1285,6226
NON-GEORGIA RESIDENT,7/11/2020,2292,2765,1290,6347
NON-GEORGIA RESIDENT,7/12/2020,2328,2799,1310,6437
NON-GEORGIA RESIDENT,7/13/2020,2469,2947,1369,6785
NON-GEORGIA RESIDENT,7/14/2020,2573,3084,1399,7056
NON-GEORGIA RESIDENT,7/15/2020,2654,3173,1432,7259
NON-GEORGIA RESIDENT,7/16/2020,2762,3286,1452,7500
NON-GEORGIA RESIDENT,7/17/2020,2849,3372,1473,7694
NON-GEORGIA RESIDENT,7/18/2020,2897,3436,1476,7809
NON-GEORGIA RESIDENT,7/19/2020,2920,3461,1481,7862
NON-GEORGIA RESIDENT,7/20/2020,3025,3551,1499,8075
NON-GEORGIA RESIDENT,7/21/2020,3112,3638,1508,8258
NON-GEORGIA RESIDENT,7/22/2020,3198,3729,1525,8452
NON-GEORGIA RESIDENT,7/23/2020,3303,3835,1535,8673
NON-GEORGIA RESIDENT,7/24/2020,3394,3923,1546,8863
NON-GEORGIA RESIDENT,7/25/2020,3429,3960,1554,8943
NON-GEORGIA RESIDENT,7/26/2020,3452,3991,1562,9005
NON-GEORGIA RESIDENT,7/27/2020,3534,4070,1574,9178
NON-GEORGIA RESIDENT,7/28/2020,3615,4158,1584,9357
NON-GEORGIA RESIDENT,7/29/2020,3684,4222,1594,9500
NON-GEORGIA RESIDENT,7/30/2020,3758,4306,1607,9671
NON-GEORGIA RESIDENT,7/31/2020,3803,4364,1630,9797
NON-GEORGIA RESIDENT,8/1/2020,3832,4409,1632,9873
NON-GEORGIA RESIDENT,8/2/2020,3862,4433,1643,9938
NON-GEORGIA RESIDENT,8/3/2020,3912,4493,1648,10053
NON-GEORGIA RESIDENT,8/4/2020,3979,4543,1660,10182
NON-GEORGIA RESIDENT,8/5/2020,4053,4630,1664,10347
NON-GEORGIA RESIDENT,8/6/2020,4120,4689,1688,10497
NON-GEORGIA RESIDENT,8/7/2020,4174,4747,1697,10618
NON-GEORGIA RESIDENT,8/8/2020,4197,4771,1698,10666
NON-GEORGIA RESIDENT,8/9/2020,4212,4797,1702,10711
NON-GEORGIA RESIDENT,8/10/2020,4264,4862,1711,10837
NON-GEORGIA RESIDENT,8/11/2020,4325,4901,1715,10941
NON-GEORGIA RESIDENT,8/12/2020,4370,4941,1719,11030
NON-GEORGIA RESIDENT,8/13/2020,4415,5000,1732,11147
NON-GEORGIA RESIDENT,8/14/2020,4450,5035,1738,11223
NON-GEORGIA RESIDENT,8/15/2020,4477,5070,1739,11286
NON-GEORGIA RESIDENT,8/16/2020,4495,5087,1741,11323
NON-GEORGIA RESIDENT,8/17/2020,4525,5132,1742,11399
NON-GEORGIA RESIDENT,8/18/2020,4549,5163,1753,11465
NON-GEORGIA RESIDENT,8/19/2020,4568,5183,1759,11510
NON-GEORGIA RESIDENT,8/20/2020,4595,5218,1762,11575
NON-GEORGIA RESIDENT,8/21/2020,4628,5248,1770,11646
NON-GEORGIA RESIDENT,8/22/2020,4640,5266,1773,11679
NON-GEORGIA RESIDENT,8/23/2020,4651,5279,1773,11703
NON-GEORGIA RESIDENT,8/24/2020,4687,5318,1789,11794
NON-GEORGIA RESIDENT,8/25/2020,4714,5349,1804,11867
NON-GEORGIA RESIDENT,8/26/2020,4740,5377,1814,11931
NON-GEORGIA RESIDENT,8/27/2020,4771,5399,1818,11988
NON-GEORGIA RESIDENT,8/28/2020,4800,5432,1825,12057
NON-GEORGIA RESIDENT,8/29/2020,4817,5448,1825,12090
NON-GEORGIA RESIDENT,8/30/2020,4838,5463,1825,12126
NON-GEORGIA RESIDENT,8/31/2020,4874,5495,1835,12204
NON-GEORGIA RESIDENT,9/1/2020,4914,5517,1841,12272
NON-GEORGIA RESIDENT,9/2/2020,4944,5547,1847,12338
NON-GEORGIA RESIDENT,9/3/2020,4964,5573,1861,12398
NON-GEORGIA RESIDENT,9/4/2020,4991,5598,1866,12455
NON-GEORGIA RESIDENT,9/5/2020,5002,5615,1869,12486
NON-GEORGIA RESIDENT,9/6/2020,5015,5628,1872,12515
NON-GEORGIA RESIDENT,9/7/2020,5033,5639,1873,12545
NON-GEORGIA RESIDENT,9/8/2020,5056,5673,1882,12611
NON-GEORGIA RESIDENT,9/9/2020,5076,5696,1886,12658
NON-GEORGIA RESIDENT,9/10/2020,5096,5710,1889,12695
NON-GEORGIA RESIDENT,9/11/2020,5117,5723,1898,12738
NON-GEORGIA RESIDENT,9/12/2020,5130,5732,1898,12760
NON-GEORGIA RESIDENT,9/13/2020,5144,5748,1899,12791
NON-GEORGIA RESIDENT,9/14/2020,5161,5781,1905,12847
NON-GEORGIA RESIDENT,9/15/2020,5179,5803,1908,12890
NON-GEORGIA RESIDENT,9/16/2020,5203,5824,1909,12936
NON-GEORGIA RESIDENT,9/17/2020,5221,5838,1910,12969
NON-GEORGIA RESIDENT,9/18/2020,5240,5856,1912,13008
NON-GEORGIA RESIDENT,9/19/2020,5255,5877,1914,13046
NON-GEORGIA RESIDENT,9/20/2020,5265,5889,1916,13070
NON-GEORGIA RESIDENT,9/21/2020,5295,5911,1920,13126
NON-GEORGIA RESIDENT,9/22/2020,5311,5925,1921,13157
NON-GEORGIA RESIDENT,9/23/2020,5336,5940,1923,13199
NON-GEORGIA RESIDENT,9/24/2020,5354,5958,1923,13235
NON-GEORGIA RESIDENT,9/25/2020,5374,5969,1924,13267
NON-GEORGIA RESIDENT,9/26/2020,5386,5989,1924,13299
NON-GEORGIA RESIDENT,9/27/2020,5391,5994,1926,13311
NON-GEORGIA RESIDENT,9/28/2020,5407,6032,1928,13367
NON-GEORGIA RESIDENT,9/29/2020,5429,6050,1929,13408
NON-GEORGIA RESIDENT,9/30/2020,5465,6080,1931,13476
NON-GEORGIA RESIDENT,10/1/2020,5494,6101,1932,13527
NON-GEORGIA RESIDENT,10/2/2020,5514,6124,1934,13572
NON-GEORGIA RESIDENT,10/3/2020,5527,6142,1934,13603
NON-GEORGIA RESIDENT,10/4/2020,5538,6150,1935,13623
NON-GEORGIA RESIDENT,10/5/2020,5564,6178,1938,13680
NON-GEORGIA RESIDENT,10/6/2020,5592,6202,1938,13732
NON-GEORGIA RESIDENT,10/7/2020,5615,6225,1941,13781
NON-GEORGIA RESIDENT,10/8/2020,5647,6251,1943,13841
NON-GEORGIA RESIDENT,10/9/2020,5665,6271,1946,13882
NON-GEORGIA RESIDENT,10/10/2020,5676,6284,1947,13907
NON-GEORGIA RESIDENT,10/11/2020,5681,6295,1947,13923
NON-GEORGIA RESIDENT,10/12/2020,5699,6315,1950,13964
NON-GEORGIA RESIDENT,10/13/2020,5732,6336,1952,14020
NON-GEORGIA RESIDENT,10/14/2020,5768,6371,1955,14094
NON-GEORGIA RESIDENT,10/15/2020,5791,6421,1956,14168
NON-GEORGIA RESIDENT,10/16/2020,5823,6456,1957,14236
NON-GEORGIA RESIDENT,10/17/2020,5841,6470,1957,14268
NON-GEORGIA RESIDENT,10/18/2020,5843,6475,1960,14278
NON-GEORGIA RESIDENT,10/19/2020,5847,6479,1961,14287
NON-GEORGIA RESIDENT,10/20/2020,5848,6479,1961,14288
BALDWIN,1/1/2020,0,0,0,0
BALDWIN,1/2/2020,0,0,0,0
BALDWIN,1/3/2020,0,0,0,0
BALDWIN,1/4/2020,0,0,0,0
BALDWIN,1/5/2020,0,0,0,0
BALDWIN,1/6/2020,0,0,0,0
BALDWIN,1/7/2020,0,0,0,0
BALDWIN,1/8/2020,0,0,0,0
BALDWIN,1/9/2020,0,0,0,0
BALDWIN,1/10/2020,0,0,0,0
BALDWIN,1/11/2020,0,0,0,0
BALDWIN,1/12/2020,0,0,0,0
BALDWIN,1/13/2020,0,0,0,0
BALDWIN,1/14/2020,0,0,0,0
BALDWIN,1/15/2020,0,0,0,0
BALDWIN,1/16/2020,0,0,0,0
BALDWIN,1/17/2020,0,0,0,0
BALDWIN,1/18/2020,0,0,0,0
BALDWIN,1/19/2020,0,0,0,0
BALDWIN,1/20/2020,0,0,0,0
BALDWIN,1/21/2020,0,0,0,0
BALDWIN,1/22/2020,0,0,0,0
BALDWIN,1/23/2020,0,0,0,0
BALDWIN,1/24/2020,0,0,0,0
BALDWIN,1/25/2020,0,0,0,0
BALDWIN,1/26/2020,0,0,0,0
BALDWIN,1/27/2020,0,0,0,0
BALDWIN,1/28/2020,0,0,0,0
BALDWIN,1/29/2020,0,0,0,0
BALDWIN,1/30/2020,0,0,0,0
BALDWIN,1/31/2020,0,0,0,0
BALDWIN,2/1/2020,0,0,0,0
BALDWIN,2/2/2020,0,0,0,0
BALDWIN,2/3/2020,0,0,0,0
BALDWIN,2/4/2020,0,0,0,0
BALDWIN,2/5/2020,0,0,0,0
BALDWIN,2/6/2020,0,0,0,0
BALDWIN,2/7/2020,0,0,0,0
BALDWIN,2/8/2020,0,0,0,0
BALDWIN,2/9/2020,0,0,0,0
BALDWIN,2/10/2020,0,0,0,0
BALDWIN,2/11/2020,0,0,0,0
BALDWIN,2/12/2020,0,0,0,0
BALDWIN,2/13/2020,0,0,0,0
BALDWIN,2/14/2020,0,0,0,0
BALDWIN,2/15/2020,0,0,0,0
BALDWIN,2/16/2020,0,0,0,0
BALDWIN,2/17/2020,0,0,0,0
BALDWIN,2/18/2020,0,0,0,0
BALDWIN,2/19/2020,0,0,0,0
BALDWIN,2/20/2020,0,0,0,0
BALDWIN,2/21/2020,0,0,0,0
BALDWIN,2/22/2020,0,0,0,0
BALDWIN,2/23/2020,0,0,0,0
BALDWIN,2/24/2020,0,0,0,0
BALDWIN,2/25/2020,0,0,0,0
BALDWIN,2/26/2020,0,0,0,0
BALDWIN,2/27/2020,0,0,0,0
BALDWIN,2/28/2020,0,0,0,0
BALDWIN,2/29/2020,0,0,0,0
BALDWIN,3/1/2020,0,0,0,0
BALDWIN,3/2/2020,0,0,0,0
BALDWIN,3/3/2020,1,0,0,1
BALDWIN,3/4/2020,2,0,0,2
BALDWIN,3/5/2020,2,0,0,2
BALDWIN,3/6/2020,2,0,0,2
BALDWIN,3/7/2020,2,0,0,2
BALDWIN,3/8/2020,3,0,0,3
BALDWIN,3/9/2020,3,1,0,4
BALDWIN,3/10/2020,3,1,0,4
BALDWIN,3/11/2020,3,1,0,4
BALDWIN,3/12/2020,3,1,0,4
BALDWIN,3/13/2020,3,2,0,5
BALDWIN,3/14/2020,3,2,0,5
BALDWIN,3/15/2020,3,2,0,5
BALDWIN,3/16/2020,3,2,0,5
BALDWIN,3/17/2020,3,3,0,6
BALDWIN,3/18/2020,3,3,0,6
BALDWIN,3/19/2020,3,3,0,6
BALDWIN,3/20/2020,4,5,0,9
BALDWIN,3/21/2020,4,5,0,9
BALDWIN,3/22/2020,5,6,0,11
BALDWIN,3/23/2020,7,6,0,13
BALDWIN,3/24/2020,7,6,0,13
BALDWIN,3/25/2020,8,6,0,14
BALDWIN,3/26/2020,8,6,0,14
BALDWIN,3/27/2020,9,6,0,15
BALDWIN,3/28/2020,10,8,0,18
BALDWIN,3/29/2020,12,9,0,21
BALDWIN,3/30/2020,12,11,0,23
BALDWIN,3/31/2020,14,13,0,27
BALDWIN,4/1/2020,18,16,0,34
BALDWIN,4/2/2020,20,17,0,37
BALDWIN,4/3/2020,22,17,1,40
BALDWIN,4/4/2020,24,19,2,45
BALDWIN,4/5/2020,26,19,2,47
BALDWIN,4/6/2020,29,21,2,52
BALDWIN,4/7/2020,34,26,2,62
BALDWIN,4/8/2020,38,30,2,70
BALDWIN,4/9/2020,39,36,2,77
BALDWIN,4/10/2020,44,53,2,99
BALDWIN,4/11/2020,46,58,2,106
BALDWIN,4/12/2020,47,60,2,109
BALDWIN,4/13/2020,51,61,2,114
BALDWIN,4/14/2020,58,71,2,131
BALDWIN,4/15/2020,61,85,2,148
BALDWIN,4/16/2020,68,97,3,168
BALDWIN,4/17/2020,69,103,3,175
BALDWIN,4/18/2020,69,104,3,176
BALDWIN,4/19/2020,69,105,3,177
BALDWIN,4/20/2020,75,109,3,187
BALDWIN,4/21/2020,79,124,3,206
BALDWIN,4/22/2020,88,125,4,217
BALDWIN,4/23/2020,91,128,4,223
BALDWIN,4/24/2020,93,131,5,229
BALDWIN,4/25/2020,96,133,5,234
BALDWIN,4/26/2020,98,134,6,238
BALDWIN,4/27/2020,100,137,6,243
BALDWIN,4/28/2020,101,141,6,248
BALDWIN,4/29/2020,102,144,6,252
BALDWIN,4/30/2020,103,147,6,256
BALDWIN,5/1/2020,106,147,6,259
BALDWIN,5/2/2020,107,148,6,261
BALDWIN,5/3/2020,109,148,6,263
BALDWIN,5/4/2020,110,157,6,273
BALDWIN,5/5/2020,110,160,6,276
BALDWIN,5/6/2020,110,162,6,278
BALDWIN,5/7/2020,111,163,6,280
BALDWIN,5/8/2020,112,165,6,283
BALDWIN,5/9/2020,112,168,6,286
BALDWIN,5/10/2020,112,171,6,289
BALDWIN,5/11/2020,114,171,6,291
BALDWIN,5/12/2020,114,172,6,292
BALDWIN,5/13/2020,116,179,6,301
BALDWIN,5/14/2020,117,182,6,305
BALDWIN,5/15/2020,127,183,6,316
BALDWIN,5/16/2020,129,183,6,318
BALDWIN,5/17/2020,131,186,6,323
BALDWIN,5/18/2020,134,193,7,334
BALDWIN,5/19/2020,134,195,7,336
BALDWIN,5/20/2020,136,198,7,341
BALDWIN,5/21/2020,137,199,7,343
BALDWIN,5/22/2020,138,203,7,348
BALDWIN,5/23/2020,139,203,7,349
BALDWIN,5/24/2020,139,203,7,349
BALDWIN,5/25/2020,139,203,7,349
BALDWIN,5/26/2020,147,207,7,361
BALDWIN,5/27/2020,147,208,7,362
BALDWIN,5/28/2020,148,208,7,363
BALDWIN,5/29/2020,151,209,9,369
BALDWIN,5/30/2020,151,210,9,370
BALDWIN,5/31/2020,152,214,9,375
BALDWIN,6/1/2020,153,216,9,378
BALDWIN,6/2/2020,154,219,9,382
BALDWIN,6/3/2020,156,221,9,386
BALDWIN,6/4/2020,157,221,9,387
BALDWIN,6/5/2020,160,231,9,400
BALDWIN,6/6/2020,160,231,9,400
BALDWIN,6/7/2020,162,231,9,402
BALDWIN,6/8/2020,167,233,9,409
BALDWIN,6/9/2020,168,236,9,413
BALDWIN,6/10/2020,170,245,11,426
BALDWIN,6/11/2020,174,245,11,430
BALDWIN,6/12/2020,175,247,11,433
BALDWIN,6/13/2020,175,248,11,434
BALDWIN,6/14/2020,177,249,11,437
BALDWIN,6/15/2020,179,253,11,443
BALDWIN,6/16/2020,181,259,11,451
BALDWIN,6/17/2020,185,266,11,462
BALDWIN,6/18/2020,187,269,11,467
BALDWIN,6/19/2020,192,273,11,476
BALDWIN,6/20/2020,193,276,11,480
BALDWIN,6/21/2020,196,280,11,487
BALDWIN,6/22/2020,200,285,11,496
BALDWIN,6/23/2020,206,288,11,505
BALDWIN,6/24/2020,209,293,11,513
BALDWIN,6/25/2020,214,297,11,522
BALDWIN,6/26/2020,231,308,14,553
BALDWIN,6/27/2020,231,310,14,555
BALDWIN,6/28/2020,234,313,14,561
BALDWIN,6/29/2020,242,337,14,593
BALDWIN,6/30/2020,247,341,14,602
BALDWIN,7/1/2020,256,343,14,613
BALDWIN,7/2/2020,261,347,14,622
BALDWIN,7/3/2020,269,351,14,634
BALDWIN,7/4/2020,272,355,14,641
BALDWIN,7/5/2020,276,364,14,654
BALDWIN,7/6/2020,283,375,14,672
BALDWIN,7/7/2020,298,387,14,699
BALDWIN,7/8/2020,310,396,14,720
BALDWIN,7/9/2020,316,400,14,730
BALDWIN,7/10/2020,324,411,14,749
BALDWIN,7/11/2020,332,414,14,760
BALDWIN,7/12/2020,337,419,14,770
BALDWIN,7/13/2020,346,432,14,792
BALDWIN,7/14/2020,352,442,15,809
BALDWIN,7/15/2020,358,446,15,819
BALDWIN,7/16/2020,366,459,15,840
BALDWIN,7/17/2020,376,466,15,857
BALDWIN,7/18/2020,380,468,15,863
BALDWIN,7/19/2020,391,470,15,876
BALDWIN,7/20/2020,407,479,15,901
BALDWIN,7/21/2020,414,486,15,915
BALDWIN,7/22/2020,423,493,15,931
BALDWIN,7/23/2020,435,499,16,950
BALDWIN,7/24/2020,442,505,16,963
BALDWIN,7/25/2020,456,509,16,981
BALDWIN,7/26/2020,463,514,16,993
BALDWIN,7/27/2020,474,523,16,1013
BALDWIN,7/28/2020,483,526,16,1025
BALDWIN,7/29/2020,494,531,17,1042
BALDWIN,7/30/2020,503,537,17,1057
BALDWIN,7/31/2020,509,546,17,1072
CLARKE,1/25/2020,0,0,0,0
BALDWIN,8/1/2020,514,553,17,1084
CLARKE,1/26/2020,0,0,0,0
BALDWIN,8/2/2020,524,561,17,1102
CLARKE,1/27/2020,0,0,0,0
BALDWIN,8/3/2020,538,572,17,1127
CLARKE,1/28/2020,0,0,0,0
BALDWIN,8/4/2020,543,578,17,1138
CLARKE,1/29/2020,0,0,0,0
UNKNOWN,1/11/2020,0,0,0,0
BALDWIN,8/5/2020,549,584,17,1150
CLARKE,1/30/2020,0,0,0,0
UNKNOWN,1/12/2020,0,0,0,0
BALDWIN,8/6/2020,559,591,17,1167
CLARKE,1/31/2020,0,0,0,0
UNKNOWN,1/13/2020,0,0,0,0
BALDWIN,8/7/2020,567,596,17,1180
CLARKE,2/1/2020,0,0,0,0
UNKNOWN,1/14/2020,0,0,0,0
BALDWIN,8/8/2020,573,598,17,1188
CLARKE,2/2/2020,0,0,0,0
CLARKE,2/3/2020,0,0,0,0
CLARKE,2/4/2020,0,0,0,0
CLARKE,2/5/2020,0,0,0,0
CLARKE,2/6/2020,0,0,0,0
CLARKE,2/7/2020,0,0,0,0
CLARKE,2/8/2020,0,0,0,0
CLARKE,2/9/2020,0,0,0,0
CLARKE,2/10/2020,0,0,0,0
CLARKE,2/11/2020,0,0,0,0
CLARKE,2/12/2020,0,0,0,0
CLARKE,2/13/2020,0,0,0,0
CLARKE,2/14/2020,0,0,0,0
CLARKE,2/15/2020,0,0,0,0
CLARKE,2/16/2020,0,0,0,0
CLARKE,2/17/2020,0,0,0,0
CLARKE,2/18/2020,0,0,0,0
CLARKE,2/19/2020,0,0,0,0
CLARKE,2/20/2020,0,0,0,0
CLARKE,2/21/2020,0,0,0,0
CLARKE,2/22/2020,0,0,0,0
CLARKE,2/23/2020,0,0,0,0
CLARKE,2/24/2020,0,0,0,0
CLARKE,2/25/2020,1,0,0,1
CLARKE,2/26/2020,1,1,0,2
CLARKE,2/27/2020,1,1,0,2
CLARKE,2/28/2020,1,1,0,2
CLARKE,2/29/2020,1,2,0,3
CLARKE,3/1/2020,1,3,0,4
CLARKE,3/2/2020,1,3,0,4
CLARKE,3/3/2020,2,3,0,5
CLARKE,3/4/2020,2,3,0,5
CLARKE,3/5/2020,2,3,0,5
CLARKE,3/6/2020,2,3,0,5
CLARKE,3/7/2020,2,3,0,5
CLARKE,3/8/2020,2,3,0,5
CLARKE,3/9/2020,2,3,0,5
CLARKE,3/10/2020,6,5,0,11
CLARKE,3/11/2020,6,5,0,11
CLARKE,3/12/2020,8,6,0,14
CLARKE,3/13/2020,9,7,0,16
CLARKE,3/14/2020,13,8,0,21
CLARKE,3/15/2020,17,11,0,28
CLARKE,3/16/2020,21,15,0,36
CLARKE,3/17/2020,24,16,0,40
CLARKE,3/18/2020,27,19,0,46
CLARKE,3/19/2020,28,20,0,48
CLARKE,3/20/2020,29,24,0,53
CLARKE,3/21/2020,30,24,0,54
CLARKE,3/22/2020,32,24,0,56
CLARKE,3/23/2020,35,24,0,59
CLARKE,3/24/2020,39,25,0,64
CLARKE,3/25/2020,42,26,0,68
CLARKE,3/26/2020,44,28,0,72
CLARKE,3/27/2020,44,29,0,73
CLARKE,3/28/2020,44,30,0,74
CLARKE,3/29/2020,45,30,0,75
CLARKE,3/30/2020,45,33,0,78
CLARKE,3/31/2020,47,34,0,81
CLARKE,4/1/2020,51,37,0,88
CLARKE,4/2/2020,51,38,0,89
CLARKE,4/3/2020,53,38,0,91
CLARKE,4/4/2020,55,39,0,94
CLARKE,4/5/2020,57,39,0,96
CLARKE,4/6/2020,59,42,0,101
CLARKE,4/7/2020,60,43,0,103
CLARKE,4/8/2020,60,44,0,104
CLARKE,4/9/2020,62,45,0,107
CLARKE,4/10/2020,64,46,0,110
CLARKE,4/11/2020,65,48,0,113
CLARKE,4/12/2020,67,48,0,115
CLARKE,4/13/2020,70,48,0,118
CLARKE,4/14/2020,72,48,0,120
CLARKE,4/15/2020,74,51,0,125
CLARKE,4/16/2020,74,51,0,125
CLARKE,4/17/2020,79,53,0,132
CLARKE,4/18/2020,81,54,0,135
CLARKE,4/19/2020,82,54,0,136
CLARKE,4/20/2020,86,54,1,141
CLARKE,4/21/2020,90,56,1,147
CLARKE,4/22/2020,94,59,1,154
CLARKE,4/23/2020,97,60,1,158
CLARKE,4/24/2020,98,61,1,160
CLARKE,4/25/2020,102,62,1,165
CLARKE,4/26/2020,103,62,1,166
CLARKE,4/27/2020,107,63,1,171
CLARKE,4/28/2020,109,71,1,181
CLARKE,4/29/2020,111,71,1,183
CLARKE,4/30/2020,113,73,1,187
CLARKE,5/1/2020,113,73,1,187
CLARKE,5/2/2020,116,74,1,191
CLARKE,5/3/2020,118,75,1,194
CLARKE,5/4/2020,120,75,1,196
CLARKE,5/5/2020,120,76,1,197
CLARKE,5/6/2020,120,77,1,198
CLARKE,5/7/2020,122,77,1,200
CLARKE,5/8/2020,125,77,1,203
CLARKE,5/9/2020,128,78,1,207
CLARKE,5/10/2020,128,79,1,208
CLARKE,5/11/2020,130,80,1,211
CLARKE,5/12/2020,131,82,1,214
CLARKE,5/13/2020,134,84,1,219
CLARKE,5/14/2020,139,86,1,226
CLARKE,5/15/2020,141,88,2,231
CLARKE,5/16/2020,142,90,2,234
CLARKE,5/17/2020,142,94,2,238
CLARKE,5/18/2020,144,94,2,240
CLARKE,5/19/2020,145,98,2,245
CLARKE,5/20/2020,149,98,2,249
CLARKE,5/21/2020,155,101,2,258
CLARKE,5/22/2020,157,106,2,265
CLARKE,5/23/2020,163,107,2,272
CLARKE,5/24/2020,164,108,2,274
CLARKE,5/25/2020,165,112,2,279
CLARKE,5/26/2020,173,120,2,295
CLARKE,5/27/2020,175,121,2,298
CLARKE,5/28/2020,176,123,2,301
CLARKE,5/29/2020,178,126,2,306
CLARKE,5/30/2020,181,128,2,311
CLARKE,5/31/2020,183,130,2,315
CLARKE,6/1/2020,188,133,2,323
CLARKE,6/2/2020,192,136,2,330
CLARKE,6/3/2020,195,137,2,334
CLARKE,6/4/2020,195,138,3,336
CLARKE,6/5/2020,197,145,3,345
CLARKE,6/6/2020,197,148,3,348
CLARKE,6/7/2020,197,151,3,351
CLARKE,6/8/2020,198,153,3,354
CLARKE,6/9/2020,199,156,3,358
CLARKE,6/10/2020,206,158,3,367
CLARKE,6/11/2020,210,159,3,372
CLARKE,6/12/2020,213,162,3,378
CLARKE,6/13/2020,216,164,3,383
CLARKE,6/14/2020,222,167,3,392
CLARKE,6/15/2020,236,174,3,413
CLARKE,6/16/2020,242,181,3,426
CLARKE,6/17/2020,250,189,3,442
CLARKE,6/18/2020,254,195,4,453
CLARKE,6/19/2020,262,205,4,471
CLARKE,6/20/2020,274,214,4,492
CLARKE,6/21/2020,282,221,4,507
CLARKE,6/22/2020,304,243,4,551
CLARKE,6/23/2020,323,266,4,593
CLARKE,6/24/2020,340,291,5,636
CLARKE,6/25/2020,358,318,5,681
CLARKE,6/26/2020,376,331,5,712
CLARKE,6/27/2020,390,344,5,739
CLARKE,6/28/2020,400,351,5,756
CLARKE,6/29/2020,423,370,6,799
CLARKE,6/30/2020,448,396,6,850
CLARKE,7/1/2020,480,422,9,911
CLARKE,7/2/2020,500,444,9,953
CLARKE,7/3/2020,525,452,9,986
CLARKE,7/4/2020,537,458,10,1005
CLARKE,7/5/2020,551,461,10,1022
CLARKE,7/6/2020,580,487,10,1077
CLARKE,7/7/2020,612,520,11,1143
CLARKE,7/8/2020,639,537,11,1187
CLARKE,7/9/2020,666,561,12,1239
CLARKE,7/10/2020,694,587,13,1294
CLARKE,7/11/2020,711,600,13,1324
CLARKE,7/12/2020,722,604,13,1339
CLARKE,7/13/2020,739,624,14,1377
CLARKE,7/14/2020,768,651,14,1433
CLARKE,7/15/2020,791,675,15,1481
CLARKE,7/16/2020,823,695,16,1534
CLARKE,7/17/2020,847,714,16,1577
CLARKE,7/18/2020,858,725,17,1600
CLARKE,7/19/2020,871,735,17,1623
CLARKE,7/20/2020,896,754,17,1667
CLARKE,7/21/2020,915,767,19,1701
CLARKE,7/22/2020,944,778,21,1743
CLARKE,7/23/2020,964,802,27,1793
CLARKE,7/24/2020,979,817,29,1825
CLARKE,7/25/2020,992,829,29,1850
CLARKE,7/26/2020,1002,843,29,1874
CLARKE,7/27/2020,1021,857,31,1909
CLARKE,7/28/2020,1042,874,31,1947
CLARKE,7/29/2020,1061,890,31,1982
CLARKE,7/30/2020,1070,906,31,2007
CLARKE,7/31/2020,1089,923,34,2046
CLARKE,8/1/2020,1106,936,34,2076
CLARKE,8/2/2020,1116,941,34,2091
CLARKE,8/3/2020,1144,966,34,2144
CLARKE,8/4/2020,1164,983,34,2181
CLARKE,8/5/2020,1176,995,35,2206
CLARKE,8/6/2020,1191,1014,35,2240
CLARKE,8/7/2020,1205,1028,35,2268
CLARKE,8/8/2020,1215,1034,35,2284
CLARKE,8/9/2020,1223,1043,35,2301
CLARKE,8/10/2020,1234,1064,35,2333
CLARKE,8/11/2020,1250,1079,36,2365
CLARKE,8/12/2020,1261,1097,36,2394
CLARKE,8/13/2020,1279,1108,37,2424
CLARKE,8/14/2020,1291,1121,38,2450
CLARKE,8/15/2020,1303,1129,39,2471
CLARKE,8/16/2020,1311,1138,39,2488
CLARKE,8/17/2020,1342,1166,39,2547
CLARKE,8/18/2020,1367,1188,42,2597
CLARKE,8/19/2020,1385,1209,42,2636
CLARKE,8/20/2020,1413,1226,43,2682
CLARKE,8/21/2020,1446,1253,43,2742
CLARKE,8/22/2020,1468,1273,43,2784
CLARKE,8/23/2020,1486,1296,43,2825
CLARKE,8/24/2020,1531,1332,43,2906
CLARKE,8/25/2020,1581,1359,43,2983
CLARKE,8/26/2020,1653,1401,43,3097
CLARKE,8/27/2020,1727,1449,43,3219
CLARKE,8/28/2020,1852,1506,44,3402
CLARKE,8/29/2020,1894,1535,45,3474
CLARKE,8/30/2020,1958,1578,45,3581
CLARKE,8/31/2020,2096,1667,45,3808
CLARKE,9/1/2020,2224,1750,45,4019
CLARKE,9/2/2020,2332,1812,46,4190
CLARKE,9/3/2020,2404,1876,46,4326
CLARKE,9/4/2020,2460,1920,47,4427
CLARKE,9/5/2020,2485,1938,47,4470
CLARKE,9/6/2020,2515,1960,47,4522
CLARKE,9/7/2020,2539,1991,47,4577
CLARKE,9/8/2020,2589,2043,47,4679
CLARKE,9/9/2020,2626,2085,47,4758
CLARKE,9/10/2020,2659,2117,47,4823
CLARKE,9/11/2020,2676,2152,47,4875
CLARKE,9/12/2020,2693,2169,47,4909
CLARKE,9/13/2020,2701,2180,47,4928
CLARKE,9/14/2020,2719,2199,47,4965
CLARKE,9/15/2020,2739,2222,47,5008
CLARKE,9/16/2020,2754,2234,47,5035
CLARKE,9/17/2020,2765,2246,47,5058
CLARKE,9/18/2020,2775,2255,47,5077
CLARKE,9/19/2020,2780,2262,47,5089
CLARKE,9/20/2020,2785,2266,47,5098
CLARKE,9/21/2020,2796,2282,47,5125
CLARKE,9/22/2020,2801,2291,47,5139
CLARKE,9/23/2020,2818,2299,47,5164
CLARKE,9/24/2020,2829,2303,47,5179
CLARKE,9/25/2020,2834,2306,47,5187
CLARKE,9/26/2020,2842,2310,47,5199
CLARKE,9/27/2020,2849,2318,47,5214
CLARKE,9/28/2020,2863,2325,47,5235
CLARKE,9/29/2020,2872,2332,47,5251
CLARKE,9/30/2020,2884,2343,47,5274
CLARKE,10/1/2020,2896,2350,47,5293
CLARKE,10/2/2020,2906,2353,47,5306
CLARKE,10/3/2020,2911,2361,47,5319
CLARKE,10/4/2020,2919,2366,47,5332
CLARKE,10/5/2020,2941,2382,47,5370
CLARKE,10/6/2020,2951,2402,47,5400
CLARKE,10/7/2020,2963,2418,47,5428
CLARKE,10/8/2020,2978,2427,47,5452
CLARKE,10/9/2020,2985,2439,47,5471
CLARKE,10/10/2020,2991,2444,47,5482
CLARKE,10/11/2020,2999,2451,47,5497
CLARKE,10/12/2020,3010,2458,47,5515
CLARKE,10/13/2020,3017,2473,47,5537
CLARKE,10/14/2020,3028,2477,47,5552
CLARKE,10/15/2020,3035,2480,47,5562
CLARKE,10/16/2020,3037,2481,47,5565
CLARKE,10/17/2020,3039,2481,47,5567
CLARKE,10/18/2020,3039,2481,47,5567
CLARKE,10/19/2020,3041,2481,47,5569
CLARKE,10/20/2020,3041,2481,47,5569
COFFEE,1/1/2020,0,0,0,0
COFFEE,1/2/2020,0,0,0,0
COFFEE,1/3/2020,0,0,0,0
COFFEE,1/4/2020,0,0,0,0
COFFEE,1/5/2020,0,0,0,0
COFFEE,1/6/2020,0,0,0,0
COFFEE,1/7/2020,0,0,0,0
COFFEE,1/8/2020,0,0,0,0
COFFEE,1/9/2020,0,0,0,0
COFFEE,1/10/2020,0,0,0,0
COFFEE,1/11/2020,0,0,0,0
COFFEE,1/12/2020,0,0,0,0
COFFEE,1/13/2020,0,0,0,0
COFFEE,1/14/2020,0,0,0,0
COFFEE,1/15/2020,0,0,0,0
COFFEE,1/16/2020,0,0,0,0
COFFEE,1/17/2020,0,0,0,0
COFFEE,1/18/2020,0,0,0,0
COFFEE,1/19/2020,0,0,0,0
COFFEE,1/20/2020,0,0,0,0
COFFEE,1/21/2020,0,0,0,0
COFFEE,1/22/2020,0,0,0,0
COFFEE,1/23/2020,0,0,0,0
COFFEE,1/24/2020,0,0,0,0
COFFEE,1/25/2020,0,0,0,0
COFFEE,1/26/2020,0,0,0,0
COFFEE,1/27/2020,0,0,0,0
COFFEE,1/28/2020,0,0,0,0
COFFEE,1/29/2020,0,0,0,0
COFFEE,1/30/2020,0,0,0,0
COFFEE,1/31/2020,0,0,0,0
COFFEE,2/1/2020,0,0,0,0
COFFEE,2/2/2020,0,0,0,0
COFFEE,2/3/2020,0,0,0,0
COFFEE,2/4/2020,0,0,0,0
COFFEE,2/5/2020,0,0,0,0
COFFEE,2/6/2020,0,0,0,0
COFFEE,2/7/2020,0,0,0,0
COFFEE,2/8/2020,0,0,0,0
COFFEE,2/9/2020,0,0,0,0
COFFEE,2/10/2020,0,0,0,0
COFFEE,2/11/2020,0,0,0,0
COFFEE,2/12/2020,0,0,0,0
COFFEE,2/13/2020,0,0,0,0
COFFEE,2/14/2020,0,0,0,0
COFFEE,2/15/2020,0,0,0,0
COFFEE,2/16/2020,0,0,0,0
COFFEE,2/17/2020,0,0,0,0
COFFEE,2/18/2020,0,0,0,0
COFFEE,2/19/2020,0,0,0,0
COFFEE,2/20/2020,0,0,0,0
COFFEE,2/21/2020,0,0,0,0
COFFEE,2/22/2020,0,0,0,0
COFFEE,2/23/2020,0,0,0,0
COFFEE,2/24/2020,0,0,0,0
COFFEE,2/25/2020,1,0,0,1
COFFEE,2/26/2020,1,0,0,1
COFFEE,2/27/2020,1,0,0,1
COFFEE,2/28/2020,1,0,0,1
COFFEE,2/29/2020,1,0,0,1
COFFEE,3/1/2020,2,0,0,2
COFFEE,3/2/2020,2,0,0,2
COFFEE,3/3/2020,2,0,0,2
COFFEE,3/4/2020,2,0,0,2
COFFEE,3/5/2020,2,0,0,2
COFFEE,3/6/2020,2,0,0,2
COFFEE,3/7/2020,2,0,0,2
COFFEE,3/8/2020,2,0,0,2
COFFEE,3/9/2020,2,0,0,2
COFFEE,3/10/2020,2,0,0,2
COFFEE,3/11/2020,3,0,0,3
COFFEE,3/12/2020,3,0,0,3
COFFEE,3/13/2020,4,0,0,4
COFFEE,3/14/2020,4,0,0,4
COFFEE,3/15/2020,5,0,0,5
COFFEE,3/16/2020,5,0,0,5
COFFEE,3/17/2020,5,1,0,6
COFFEE,3/18/2020,5,2,0,7
COFFEE,3/19/2020,5,2,0,7
COFFEE,3/20/2020,6,2,0,8
COFFEE,3/21/2020,7,4,0,11
COFFEE,3/22/2020,10,5,0,15
COFFEE,3/23/2020,17,5,0,22
COFFEE,3/24/2020,21,9,0,30
COFFEE,3/25/2020,21,11,0,32
COFFEE,3/26/2020,24,14,0,38
COFFEE,3/27/2020,24,14,0,38
COFFEE,3/28/2020,28,15,0,43
COFFEE,3/29/2020,30,15,0,45
COFFEE,3/30/2020,31,15,0,46
COFFEE,3/31/2020,34,17,0,51
COFFEE,4/1/2020,40,17,0,57
COFFEE,4/2/2020,42,20,0,62
COFFEE,4/3/2020,44,21,0,65
COFFEE,4/4/2020,46,22,0,68
COFFEE,4/5/2020,47,22,0,69
COFFEE,4/6/2020,49,24,0,73
COFFEE,4/7/2020,50,28,0,78
COFFEE,4/8/2020,53,28,0,81
COFFEE,4/9/2020,55,28,0,83
COFFEE,4/10/2020,56,29,0,85
COFFEE,4/11/2020,57,29,0,86
COFFEE,4/12/2020,57,31,0,88
COFFEE,4/13/2020,59,32,0,91
COFFEE,4/14/2020,61,32,0,93
COFFEE,4/15/2020,62,34,0,96
COFFEE,4/16/2020,66,35,0,101
COFFEE,4/17/2020,70,36,0,106
COFFEE,4/18/2020,71,37,0,108
COFFEE,4/19/2020,73,38,0,111
COFFEE,4/20/2020,83,42,0,125
COFFEE,4/21/2020,90,44,1,135
COFFEE,4/22/2020,92,45,1,138
COFFEE,4/23/2020,93,48,1,142
COFFEE,4/24/2020,105,51,1,157
COFFEE,4/25/2020,110,52,1,163
COFFEE,4/26/2020,112,52,1,165
COFFEE,4/27/2020,114,56,1,171
COFFEE,4/28/2020,118,56,1,175
COFFEE,4/29/2020,121,60,1,182
COFFEE,4/30/2020,121,61,1,183
COFFEE,5/1/2020,124,63,1,188
COFFEE,5/2/2020,124,64,1,189
COFFEE,5/3/2020,128,64,1,193
COFFEE,5/4/2020,130,64,1,195
COFFEE,5/5/2020,136,66,1,203
COFFEE,5/6/2020,138,68,1,207
COFFEE,5/7/2020,141,71,1,213
COFFEE,5/8/2020,146,75,1,222
COFFEE,5/9/2020,146,75,1,222
COFFEE,5/10/2020,149,76,1,226
BALDWIN,8/9/2020,583,604,17,1204
UNKNOWN,1/15/2020,0,0,0,0
COFFEE,5/11/2020,155,76,1,232
BALDWIN,8/10/2020,595,612,17,1224
UNKNOWN,1/16/2020,0,0,0,0
COFFEE,5/12/2020,157,77,1,235
BALDWIN,8/11/2020,601,615,17,1233
UNKNOWN,1/17/2020,0,0,0,0
COFFEE,5/13/2020,162,77,1,240
COFFEE,5/14/2020,171,78,1,250
COFFEE,5/15/2020,172,78,1,251
COFFEE,5/16/2020,174,81,1,256
COFFEE,5/17/2020,175,83,1,259
COFFEE,5/18/2020,179,91,1,271
COFFEE,5/19/2020,181,91,1,273
COFFEE,5/20/2020,182,93,1,276
COFFEE,5/21/2020,186,95,1,282
COFFEE,5/22/2020,189,95,1,285
COFFEE,5/23/2020,190,95,1,286
COFFEE,5/24/2020,191,97,1,289
COFFEE,5/25/2020,192,97,1,290
COFFEE,5/26/2020,195,99,1,295
COFFEE,5/27/2020,201,100,1,302
COFFEE,5/28/2020,209,100,1,310
COFFEE,5/29/2020,210,104,1,315
COFFEE,5/30/2020,211,106,1,318
COFFEE,5/31/2020,211,108,1,320
COFFEE,6/1/2020,214,109,1,324
COFFEE,6/2/2020,219,112,1,332
COFFEE,6/3/2020,223,113,1,337
COFFEE,6/4/2020,227,119,1,347
COFFEE,6/5/2020,230,119,1,350
COFFEE,6/6/2020,233,121,1,355
COFFEE,6/7/2020,235,122,1,358
COFFEE,6/8/2020,238,127,4,369
COFFEE,6/9/2020,243,133,6,382
COFFEE,6/10/2020,245,136,9,390
COFFEE,6/11/2020,252,145,9,406
COFFEE,6/12/2020,258,149,9,416
COFFEE,6/13/2020,263,151,9,423
COFFEE,6/14/2020,268,157,9,434
COFFEE,6/15/2020,275,169,9,453
COFFEE,6/16/2020,284,175,9,468
COFFEE,6/17/2020,295,188,9,492
COFFEE,6/18/2020,305,195,9,509
COFFEE,6/19/2020,311,204,9,524
COFFEE,6/20/2020,319,215,9,543
COFFEE,6/21/2020,326,224,9,559
COFFEE,6/22/2020,338,235,9,582
COFFEE,6/23/2020,353,390,9,752
COFFEE,6/24/2020,370,400,10,780
COFFEE,6/25/2020,381,407,10,798
COFFEE,6/26/2020,387,415,10,812
COFFEE,6/27/2020,392,421,10,823
COFFEE,6/28/2020,399,424,10,833
COFFEE,6/29/2020,418,436,10,864
COFFEE,6/30/2020,424,445,11,880
COFFEE,7/1/2020,442,458,11,911
COFFEE,7/2/2020,453,466,11,930
COFFEE,7/3/2020,465,477,11,953
COFFEE,7/4/2020,474,482,11,967
COFFEE,7/5/2020,481,493,11,985
COFFEE,7/6/2020,497,506,11,1014
COFFEE,7/7/2020,517,520,11,1048
COFFEE,7/8/2020,531,530,11,1072
COFFEE,7/9/2020,538,542,12,1092
COFFEE,7/10/2020,551,546,12,1109
COFFEE,7/11/2020,555,554,12,1121
COFFEE,7/12/2020,562,557,12,1131
COFFEE,7/13/2020,572,571,12,1155
COFFEE,7/14/2020,585,577,12,1174
COFFEE,7/15/2020,598,588,12,1198
COFFEE,7/16/2020,609,604,12,1225
COFFEE,7/17/2020,621,614,12,1247
COFFEE,7/18/2020,632,620,12,1264
COFFEE,7/19/2020,637,624,12,1273
COFFEE,7/20/2020,655,634,12,1301
COFFEE,7/21/2020,665,648,12,1325
COFFEE,7/22/2020,681,661,12,1354
COFFEE,7/23/2020,691,667,12,1370
COFFEE,7/24/2020,698,669,12,1379
COFFEE,7/25/2020,705,674,12,1391
COFFEE,7/26/2020,709,677,12,1398
COFFEE,7/27/2020,720,692,12,1424
COFFEE,7/28/2020,728,697,12,1437
COFFEE,7/29/2020,742,705,12,1459
COFFEE,7/30/2020,749,711,12,1472
COFFEE,7/31/2020,759,715,12,1486
COFFEE,8/1/2020,769,724,12,1505
COFFEE,8/2/2020,774,727,12,1513
COFFEE,8/3/2020,783,733,12,1528
COFFEE,8/4/2020,789,745,13,1547
COFFEE,8/5/2020,795,753,13,1561
COFFEE,8/6/2020,798,758,13,1569
COFFEE,8/7/2020,808,760,13,1581
COFFEE,8/8/2020,818,770,13,1601
COFFEE,8/9/2020,821,776,13,1610
COFFEE,8/10/2020,831,786,13,1630
COFFEE,8/11/2020,839,796,13,1648
COFFEE,8/12/2020,845,800,14,1659
COFFEE,8/13/2020,850,808,14,1672
COFFEE,8/14/2020,853,817,14,1684
COFFEE,8/15/2020,859,821,14,1694
COFFEE,8/16/2020,865,827,14,1706
COFFEE,8/17/2020,873,836,14,1723
COFFEE,8/18/2020,876,855,14,1745
COFFEE,8/19/2020,890,859,14,1763
COFFEE,8/20/2020,899,864,14,1777
COFFEE,8/21/2020,901,871,14,1786
COFFEE,8/22/2020,908,873,14,1795
COFFEE,8/23/2020,913,876,14,1803
COFFEE,8/24/2020,922,882,14,1818
COFFEE,8/25/2020,924,888,14,1826
COFFEE,8/26/2020,928,894,14,1836
COFFEE,8/27/2020,931,900,14,1845
COFFEE,8/28/2020,936,906,14,1856
COFFEE,8/29/2020,943,912,14,1869
COFFEE,8/30/2020,946,915,14,1875
COFFEE,8/31/2020,952,923,14,1889
COFFEE,9/1/2020,962,931,14,1907
COFFEE,9/2/2020,969,937,14,1920
COFFEE,9/3/2020,977,944,14,1935
COFFEE,9/4/2020,980,947,14,1941
COFFEE,9/5/2020,983,948,14,1945
COFFEE,9/6/2020,987,950,14,1951
COFFEE,9/7/2020,991,956,14,1961
COFFEE,9/8/2020,996,958,14,1968
COFFEE,9/9/2020,1005,961,14,1980
COFFEE,9/10/2020,1005,965,18,1988
COFFEE,9/11/2020,1006,970,18,1994
COFFEE,9/12/2020,1008,970,18,1996
COFFEE,9/13/2020,1013,972,18,2003
COFFEE,9/14/2020,1019,976,18,2013
COFFEE,9/15/2020,1022,977,18,2017
COFFEE,9/16/2020,1030,985,18,2033
COFFEE,9/17/2020,1034,988,18,2040
COFFEE,9/18/2020,1040,995,18,2053
COFFEE,9/19/2020,1043,996,18,2057
COFFEE,9/20/2020,1046,997,18,2061
COFFEE,9/21/2020,1055,1006,18,2079
COFFEE,9/22/2020,1058,1010,18,2086
COFFEE,9/23/2020,1062,1014,18,2094
COFFEE,9/24/2020,1063,1016,18,2097
COFFEE,9/25/2020,1068,1016,18,2102
COFFEE,9/26/2020,1069,1017,18,2104
COFFEE,9/27/2020,1070,1018,18,2106
COFFEE,9/28/2020,1074,1020,18,2112
COFFEE,9/29/2020,1077,1023,18,2118
COFFEE,9/30/2020,1078,1028,18,2124
COFFEE,10/1/2020,1081,1034,19,2134
COFFEE,10/2/2020,1086,1039,19,2144
COFFEE,10/3/2020,1087,1040,19,2146
COFFEE,10/4/2020,1088,1040,19,2147
COFFEE,10/5/2020,1093,1042,19,2154
COFFEE,10/6/2020,1094,1044,19,2157
COFFEE,10/7/2020,1095,1048,19,2162
COFFEE,10/8/2020,1096,1049,19,2164
COFFEE,10/9/2020,1098,1054,19,2171
COFFEE,10/10/2020,1099,1055,19,2173
COFFEE,10/11/2020,1100,1056,19,2175
COFFEE,10/12/2020,1103,1058,19,2180
COFFEE,10/13/2020,1106,1061,19,2186
COFFEE,10/14/2020,1106,1064,19,2189
COFFEE,10/15/2020,1108,1064,19,2191
COFFEE,10/16/2020,1108,1065,19,2192
COFFEE,10/17/2020,1108,1066,19,2193
COFFEE,10/18/2020,1108,1066,19,2193
COFFEE,10/19/2020,1108,1066,19,2193
COFFEE,10/20/2020,1108,1066,19,2193
HENRY,1/1/2020,0,0,0,0
HENRY,1/2/2020,0,0,0,0
HENRY,1/3/2020,0,0,0,0
HENRY,1/4/2020,0,0,0,0
HENRY,1/5/2020,0,0,0,0
HENRY,1/6/2020,0,0,0,0
HENRY,1/7/2020,0,0,0,0
HENRY,1/8/2020,0,0,0,0
HENRY,1/9/2020,0,0,0,0
HENRY,1/10/2020,0,0,0,0
HENRY,1/11/2020,0,0,0,0
HENRY,1/12/2020,0,0,0,0
HENRY,1/13/2020,0,0,0,0
HENRY,1/14/2020,0,0,0,0
HENRY,1/15/2020,0,0,0,0
HENRY,1/16/2020,0,0,0,0
HENRY,1/17/2020,0,0,0,0
HENRY,1/18/2020,0,0,0,0
HENRY,1/19/2020,0,0,0,0
HENRY,1/20/2020,0,0,0,0
HENRY,1/21/2020,0,0,0,0
HENRY,1/22/2020,0,0,0,0
HENRY,1/23/2020,0,0,0,0
HENRY,1/24/2020,0,0,0,0
HENRY,1/25/2020,0,0,0,0
HENRY,1/26/2020,0,0,0,0
HENRY,1/27/2020,0,0,0,0
HENRY,1/28/2020,0,0,0,0
HENRY,1/29/2020,0,0,0,0
HENRY,1/30/2020,0,0,0,0
HENRY,1/31/2020,0,0,0,0
HENRY,2/1/2020,0,0,0,0
HENRY,2/2/2020,0,0,0,0
HENRY,2/3/2020,1,0,0,1
HENRY,2/4/2020,1,0,0,1
HENRY,2/5/2020,1,0,0,1
HENRY,2/6/2020,1,0,0,1
HENRY,2/7/2020,1,0,0,1
HENRY,2/8/2020,1,0,0,1
HENRY,2/9/2020,1,0,0,1
HENRY,2/10/2020,1,0,0,1
HENRY,2/11/2020,1,0,0,1
HENRY,2/12/2020,1,0,0,1
HENRY,2/13/2020,1,0,0,1
HENRY,2/14/2020,1,0,0,1
HENRY,2/15/2020,1,0,0,1
HENRY,2/16/2020,1,0,0,1
HENRY,2/17/2020,1,0,0,1
HENRY,2/18/2020,1,0,0,1
HENRY,2/19/2020,1,0,0,1
HENRY,2/20/2020,1,0,0,1
HENRY,2/21/2020,1,0,0,1
HENRY,2/22/2020,1,1,0,2
HENRY,2/23/2020,1,1,0,2
HENRY,2/24/2020,2,1,0,3
HENRY,2/25/2020,2,1,0,3
HENRY,2/26/2020,2,1,0,3
HENRY,2/27/2020,2,1,0,3
HENRY,2/28/2020,2,1,0,3
HENRY,2/29/2020,2,1,0,3
HENRY,3/1/2020,3,2,0,5
HENRY,3/2/2020,3,2,0,5
HENRY,3/3/2020,3,2,0,5
HENRY,3/4/2020,5,2,0,7
HENRY,3/5/2020,5,2,0,7
HENRY,3/6/2020,6,2,0,8
HENRY,3/7/2020,7,2,0,9
HENRY,3/8/2020,7,2,0,9
HENRY,3/9/2020,9,3,0,12
HENRY,3/10/2020,10,6,0,16
HENRY,3/11/2020,12,6,0,18
HENRY,3/12/2020,15,7,0,22
HENRY,3/13/2020,19,8,0,27
HENRY,3/14/2020,20,10,0,30
HENRY,3/15/2020,23,13,0,36
HENRY,3/16/2020,28,23,0,51
HENRY,3/17/2020,36,29,0,65
HENRY,3/18/2020,46,33,0,79
HENRY,3/19/2020,51,38,0,89
HENRY,3/20/2020,57,43,0,100
HENRY,3/21/2020,62,47,0,109
HENRY,3/22/2020,67,50,0,117
HENRY,3/23/2020,81,54,0,135
HENRY,3/24/2020,88,60,0,148
HENRY,3/25/2020,98,68,0,166
HENRY,3/26/2020,107,71,0,178
HENRY,3/27/2020,119,74,0,193
HENRY,3/28/2020,125,78,0,203
HENRY,3/29/2020,126,82,0,208
HENRY,3/30/2020,136,90,0,226
HENRY,3/31/2020,144,92,0,236
HENRY,4/1/2020,148,101,0,249
HENRY,4/2/2020,152,106,1,259
HENRY,4/3/2020,157,114,1,272
HENRY,4/4/2020,160,115,1,276
HENRY,4/5/2020,163,116,1,280
HENRY,4/6/2020,173,125,1,299
HENRY,4/7/2020,175,133,1,309
HENRY,4/8/2020,181,138,1,320
HENRY,4/9/2020,189,146,1,336
HENRY,4/10/2020,192,154,1,347
HENRY,4/11/2020,197,154,1,352
HENRY,4/12/2020,200,156,1,357
HENRY,4/13/2020,211,163,1,375
HENRY,4/14/2020,215,169,1,385
HENRY,4/15/2020,222,172,1,395
HENRY,4/16/2020,226,174,1,401
HENRY,4/17/2020,231,179,1,411
HENRY,4/18/2020,234,181,1,416
HENRY,4/19/2020,239,182,1,422
HENRY,4/20/2020,253,188,1,442
HENRY,4/21/2020,275,194,1,470
HENRY,4/22/2020,280,197,1,478
HENRY,4/23/2020,285,200,1,486
HENRY,4/24/2020,296,205,1,502
HENRY,4/25/2020,300,206,1,507
HENRY,4/26/2020,305,207,1,513
HENRY,4/27/2020,318,213,1,532
HENRY,4/28/2020,330,220,1,551
HENRY,4/29/2020,338,222,1,561
HENRY,4/30/2020,346,223,1,570
HENRY,5/1/2020,353,226,1,580
HENRY,5/2/2020,357,228,1,586
HENRY,5/3/2020,358,231,1,590
HENRY,5/4/2020,367,235,1,603
HENRY,5/5/2020,371,240,1,612
HENRY,5/6/2020,375,241,1,617
HENRY,5/7/2020,378,243,1,622
HENRY,5/8/2020,382,244,2,628
HENRY,5/9/2020,386,247,2,635
HENRY,5/10/2020,387,248,2,637
HENRY,5/11/2020,391,250,2,643
HENRY,5/12/2020,397,255,2,654
HENRY,5/13/2020,402,257,2,661
HENRY,5/14/2020,409,260,2,671
HENRY,5/15/2020,412,266,2,680
HENRY,5/16/2020,413,266,2,681
HENRY,5/17/2020,414,268,2,684
HENRY,5/18/2020,419,268,2,689
HENRY,5/19/2020,422,273,2,697
HENRY,5/20/2020,424,277,2,703
HENRY,5/21/2020,432,288,2,722
HENRY,5/22/2020,433,291,2,726
HENRY,5/23/2020,437,293,2,732
HENRY,5/24/2020,437,294,2,733
HENRY,5/25/2020,443,297,2,742
HENRY,5/26/2020,455,305,2,762
HENRY,5/27/2020,465,312,2,779
HENRY,5/28/2020,469,319,2,790
HENRY,5/29/2020,470,322,2,794
HENRY,5/30/2020,474,328,2,804
HENRY,5/31/2020,481,331,2,814
HENRY,6/1/2020,489,339,3,831
HENRY,6/2/2020,493,344,3,840
HENRY,6/3/2020,504,346,3,853
HENRY,6/4/2020,510,350,3,863
HENRY,6/5/2020,518,355,3,876
HENRY,6/6/2020,529,356,3,888
HENRY,6/7/2020,532,360,3,895
HENRY,6/8/2020,536,368,3,907
HENRY,6/9/2020,542,373,3,918
HENRY,6/10/2020,552,381,3,936
HENRY,6/11/2020,559,387,3,949
HENRY,6/12/2020,570,391,3,964
HENRY,6/13/2020,578,394,3,975
HENRY,6/14/2020,581,400,3,984
HENRY,6/15/2020,606,414,3,1023
HENRY,6/16/2020,628,425,3,1056
HENRY,6/17/2020,647,438,3,1088
HENRY,6/18/2020,665,456,3,1124
HENRY,6/19/2020,687,476,3,1166
HENRY,6/20/2020,701,489,3,1193
HENRY,6/21/2020,708,498,3,1209
HENRY,6/22/2020,728,526,5,1259
HENRY,6/23/2020,749,555,5,1309
HENRY,6/24/2020,789,581,5,1375
HENRY,6/25/2020,813,597,6,1416
HENRY,6/26/2020,846,619,6,1471
HENRY,6/27/2020,863,629,6,1498
HENRY,6/28/2020,883,634,6,1523
HENRY,6/29/2020,924,675,11,1610
HENRY,6/30/2020,967,706,12,1685
HENRY,7/1/2020,1000,744,13,1757
HENRY,7/2/2020,1048,777,13,1838
HENRY,7/3/2020,1080,799,16,1895
HENRY,7/4/2020,1094,809,16,1919
HENRY,7/5/2020,1110,818,16,1944
HENRY,7/6/2020,1177,872,16,2065
HENRY,7/7/2020,1242,922,16,2180
HENRY,7/8/2020,1291,962,18,2271
HENRY,7/9/2020,1344,1001,22,2367
HENRY,7/10/2020,1410,1044,24,2478
HENRY,7/11/2020,1440,1060,26,2526
HENRY,7/12/2020,1457,1066,26,2549
HENRY,7/13/2020,1531,1123,27,2681
HENRY,7/14/2020,1582,1162,28,2772
HENRY,7/15/2020,1633,1203,32,2868
HENRY,7/16/2020,1674,1239,32,2945
HENRY,7/17/2020,1719,1272,34,3025
HENRY,7/18/2020,1731,1289,34,3054
HENRY,7/19/2020,1739,1303,34,3076
HENRY,7/20/2020,1789,1344,36,3169
HENRY,7/21/2020,1822,1373,36,3231
HENRY,7/22/2020,1862,1410,36,3308
HENRY,7/23/2020,1905,1435,36,3376
HENRY,7/24/2020,1954,1468,39,3461
HENRY,7/25/2020,1972,1480,39,3491
HENRY,7/26/2020,1984,1490,39,3513
HENRY,7/27/2020,2030,1522,39,3591
HENRY,7/28/2020,2077,1550,39,3666
HENRY,7/29/2020,2112,1565,39,3716
HENRY,7/30/2020,2149,1581,39,3769
HENRY,7/31/2020,2193,1609,39,3841
HENRY,8/1/2020,2215,1624,39,3878
HENRY,8/2/2020,2225,1635,39,3899
HENRY,8/3/2020,2259,1661,39,3959
HENRY,8/4/2020,2301,1692,39,4032
HENRY,8/5/2020,2329,1711,40,4080
HENRY,8/6/2020,2362,1741,40,4143
HENRY,8/7/2020,2408,1765,40,4213
HENRY,8/8/2020,2422,1780,40,4242
HENRY,8/9/2020,2430,1794,40,4264
HENRY,8/10/2020,2470,1824,41,4335
HENRY,8/11/2020,2504,1851,41,4396
HENRY,8/12/2020,2534,1875,41,4450
HENRY,8/13/2020,2560,1898,41,4499
HENRY,8/14/2020,2592,1921,42,4555
HENRY,8/15/2020,2606,1931,43,4580
HENRY,8/16/2020,2622,1939,43,4604
HENRY,8/17/2020,2648,1959,43,4650
HENRY,8/18/2020,2673,1979,43,4695
HENRY,8/19/2020,2698,1999,44,4741
HENRY,8/20/2020,2725,2016,44,4785
HENRY,8/21/2020,2752,2028,44,4824
HENRY,8/22/2020,2765,2036,44,4845
HENRY,8/23/2020,2779,2043,45,4867
BALDWIN,8/12/2020,612,621,17,1250
BALDWIN,8/13/2020,625,627,19,1271
UNKNOWN,1/18/2020,0,0,0,0
BALDWIN,8/14/2020,639,633,19,1291
BALDWIN,8/15/2020,654,637,19,1310
BALDWIN,8/16/2020,671,642,19,1332
BALDWIN,8/17/2020,719,657,19,1395
BALDWIN,8/18/2020,757,672,19,1448
BALDWIN,8/19/2020,808,688,21,1517
BALDWIN,8/20/2020,843,707,21,1571
BALDWIN,8/21/2020,879,724,21,1624
BALDWIN,8/22/2020,894,734,21,1649
BALDWIN,8/23/2020,915,741,21,1677
BALDWIN,8/24/2020,939,752,23,1714
BALDWIN,8/25/2020,962,759,23,1744
BALDWIN,8/26/2020,978,766,23,1767
BALDWIN,8/27/2020,987,776,23,1786
BALDWIN,8/28/2020,1001,785,23,1809
BALDWIN,8/29/2020,1009,790,23,1822
BALDWIN,8/30/2020,1018,798,23,1839
BALDWIN,8/31/2020,1031,813,23,1867
BALDWIN,9/1/2020,1039,827,23,1889
BALDWIN,9/2/2020,1052,837,23,1912
BALDWIN,9/3/2020,1060,850,23,1933
BALDWIN,9/4/2020,1072,860,23,1955
BALDWIN,9/5/2020,1078,868,23,1969
BALDWIN,9/6/2020,1088,873,23,1984
BALDWIN,9/7/2020,1093,880,23,1996
BALDWIN,9/8/2020,1098,886,23,2007
BALDWIN,9/9/2020,1105,892,23,2020
BALDWIN,9/10/2020,1109,898,23,2030
BALDWIN,9/11/2020,1119,903,23,2045
BALDWIN,9/12/2020,1124,907,23,2054
BALDWIN,9/13/2020,1126,912,23,2061
BALDWIN,9/14/2020,1131,916,23,2070
BALDWIN,9/15/2020,1134,922,23,2079
BALDWIN,9/16/2020,1141,926,23,2090
BALDWIN,9/17/2020,1146,930,23,2099
BALDWIN,9/18/2020,1151,932,23,2106
BALDWIN,9/19/2020,1153,936,23,2112
BALDWIN,9/20/2020,1156,938,23,2117
BALDWIN,9/21/2020,1159,939,23,2121
BALDWIN,9/22/2020,1164,941,23,2128
BALDWIN,9/23/2020,1165,946,23,2134
BALDWIN,9/24/2020,1170,950,23,2143
BALDWIN,9/25/2020,1172,953,23,2148
BALDWIN,9/26/2020,1174,954,23,2151
BALDWIN,9/27/2020,1175,958,23,2156
BALDWIN,9/28/2020,1179,961,23,2163
BALDWIN,9/29/2020,1185,962,23,2170
BALDWIN,9/30/2020,1190,962,23,2175
BALDWIN,10/1/2020,1192,964,23,2179
BALDWIN,10/2/2020,1196,964,23,2183
BALDWIN,10/3/2020,1197,967,23,2187
BALDWIN,10/4/2020,1199,969,23,2191
BALDWIN,10/5/2020,1199,972,23,2194
BALDWIN,10/6/2020,1200,974,23,2197
BALDWIN,10/7/2020,1203,978,23,2204
BALDWIN,10/8/2020,1205,979,23,2207
BALDWIN,10/9/2020,1207,981,23,2211
BALDWIN,10/10/2020,1208,983,23,2214
BALDWIN,10/11/2020,1211,985,23,2219
BALDWIN,10/12/2020,1215,990,23,2228
BALDWIN,10/13/2020,1220,995,23,2238
BALDWIN,10/14/2020,1223,998,23,2244
BALDWIN,10/15/2020,1225,1001,23,2249
BALDWIN,10/16/2020,1228,1001,23,2252
BALDWIN,10/17/2020,1229,1001,23,2253
BALDWIN,10/18/2020,1229,1002,23,2254
BALDWIN,10/19/2020,1230,1004,23,2257
BALDWIN,10/20/2020,1230,1004,23,2257
BIBB,1/1/2020,0,0,0,0
BIBB,1/2/2020,0,0,0,0
BIBB,1/3/2020,0,0,0,0
BIBB,1/4/2020,0,0,0,0
BIBB,1/5/2020,0,0,0,0
BIBB,1/6/2020,0,0,0,0
BIBB,1/7/2020,0,0,0,0
BIBB,1/8/2020,0,0,0,0
BIBB,1/9/2020,0,0,0,0
BIBB,1/10/2020,0,0,0,0
BIBB,1/11/2020,0,0,0,0
BIBB,1/12/2020,0,0,0,0
BIBB,1/13/2020,0,0,0,0
BIBB,1/14/2020,0,0,0,0
BIBB,1/15/2020,0,0,0,0
BIBB,1/16/2020,0,0,0,0
BIBB,1/17/2020,0,0,0,0
BIBB,1/18/2020,0,0,0,0
BIBB,1/19/2020,0,0,0,0
BIBB,1/20/2020,0,0,0,0
BIBB,1/21/2020,0,0,0,0
BIBB,1/22/2020,0,0,0,0
BIBB,1/23/2020,0,0,0,0
BIBB,1/24/2020,0,0,0,0
BIBB,1/25/2020,0,0,0,0
BIBB,1/26/2020,0,0,0,0
BIBB,1/27/2020,0,0,0,0
BIBB,1/28/2020,0,0,0,0
BIBB,1/29/2020,0,0,0,0
BIBB,1/30/2020,0,0,0,0
BIBB,1/31/2020,0,0,0,0
BIBB,2/1/2020,0,0,0,0
BIBB,2/2/2020,0,0,0,0
BIBB,2/3/2020,0,0,0,0
BIBB,2/4/2020,0,0,0,0
BIBB,2/5/2020,0,0,0,0
BIBB,2/6/2020,0,0,0,0
BIBB,2/7/2020,0,0,0,0
BIBB,2/8/2020,0,0,0,0
BIBB,2/9/2020,0,0,0,0
BIBB,2/10/2020,0,0,0,0
BIBB,2/11/2020,0,0,0,0
BIBB,2/12/2020,0,0,0,0
BIBB,2/13/2020,0,0,0,0
BIBB,2/14/2020,0,0,0,0
BIBB,2/15/2020,0,0,0,0
BIBB,2/16/2020,0,0,0,0
BIBB,2/17/2020,0,0,0,0
BIBB,2/18/2020,0,0,0,0
BIBB,2/19/2020,0,0,0,0
BIBB,2/20/2020,0,0,0,0
BIBB,2/21/2020,0,0,0,0
BIBB,2/22/2020,0,0,0,0
BIBB,2/23/2020,0,0,0,0
BIBB,2/24/2020,0,0,0,0
BIBB,2/25/2020,0,0,0,0
BIBB,2/26/2020,0,0,0,0
BIBB,2/27/2020,0,0,0,0
BIBB,2/28/2020,0,0,0,0
BIBB,2/29/2020,0,0,0,0
BIBB,3/1/2020,0,0,0,0
BIBB,3/2/2020,0,0,0,0
BIBB,3/3/2020,0,0,0,0
BIBB,3/4/2020,0,0,0,0
BIBB,3/5/2020,0,0,0,0
BIBB,3/6/2020,1,0,0,1
BIBB,3/7/2020,1,0,0,1
BIBB,3/8/2020,1,0,0,1
BIBB,3/9/2020,2,1,0,3
BIBB,3/10/2020,2,1,0,3
BIBB,3/11/2020,2,1,0,3
BIBB,3/12/2020,2,2,0,4
BIBB,3/13/2020,3,2,0,5
BIBB,3/14/2020,4,3,0,7
BIBB,3/15/2020,5,3,0,8
BIBB,3/16/2020,6,5,0,11
BIBB,3/17/2020,7,9,0,16
BIBB,3/18/2020,9,13,0,22
BIBB,3/19/2020,10,14,0,24
BIBB,3/20/2020,11,14,0,25
BIBB,3/21/2020,12,15,0,27
BIBB,3/22/2020,15,16,0,31
BIBB,3/23/2020,16,17,0,33
BIBB,3/24/2020,18,18,0,36
BIBB,3/25/2020,21,19,0,40
BIBB,3/26/2020,21,21,0,42
BIBB,3/27/2020,24,22,0,46
BIBB,3/28/2020,26,22,0,48
BIBB,3/29/2020,27,22,0,49
BIBB,3/30/2020,32,22,0,54
BIBB,3/31/2020,33,22,0,55
BIBB,4/1/2020,35,24,0,59
BIBB,4/2/2020,35,27,0,62
BIBB,4/3/2020,39,29,0,68
BIBB,4/4/2020,45,31,0,76
BIBB,4/5/2020,50,31,0,81
BIBB,4/6/2020,55,34,0,89
BIBB,4/7/2020,64,37,0,101
BIBB,4/8/2020,66,39,0,105
BIBB,4/9/2020,91,52,2,145
BIBB,4/10/2020,97,59,2,158
BIBB,4/11/2020,98,60,2,160
BIBB,4/12/2020,102,62,2,166
BIBB,4/13/2020,118,73,2,193
BIBB,4/14/2020,123,77,2,202
BIBB,4/15/2020,127,78,2,207
BIBB,4/16/2020,132,80,2,214
BIBB,4/17/2020,139,82,2,223
BIBB,4/18/2020,143,83,2,228
BIBB,4/19/2020,149,88,2,239
BIBB,4/20/2020,154,92,2,248
BIBB,4/21/2020,159,94,2,255
BIBB,4/22/2020,161,95,2,258
BIBB,4/23/2020,169,99,2,270
BIBB,4/24/2020,174,107,2,283
BIBB,4/25/2020,178,111,2,291
BIBB,4/26/2020,184,113,2,299
BIBB,4/27/2020,201,124,2,327
BIBB,4/28/2020,209,131,2,342
BIBB,4/29/2020,211,134,2,347
BIBB,4/30/2020,214,137,2,353
BIBB,5/1/2020,216,139,2,357
BIBB,5/2/2020,217,142,2,361
BIBB,5/3/2020,219,144,2,365
BIBB,5/4/2020,223,148,2,373
BIBB,5/5/2020,226,149,2,377
BIBB,5/6/2020,228,149,2,379
BIBB,5/7/2020,229,150,2,381
BIBB,5/8/2020,230,152,2,384
BIBB,5/9/2020,233,153,2,388
BIBB,5/10/2020,234,155,2,391
BIBB,5/11/2020,236,159,2,397
BIBB,5/12/2020,240,160,2,402
BIBB,5/13/2020,244,163,2,409
BIBB,5/14/2020,249,165,2,416
BIBB,5/15/2020,254,167,2,423
BIBB,5/16/2020,259,168,2,429
BIBB,5/17/2020,260,169,2,431
BIBB,5/18/2020,261,171,2,434
BIBB,5/19/2020,264,174,2,440
BIBB,5/20/2020,266,178,2,446
BIBB,5/21/2020,268,180,2,450
BIBB,5/22/2020,270,182,2,454
BIBB,5/23/2020,272,184,2,458
BIBB,5/24/2020,273,184,2,459
BIBB,5/25/2020,278,184,2,464
BIBB,5/26/2020,285,185,2,472
BIBB,5/27/2020,288,186,2,476
BIBB,5/28/2020,292,189,2,483
BIBB,5/29/2020,293,191,2,486
BIBB,5/30/2020,295,193,2,490
BIBB,5/31/2020,296,194,2,492
BIBB,6/1/2020,305,198,2,505
BIBB,6/2/2020,319,206,2,527
BIBB,6/3/2020,326,207,2,535
BIBB,6/4/2020,330,209,2,541
BIBB,6/5/2020,338,214,2,554
BIBB,6/6/2020,342,219,2,563
BIBB,6/7/2020,347,220,2,569
BIBB,6/8/2020,352,223,2,577
BIBB,6/9/2020,356,227,2,585
BIBB,6/10/2020,363,229,2,594
BIBB,6/11/2020,369,229,2,600
BIBB,6/12/2020,373,231,2,606
BIBB,6/13/2020,381,232,2,615
BIBB,6/14/2020,387,238,2,627
BIBB,6/15/2020,398,244,2,644
BIBB,6/16/2020,408,250,2,660
BIBB,6/17/2020,418,259,2,679
BIBB,6/18/2020,425,263,2,690
BIBB,6/19/2020,438,275,3,716
BIBB,6/20/2020,457,285,4,746
BIBB,6/21/2020,475,290,4,769
BIBB,6/22/2020,508,311,4,823
BIBB,6/23/2020,536,340,4,880
BIBB,6/24/2020,564,361,4,929
BIBB,6/25/2020,606,397,4,1007
BIBB,6/26/2020,654,421,4,1079
BIBB,6/27/2020,688,431,5,1124
BIBB,6/28/2020,723,456,5,1184
BIBB,6/29/2020,789,512,5,1306
BIBB,6/30/2020,840,559,10,1409
BIBB,7/1/2020,884,601,10,1495
BIBB,7/2/2020,937,641,10,1588
BIBB,7/3/2020,984,667,10,1661
BIBB,7/4/2020,1024,695,10,1729
BIBB,7/5/2020,1065,724,10,1799
BIBB,7/6/2020,1133,779,10,1922
BIBB,7/7/2020,1206,839,11,2056
BIBB,7/8/2020,1280,898,15,2193
BIBB,7/9/2020,1334,947,15,2296
BIBB,7/10/2020,1398,1010,15,2423
BIBB,7/11/2020,1442,1038,16,2496
BIBB,7/12/2020,1471,1070,17,2558
BIBB,7/13/2020,1557,1117,18,2692
BIBB,7/14/2020,1613,1168,20,2801
BIBB,7/15/2020,1682,1204,20,2906
BIBB,7/16/2020,1751,1254,20,3025
BIBB,7/17/2020,1814,1297,23,3134
BIBB,7/18/2020,1850,1324,24,3198
BIBB,7/19/2020,1880,1355,25,3260
BIBB,7/20/2020,1930,1403,25,3358
BIBB,7/21/2020,1968,1465,25,3458
BIBB,7/22/2020,2010,1494,27,3531
BIBB,7/23/2020,2057,1532,27,3616
BIBB,7/24/2020,2112,1557,27,3696
BIBB,7/25/2020,2141,1573,27,3741
BIBB,7/26/2020,2172,1590,27,3789
BIBB,7/27/2020,2234,1634,28,3896
BIBB,7/28/2020,2283,1674,28,3985
BIBB,7/29/2020,2326,1704,30,4060
BIBB,7/30/2020,2363,1724,30,4117
BIBB,7/31/2020,2400,1747,30,4177
BIBB,8/1/2020,2435,1780,30,4245
BIBB,8/2/2020,2460,1795,30,4285
BIBB,8/3/2020,2514,1838,31,4383
BIBB,8/4/2020,2550,1871,35,4456
BIBB,8/5/2020,2607,1898,35,4540
BIBB,8/6/2020,2646,1935,36,4617
BIBB,8/7/2020,2681,1962,37,4680
BIBB,8/8/2020,2704,1976,37,4717
BIBB,8/9/2020,2727,1991,37,4755
BIBB,8/10/2020,2767,2029,37,4833
BIBB,8/11/2020,2812,2049,38,4899
BIBB,8/12/2020,2849,2073,39,4961
BIBB,8/13/2020,2884,2095,39,5018
BIBB,8/14/2020,2922,2127,39,5088
BIBB,8/15/2020,2942,2145,39,5126
BIBB,8/16/2020,2963,2161,39,5163
BIBB,8/17/2020,2993,2177,39,5209
BIBB,8/18/2020,3013,2192,40,5245
BIBB,8/19/2020,3036,2207,40,5283
BIBB,8/20/2020,3050,2218,42,5310
BIBB,8/21/2020,3079,2233,43,5355
BIBB,8/22/2020,3094,2245,43,5382
BIBB,8/23/2020,3103,2260,44,5407
BIBB,8/24/2020,3120,2277,45,5442
BIBB,8/25/2020,3140,2290,47,5477
BIBB,8/26/2020,3164,2301,48,5513
BIBB,8/27/2020,3175,2318,50,5543
BIBB,8/28/2020,3188,2335,50,5573
BIBB,8/29/2020,3197,2343,50,5590
BIBB,8/30/2020,3205,2359,51,5615
BIBB,8/31/2020,3224,2378,52,5654
BIBB,9/1/2020,3244,2394,52,5690
BIBB,9/2/2020,3256,2399,52,5707
BIBB,9/3/2020,3275,2415,52,5742
BIBB,9/4/2020,3281,2422,52,5755
BIBB,9/5/2020,3291,2427,52,5770
BIBB,9/6/2020,3297,2431,52,5780
BIBB,9/7/2020,3303,2445,52,5800
BIBB,9/8/2020,3314,2460,53,5827
BIBB,9/9/2020,3324,2477,53,5854
BIBB,9/10/2020,3341,2487,57,5885
BIBB,9/11/2020,3352,2493,58,5903
BIBB,9/12/2020,3354,2501,58,5913
BIBB,9/13/2020,3368,2509,58,5935
BIBB,9/14/2020,3378,2521,63,5962
BIBB,9/15/2020,3385,2533,63,5981
BIBB,9/16/2020,3397,2540,63,6000
BIBB,9/17/2020,3399,2547,63,6009
BIBB,9/18/2020,3406,2553,63,6022
BIBB,9/19/2020,3411,2556,63,6030
BIBB,9/20/2020,3414,2560,63,6037
BIBB,9/21/2020,3421,2567,63,6051
BIBB,9/22/2020,3426,2570,63,6059
BIBB,9/23/2020,3434,2580,63,6077
BIBB,9/24/2020,3443,2584,63,6090
BIBB,9/25/2020,3449,2592,63,6104
BIBB,9/26/2020,3451,2595,63,6109
BIBB,9/27/2020,3465,2598,64,6127
BIBB,9/28/2020,3479,2608,64,6151
BIBB,9/29/2020,3488,2611,65,6164
BIBB,9/30/2020,3494,2620,65,6179
BIBB,10/1/2020,3504,2629,65,6198
BIBB,10/2/2020,3520,2639,65,6224
BIBB,10/3/2020,3528,2641,65,6234
BIBB,10/4/2020,3539,2646,65,6250
BIBB,10/5/2020,3552,2662,65,6279
BIBB,10/6/2020,3575,2672,65,6312
BIBB,10/7/2020,3584,2684,65,6333
BIBB,10/8/2020,3598,2694,65,6357
BIBB,10/9/2020,3604,2698,65,6367
BIBB,10/10/2020,3614,2703,65,6382
BIBB,10/11/2020,3619,2705,65,6389
BIBB,10/12/2020,3636,2712,65,6413
BIBB,10/13/2020,3649,2723,65,6437
BIBB,10/14/2020,3657,2728,65,6450
BIBB,10/15/2020,3663,2733,66,6462
BIBB,10/16/2020,3669,2738,67,6474
BIBB,10/17/2020,3670,2743,67,6480
BIBB,10/18/2020,3671,2744,67,6482
BIBB,10/19/2020,3672,2744,67,6483
BIBB,10/20/2020,3672,2744,67,6483
CLARKE,1/1/2020,0,0,0,0
CLARKE,1/2/2020,0,0,0,0
CLARKE,1/3/2020,0,0,0,0
CLARKE,1/4/2020,0,0,0,0
CLARKE,1/5/2020,0,0,0,0
CLARKE,1/6/2020,0,0,0,0
CLARKE,1/7/2020,0,0,0,0
CLARKE,1/8/2020,0,0,0,0
CLARKE,1/9/2020,0,0,0,0
CLARKE,1/10/2020,0,0,0,0
CLARKE,1/11/2020,0,0,0,0
CLARKE,1/12/2020,0,0,0,0
CLARKE,1/13/2020,0,0,0,0
CLARKE,1/14/2020,0,0,0,0
CLARKE,1/15/2020,0,0,0,0
CLARKE,1/16/2020,0,0,0,0
CLARKE,1/17/2020,0,0,0,0
CLARKE,1/18/2020,0,0,0,0
CLARKE,1/19/2020,0,0,0,0
CLARKE,1/20/2020,0,0,0,0
CLARKE,1/21/2020,0,0,0,0
CLARKE,1/22/2020,0,0,0,0
CLARKE,1/23/2020,0,0,0,0
CLARKE,1/24/2020,0,0,0,0
UNKNOWN,1/19/2020,0,0,0,0
UNKNOWN,1/20/2020,0,0,0,0
UNKNOWN,1/21/2020,0,0,0,0
UNKNOWN,1/22/2020,0,0,0,0
UNKNOWN,1/23/2020,0,0,0,0
UNKNOWN,1/24/2020,0,0,0,0
UNKNOWN,1/25/2020,0,0,0,0
UNKNOWN,1/26/2020,0,0,0,0
UNKNOWN,1/27/2020,0,0,0,0
UNKNOWN,1/28/2020,0,0,0,0
UNKNOWN,1/29/2020,0,0,0,0
UNKNOWN,1/30/2020,0,0,0,0
UNKNOWN,1/31/2020,0,0,0,0
UNKNOWN,2/1/2020,0,0,0,0
UNKNOWN,2/2/2020,0,0,0,0
UNKNOWN,2/3/2020,0,0,0,0
UNKNOWN,2/4/2020,0,0,0,0
UNKNOWN,2/5/2020,0,0,0,0
UNKNOWN,2/6/2020,0,0,0,0
UNKNOWN,2/7/2020,0,0,0,0
UNKNOWN,2/8/2020,0,0,0,0
UNKNOWN,2/9/2020,0,0,0,0
UNKNOWN,2/10/2020,0,0,0,0
UNKNOWN,2/11/2020,0,0,0,0
UNKNOWN,2/12/2020,0,0,0,0
UNKNOWN,2/13/2020,0,0,0,0
UNKNOWN,2/14/2020,0,0,0,0
UNKNOWN,2/15/2020,0,0,0,0
UNKNOWN,2/16/2020,0,0,0,0
UNKNOWN,2/17/2020,0,0,0,0
UNKNOWN,2/18/2020,0,0,0,0
UNKNOWN,2/19/2020,0,0,0,0
UNKNOWN,2/20/2020,0,0,0,0
UNKNOWN,2/21/2020,0,0,0,0
UNKNOWN,2/22/2020,0,0,0,0
UNKNOWN,2/23/2020,0,0,0,0
UNKNOWN,2/24/2020,0,0,0,0
UNKNOWN,2/25/2020,0,0,0,0
UNKNOWN,2/26/2020,0,0,0,0
UNKNOWN,2/27/2020,0,0,0,0
UNKNOWN,2/28/2020,0,0,0,0
UNKNOWN,2/29/2020,0,0,0,0
UNKNOWN,3/1/2020,0,0,0,0
UNKNOWN,3/2/2020,0,0,0,0
UNKNOWN,3/3/2020,0,0,0,0
UNKNOWN,3/4/2020,0,0,0,0
UNKNOWN,3/5/2020,0,0,0,0
UNKNOWN,3/6/2020,0,0,0,0
UNKNOWN,3/7/2020,0,0,0,0
UNKNOWN,3/8/2020,0,0,0,0
UNKNOWN,3/9/2020,0,0,0,0
UNKNOWN,3/10/2020,0,0,0,0
UNKNOWN,3/11/2020,0,0,0,0
UNKNOWN,3/12/2020,0,0,0,0
UNKNOWN,3/13/2020,0,0,0,0
UNKNOWN,3/14/2020,0,0,0,0
UNKNOWN,3/15/2020,0,1,0,1
UNKNOWN,3/16/2020,2,4,0,6
UNKNOWN,3/17/2020,2,4,0,6
UNKNOWN,3/18/2020,4,7,0,11
UNKNOWN,3/19/2020,6,9,0,15
UNKNOWN,3/20/2020,6,9,0,15
UNKNOWN,3/21/2020,6,9,0,15
UNKNOWN,3/22/2020,6,9,0,15
UNKNOWN,3/23/2020,6,9,0,15
UNKNOWN,3/24/2020,6,9,0,15
UNKNOWN,3/25/2020,6,9,0,15
UNKNOWN,3/26/2020,8,9,0,17
UNKNOWN,3/27/2020,8,9,0,17
UNKNOWN,3/28/2020,9,9,0,18
UNKNOWN,3/29/2020,9,9,0,18
UNKNOWN,3/30/2020,9,9,0,18
UNKNOWN,3/31/2020,9,10,0,19
UNKNOWN,4/1/2020,9,10,0,19
UNKNOWN,4/2/2020,10,10,2,22
UNKNOWN,4/3/2020,13,11,3,27
UNKNOWN,4/4/2020,13,11,4,28
UNKNOWN,4/5/2020,13,12,4,29
UNKNOWN,4/6/2020,14,15,7,36
UNKNOWN,4/7/2020,16,15,8,39
UNKNOWN,4/8/2020,18,16,10,44
UNKNOWN,4/9/2020,18,16,10,44
UNKNOWN,4/10/2020,19,16,11,46
UNKNOWN,4/11/2020,21,16,11,48
UNKNOWN,4/12/2020,21,16,13,50
UNKNOWN,4/13/2020,23,20,13,56
UNKNOWN,4/14/2020,26,20,13,59
UNKNOWN,4/15/2020,26,23,13,62
UNKNOWN,4/16/2020,28,26,14,68
UNKNOWN,4/17/2020,29,26,14,69
UNKNOWN,4/18/2020,30,26,14,70
UNKNOWN,4/19/2020,30,26,14,70
UNKNOWN,4/20/2020,31,31,14,76
UNKNOWN,4/21/2020,32,34,16,82
UNKNOWN,4/22/2020,35,36,22,93
UNKNOWN,4/23/2020,38,40,22,100
UNKNOWN,4/24/2020,43,47,22,112
UNKNOWN,4/25/2020,43,48,22,113
UNKNOWN,4/26/2020,43,48,22,113
UNKNOWN,4/27/2020,45,51,22,118
UNKNOWN,4/28/2020,47,52,22,121
UNKNOWN,4/29/2020,47,58,23,128
UNKNOWN,4/30/2020,47,60,25,132
UNKNOWN,5/1/2020,47,61,25,133
UNKNOWN,5/2/2020,47,61,25,133
UNKNOWN,5/3/2020,47,61,25,133
UNKNOWN,5/4/2020,47,62,25,134
UNKNOWN,5/5/2020,47,62,25,134
UNKNOWN,5/6/2020,48,63,25,136
UNKNOWN,5/7/2020,53,66,26,145
UNKNOWN,5/8/2020,54,67,26,147
UNKNOWN,5/9/2020,54,67,26,147
UNKNOWN,5/10/2020,54,67,26,147
UNKNOWN,5/11/2020,55,69,27,151
UNKNOWN,5/12/2020,58,70,27,155
UNKNOWN,5/13/2020,62,74,28,164
UNKNOWN,5/14/2020,68,78,28,174
UNKNOWN,5/15/2020,81,86,29,196
UNKNOWN,5/16/2020,82,89,29,200
UNKNOWN,5/17/2020,88,97,29,214
UNKNOWN,5/18/2020,94,103,29,226
UNKNOWN,5/19/2020,97,105,29,231
UNKNOWN,5/20/2020,98,110,29,237
UNKNOWN,5/21/2020,101,113,29,243
UNKNOWN,5/22/2020,103,118,30,251
UNKNOWN,5/23/2020,105,119,30,254
UNKNOWN,5/24/2020,106,119,30,255
UNKNOWN,5/25/2020,106,119,30,255
UNKNOWN,5/26/2020,112,125,30,267
UNKNOWN,5/27/2020,117,128,30,275
UNKNOWN,5/28/2020,117,135,30,282
UNKNOWN,5/29/2020,119,140,30,289
UNKNOWN,5/30/2020,120,141,30,291
UNKNOWN,5/31/2020,120,141,30,291
UNKNOWN,6/1/2020,125,145,30,300
UNKNOWN,6/2/2020,125,147,30,302
UNKNOWN,6/3/2020,128,147,30,305
UNKNOWN,6/4/2020,130,151,30,311
UNKNOWN,6/5/2020,131,151,30,312
UNKNOWN,6/6/2020,131,153,31,315
UNKNOWN,6/7/2020,133,153,31,317
UNKNOWN,6/8/2020,135,155,31,321
UNKNOWN,6/9/2020,138,156,31,325
UNKNOWN,6/10/2020,138,157,31,326
UNKNOWN,6/11/2020,138,160,31,329
UNKNOWN,6/12/2020,138,161,32,331
UNKNOWN,6/13/2020,138,161,33,332
UNKNOWN,6/14/2020,138,162,33,333
UNKNOWN,6/15/2020,147,168,33,348
UNKNOWN,6/16/2020,150,170,33,353
UNKNOWN,6/17/2020,152,173,33,358
UNKNOWN,6/18/2020,158,177,33,368
UNKNOWN,6/19/2020,161,178,34,373
UNKNOWN,6/20/2020,163,180,34,377
UNKNOWN,6/21/2020,164,180,34,378
UNKNOWN,6/22/2020,169,188,34,391
UNKNOWN,6/23/2020,173,191,34,398
UNKNOWN,6/24/2020,177,195,34,406
UNKNOWN,6/25/2020,184,203,35,422
UNKNOWN,6/26/2020,188,207,36,431
UNKNOWN,6/27/2020,209,226,47,482
UNKNOWN,6/28/2020,231,239,63,533
UNKNOWN,6/29/2020,238,245,63,546
UNKNOWN,6/30/2020,245,250,64,559
UNKNOWN,7/1/2020,252,258,64,574
UNKNOWN,7/2/2020,289,289,85,663
UNKNOWN,7/3/2020,348,358,112,818
UNKNOWN,7/4/2020,348,358,112,818
UNKNOWN,7/5/2020,352,360,112,824
UNKNOWN,7/6/2020,359,375,112,846
UNKNOWN,7/7/2020,364,384,113,861
UNKNOWN,7/8/2020,379,397,113,889
UNKNOWN,7/9/2020,389,403,115,907
UNKNOWN,7/10/2020,410,429,118,957
UNKNOWN,7/11/2020,415,432,120,967
UNKNOWN,7/12/2020,417,435,120,972
UNKNOWN,7/13/2020,439,460,130,1029
UNKNOWN,7/14/2020,453,491,139,1083
UNKNOWN,7/15/2020,462,498,139,1099
UNKNOWN,7/16/2020,483,517,153,1153
UNKNOWN,7/17/2020,507,536,158,1201
UNKNOWN,7/18/2020,512,540,158,1210
UNKNOWN,7/19/2020,514,542,158,1214
UNKNOWN,7/20/2020,533,553,164,1250
UNKNOWN,7/21/2020,547,571,167,1285
UNKNOWN,7/22/2020,559,581,169,1309
UNKNOWN,7/23/2020,572,588,179,1339
UNKNOWN,7/24/2020,581,601,179,1361
UNKNOWN,7/25/2020,583,604,179,1366
UNKNOWN,7/26/2020,585,606,179,1370
UNKNOWN,7/27/2020,594,614,180,1388
UNKNOWN,7/28/2020,605,621,181,1407
UNKNOWN,7/29/2020,611,628,181,1420
UNKNOWN,7/30/2020,613,632,182,1427
UNKNOWN,7/31/2020,618,639,182,1439
UNKNOWN,8/1/2020,619,643,183,1445
UNKNOWN,8/2/2020,619,644,184,1447
UNKNOWN,8/3/2020,621,646,184,1451
UNKNOWN,8/4/2020,626,647,186,1459
UNKNOWN,8/5/2020,629,649,186,1464
UNKNOWN,8/6/2020,634,651,186,1471
UNKNOWN,8/7/2020,635,654,187,1476
UNKNOWN,8/8/2020,635,656,187,1478
UNKNOWN,8/9/2020,636,656,188,1480
UNKNOWN,8/10/2020,637,658,189,1484
UNKNOWN,8/11/2020,637,659,191,1487
UNKNOWN,8/12/2020,641,661,191,1493
UNKNOWN,8/13/2020,641,667,191,1499
UNKNOWN,8/14/2020,643,668,191,1502
UNKNOWN,8/15/2020,644,671,193,1508
UNKNOWN,8/16/2020,645,672,194,1511
UNKNOWN,8/17/2020,647,673,194,1514
UNKNOWN,8/18/2020,648,674,194,1516
UNKNOWN,8/19/2020,649,676,194,1519
UNKNOWN,8/20/2020,651,676,197,1524
UNKNOWN,8/21/2020,654,677,197,1528
UNKNOWN,8/22/2020,654,679,197,1530
UNKNOWN,8/23/2020,655,680,197,1532
UNKNOWN,8/24/2020,657,681,197,1535
UNKNOWN,8/25/2020,662,682,199,1543
UNKNOWN,8/26/2020,664,682,199,1545
UNKNOWN,8/27/2020,666,691,200,1557
UNKNOWN,8/28/2020,670,692,200,1562
UNKNOWN,8/29/2020,671,693,200,1564
UNKNOWN,8/30/2020,672,693,200,1565
UNKNOWN,8/31/2020,673,694,200,1567
UNKNOWN,9/1/2020,675,695,200,1570
UNKNOWN,9/2/2020,676,695,201,1572
UNKNOWN,9/3/2020,678,695,201,1574
UNKNOWN,9/4/2020,680,696,202,1578
UNKNOWN,9/5/2020,680,696,203,1579
UNKNOWN,9/6/2020,680,697,203,1580
UNKNOWN,9/7/2020,680,697,203,1580
UNKNOWN,9/8/2020,682,700,205,1587
UNKNOWN,9/9/2020,684,702,207,1593
UNKNOWN,9/10/2020,686,703,207,1596
UNKNOWN,9/11/2020,687,704,210,1601
UNKNOWN,9/12/2020,687,705,210,1602
UNKNOWN,9/13/2020,687,705,210,1602
UNKNOWN,9/14/2020,691,708,211,1610
UNKNOWN,9/15/2020,703,711,212,1626
UNKNOWN,9/16/2020,704,715,212,1631
UNKNOWN,9/17/2020,708,718,212,1638
UNKNOWN,9/18/2020,710,721,212,1643
UNKNOWN,9/19/2020,711,721,212,1644
UNKNOWN,9/20/2020,712,721,213,1646
UNKNOWN,9/21/2020,715,722,214,1651
UNKNOWN,9/22/2020,719,724,215,1658
UNKNOWN,9/23/2020,720,725,215,1660
UNKNOWN,9/24/2020,722,726,216,1664
UNKNOWN,9/25/2020,725,728,218,1671
UNKNOWN,9/26/2020,726,730,218,1674
UNKNOWN,9/27/2020,727,730,218,1675
UNKNOWN,9/28/2020,732,733,224,1689
UNKNOWN,9/29/2020,733,736,224,1693
UNKNOWN,9/30/2020,734,740,224,1698
UNKNOWN,10/1/2020,740,743,224,1707
UNKNOWN,10/2/2020,742,750,224,1716
UNKNOWN,10/3/2020,742,754,227,1723
UNKNOWN,10/4/2020,742,755,227,1724
UNKNOWN,10/5/2020,749,760,227,1736
UNKNOWN,10/6/2020,752,765,227,1744
UNKNOWN,10/7/2020,762,771,227,1760
UNKNOWN,10/8/2020,762,774,228,1764
UNKNOWN,10/9/2020,771,778,229,1778
UNKNOWN,10/10/2020,775,781,229,1785
UNKNOWN,10/11/2020,775,784,229,1788
UNKNOWN,10/12/2020,779,786,229,1794
UNKNOWN,10/13/2020,785,795,229,1809
UNKNOWN,10/14/2020,787,800,229,1816
UNKNOWN,10/15/2020,790,801,236,1827
UNKNOWN,10/16/2020,800,805,239,1844
UNKNOWN,10/17/2020,809,814,239,1862
UNKNOWN,10/18/2020,809,816,239,1864
UNKNOWN,10/19/2020,810,816,239,1865
UNKNOWN,10/20/2020,810,816,239,1865
NON-GEORGIA RESIDENT,1/1/2020,0,1,0,1
NON-GEORGIA RESIDENT,1/2/2020,0,1,0,1
NON-GEORGIA RESIDENT,1/3/2020,0,1,0,1
NON-GEORGIA RESIDENT,1/4/2020,0,1,0,1
NON-GEORGIA RESIDENT,1/5/2020,0,1,0,1
NON-GEORGIA RESIDENT,1/6/2020,0,1,0,1
NON-GEORGIA RESIDENT,1/7/2020,0,1,0,1
NON-GEORGIA RESIDENT,1/8/2020,0,1,0,1
NON-GEORGIA RESIDENT,1/9/2020,0,1,0,1
NON-GEORGIA RESIDENT,1/10/2020,0,1,0,1
NON-GEORGIA RESIDENT,1/11/2020,0,1,0,1
NON-GEORGIA RESIDENT,1/12/2020,0,1,0,1
NON-GEORGIA RESIDENT,1/13/2020,0,1,0,1
NON-GEORGIA RESIDENT,1/14/2020,0,1,0,1
NON-GEORGIA RESIDENT,1/15/2020,0,1,0,1
NON-GEORGIA RESIDENT,1/16/2020,0,1,0,1
NON-GEORGIA RESIDENT,1/17/2020,0,1,0,1
NON-GEORGIA RESIDENT,1/18/2020,0,1,0,1
NON-GEORGIA RESIDENT,1/19/2020,0,1,0,1
NON-GEORGIA RESIDENT,1/20/2020,0,1,0,1
NON-GEORGIA RESIDENT,1/21/2020,0,1,0,1
NON-GEORGIA RESIDENT,1/22/2020,0,1,0,1
NON-GEORGIA RESIDENT,1/23/2020,0,1,0,1
NON-GEORGIA RESIDENT,1/24/2020,0,1,0,1
NON-GEORGIA RESIDENT,1/25/2020,0,1,0,1
NON-GEORGIA RESIDENT,1/26/2020,0,1,0,1
NON-GEORGIA RESIDENT,1/27/2020,0,1,0,1
NON-GEORGIA RESIDENT,1/28/2020,0,1,0,1
NON-GEORGIA RESIDENT,1/29/2020,0,1,0,1
NON-GEORGIA RESIDENT,1/30/2020,0,1,0,1
NON-GEORGIA RESIDENT,1/31/2020,0,1,0,1
NON-GEORGIA RESIDENT,2/1/2020,0,1,0,1
NON-GEORGIA RESIDENT,2/2/2020,0,1,0,1
NON-GEORGIA RESIDENT,2/3/2020,0,1,0,1
NON-GEORGIA RESIDENT,2/4/2020,0,1,0,1
NON-GEORGIA RESIDENT,2/5/2020,0,1,0,1
NON-GEORGIA RESIDENT,2/6/2020,0,1,0,1
NON-GEORGIA RESIDENT,2/7/2020,0,1,0,1
NON-GEORGIA RESIDENT,2/8/2020,0,1,0,1
NON-GEORGIA RESIDENT,2/9/2020,0,1,0,1
NON-GEORGIA RESIDENT,2/10/2020,0,1,0,1
NON-GEORGIA RESIDENT,2/11/2020,0,1,0,1
NON-GEORGIA RESIDENT,2/12/2020,0,1,0,1
NON-GEORGIA RESIDENT,2/13/2020,0,1,0,1
NON-GEORGIA RESIDENT,2/14/2020,0,1,0,1
NON-GEORGIA RESIDENT,2/15/2020,0,1,0,1
NON-GEORGIA RESIDENT,2/16/2020,0,1,0,1
NON-GEORGIA RESIDENT,2/17/2020,0,1,0,1
NON-GEORGIA RESIDENT,2/18/2020,0,1,0,1
NON-GEORGIA RESIDENT,2/19/2020,0,1,0,1
NON-GEORGIA RESIDENT,2/20/2020,0,1,0,1
NON-GEORGIA RESIDENT,2/21/2020,0,1,0,1
NON-GEORGIA RESIDENT,2/22/2020,0,1,0,1
NON-GEORGIA RESIDENT,2/23/2020,0,1,0,1
NON-GEORGIA RESIDENT,2/24/2020,0,2,0,2
NON-GEORGIA RESIDENT,2/25/2020,0,2,0,2
NON-GEORGIA RESIDENT,2/26/2020,0,2,0,2
NON-GEORGIA RESIDENT,2/27/2020,0,2,0,2
NON-GEORGIA RESIDENT,2/28/2020,0,2,0,2
NON-GEORGIA RESIDENT,2/29/2020,0,2,0,2
NON-GEORGIA RESIDENT,3/1/2020,0,2,0,2
NON-GEORGIA RESIDENT,3/2/2020,0,2,0,2
NON-GEORGIA RESIDENT,3/3/2020,0,2,0,2
NON-GEORGIA RESIDENT,3/4/2020,0,2,0,2
NON-GEORGIA RESIDENT,3/5/2020,0,2,0,2
NON-GEORGIA RESIDENT,3/6/2020,0,2,0,2
NON-GEORGIA RESIDENT,3/7/2020,1,2,0,3
NON-GEORGIA RESIDENT,3/8/2020,1,2,0,3
NON-GEORGIA RESIDENT,3/9/2020,2,3,0,5
NON-GEORGIA RESIDENT,3/10/2020,3,4,0,7
NON-GEORGIA RESIDENT,3/11/2020,3,5,0,8
NON-GEORGIA RESIDENT,3/12/2020,3,6,0,9
NON-GEORGIA RESIDENT,3/13/2020,3,6,0,9
NON-GEORGIA RESIDENT,3/14/2020,4,7,0,11
NON-GEORGIA RESIDENT,3/15/2020,7,7,0,14
NON-GEORGIA RESIDENT,3/16/2020,12,9,0,21
NON-GEORGIA RESIDENT,3/17/2020,14,10,0,24
NON-GEORGIA RESIDENT,3/18/2020,17,14,0,31
NON-GEORGIA RESIDENT,3/19/2020,18,15,0,33
NON-GEORGIA RESIDENT,3/20/2020,21,17,0,38
NON-GEORGIA RESIDENT,3/21/2020,23,19,0,42
NON-GEORGIA RESIDENT,3/22/2020,24,20,0,44
NON-GEORGIA RESIDENT,3/23/2020,27,21,0,48
NON-GEORGIA RESIDENT,3/24/2020,33,23,0,56
NON-GEORGIA RESIDENT,3/25/2020,37,26,0,63
NON-GEORGIA RESIDENT,3/26/2020,40,29,0,69
NON-GEORGIA RESIDENT,3/27/2020,45,36,0,81
NON-GEORGIA RESIDENT,3/28/2020,48,37,0,85
NON-GEORGIA RESIDENT,3/29/2020,51,41,0,92
NON-GEORGIA RESIDENT,3/30/2020,57,44,1,102
NON-GEORGIA RESIDENT,3/31/2020,62,49,3,114
NON-GEORGIA RESIDENT,4/1/2020,66,54,3,123
NON-GEORGIA RESIDENT,4/2/2020,73,65,5,143
NON-GEORGIA RESIDENT,4/3/2020,86,83,6,175
NON-GEORGIA RESIDENT,4/4/2020,105,91,8,204
NON-GEORGIA RESIDENT,4/5/2020,118,99,9,226
NON-GEORGIA RESIDENT,4/6/2020,140,111,18,269
NON-GEORGIA RESIDENT,4/7/2020,146,123,19,288
NON-GEORGIA RESIDENT,4/8/2020,154,133,21,308
NON-GEORGIA RESIDENT,4/9/2020,166,147,24,337
NON-GEORGIA RESIDENT,4/10/2020,171,154,25,350
NON-GEORGIA RESIDENT,4/11/2020,177,160,28,365
NON-GEORGIA RESIDENT,4/12/2020,183,163,29,375
NON-GEORGIA RESIDENT,4/13/2020,189,169,41,399
NON-GEORGIA RESIDENT,4/14/2020,201,178,51,430
NON-GEORGIA RESIDENT,4/15/2020,210,203,58,471
PICKENS,6/3/2020,35,27,0,62
PICKENS,6/4/2020,36,29,0,65
PICKENS,6/5/2020,37,30,0,67
PICKENS,6/6/2020,37,30,0,67
PICKENS,6/7/2020,37,30,0,67
PICKENS,6/8/2020,38,34,0,72
PICKENS,6/9/2020,39,34,0,73
PICKENS,6/10/2020,41,35,0,76
PICKENS,6/11/2020,43,37,0,80
PICKENS,6/12/2020,44,39,0,83
PICKENS,6/13/2020,44,40,0,84
PICKENS,6/14/2020,45,41,0,86
PICKENS,6/15/2020,48,41,0,89
PICKENS,6/16/2020,50,41,0,91
PICKENS,6/17/2020,51,46,0,97
PICKENS,6/18/2020,51,46,0,97
PICKENS,6/19/2020,53,46,0,99
PICKENS,6/20/2020,54,46,0,100
PICKENS,6/21/2020,54,47,0,101
PICKENS,6/22/2020,55,49,0,104
PICKENS,6/23/2020,55,49,0,104
PICKENS,6/24/2020,56,51,0,107
PICKENS,6/25/2020,57,53,0,110
PICKENS,6/26/2020,58,54,0,112
PICKENS,6/27/2020,58,54,0,112
PICKENS,6/28/2020,58,55,0,113
PICKENS,6/29/2020,59,56,0,115
PICKENS,6/30/2020,60,57,0,117
PICKENS,7/1/2020,60,57,0,117
PICKENS,7/2/2020,61,58,0,119
PICKENS,7/3/2020,62,58,0,120
PICKENS,7/4/2020,63,59,0,122
PICKENS,7/5/2020,66,59,0,125
PICKENS,7/6/2020,70,63,0,133
PICKENS,7/7/2020,74,65,1,140
PICKENS,7/8/2020,84,70,1,155
PICKENS,7/9/2020,85,74,1,160
PICKENS,7/10/2020,89,78,1,168
PICKENS,7/11/2020,91,80,1,172
PICKENS,7/12/2020,97,81,1,179
PICKENS,7/13/2020,108,88,1,197
PICKENS,7/14/2020,114,99,1,214
PICKENS,7/15/2020,125,109,1,235
PICKENS,7/16/2020,129,116,1,246
PICKENS,7/17/2020,134,120,1,255
PICKENS,7/18/2020,138,123,1,262
PICKENS,7/19/2020,144,130,2,276
PICKENS,7/20/2020,146,138,2,286
PICKENS,7/21/2020,151,141,2,294
PICKENS,7/22/2020,158,143,2,303
PICKENS,7/23/2020,166,148,2,316
PICKENS,7/24/2020,172,153,2,327
PICKENS,7/25/2020,178,155,2,335
PICKENS,7/26/2020,181,159,2,342
PICKENS,7/27/2020,188,165,2,355
PICKENS,7/28/2020,192,169,2,363
PICKENS,7/29/2020,200,175,2,377
PICKENS,7/30/2020,209,180,2,391
PICKENS,7/31/2020,213,184,3,400
PICKENS,8/1/2020,216,186,3,405
PICKENS,8/2/2020,219,186,3,408
PICKENS,8/3/2020,223,188,3,414
PICKENS,8/4/2020,233,191,3,427
PICKENS,8/5/2020,237,194,4,435
PICKENS,8/6/2020,247,200,4,451
PICKENS,8/7/2020,254,204,6,464
PICKENS,8/8/2020,258,206,6,470
PICKENS,8/9/2020,260,207,6,473
PICKENS,8/10/2020,262,210,6,478
PICKENS,8/11/2020,266,211,6,483
PICKENS,8/12/2020,269,214,6,489
PICKENS,8/13/2020,273,215,6,494
PICKENS,8/14/2020,276,220,6,502
PICKENS,8/15/2020,278,222,6,506
PICKENS,8/16/2020,279,223,6,508
PICKENS,8/17/2020,279,226,6,511
PICKENS,8/18/2020,285,228,6,519
PICKENS,8/19/2020,287,228,6,521
PICKENS,8/20/2020,288,228,7,523
PICKENS,8/21/2020,292,230,7,529
PICKENS,8/22/2020,293,231,7,531
PICKENS,8/23/2020,294,232,7,533
PICKENS,8/24/2020,298,234,8,540
PICKENS,8/25/2020,299,237,8,544
PICKENS,8/26/2020,299,240,8,547
PICKENS,8/27/2020,300,240,8,548
PICKENS,8/28/2020,301,242,8,551
PICKENS,8/29/2020,303,244,8,555
PICKENS,8/30/2020,305,244,8,557
PICKENS,8/31/2020,308,247,8,563
PICKENS,9/1/2020,308,247,9,564
PICKENS,9/2/2020,312,248,9,569
PICKENS,9/3/2020,313,249,9,571
PICKENS,9/4/2020,316,251,9,576
PICKENS,9/5/2020,318,253,9,580
PICKENS,9/6/2020,318,256,9,583
PICKENS,9/7/2020,321,257,9,587
PICKENS,9/8/2020,323,260,9,592
PICKENS,9/9/2020,323,260,9,592
PICKENS,9/10/2020,325,260,9,594
PICKENS,9/11/2020,325,262,9,596
PICKENS,9/12/2020,326,263,9,598
PICKENS,9/13/2020,327,268,9,604
PICKENS,9/14/2020,330,268,9,607
PICKENS,9/15/2020,333,271,9,613
PICKENS,9/16/2020,336,271,9,616
PICKENS,9/17/2020,338,272,9,619
PICKENS,9/18/2020,339,272,9,620
PICKENS,9/19/2020,339,272,9,620
PICKENS,9/20/2020,340,273,9,622
PICKENS,9/21/2020,341,276,9,626
PICKENS,9/22/2020,344,276,9,629
PICKENS,9/23/2020,344,277,9,630
PICKENS,9/24/2020,344,278,9,631
PICKENS,9/25/2020,344,278,9,631
PICKENS,9/26/2020,344,279,9,632
PICKENS,9/27/2020,345,280,9,634
PICKENS,9/28/2020,348,280,9,637
PICKENS,9/29/2020,350,282,9,641
PICKENS,9/30/2020,351,283,9,643
PICKENS,10/1/2020,353,283,9,645
PICKENS,10/2/2020,353,283,9,645
PICKENS,10/3/2020,353,283,9,645
PICKENS,10/4/2020,357,285,9,651
PICKENS,10/5/2020,359,286,9,654
PICKENS,10/6/2020,360,288,9,657
PICKENS,10/7/2020,363,290,9,662
PICKENS,10/8/2020,366,292,9,667
PICKENS,10/9/2020,368,293,9,670
PICKENS,10/10/2020,370,293,9,672
PICKENS,10/11/2020,372,294,9,675
PICKENS,10/12/2020,374,299,9,682
PICKENS,10/13/2020,376,301,10,687
PICKENS,10/14/2020,377,303,10,690
PICKENS,10/15/2020,379,305,11,695
PICKENS,10/16/2020,380,309,11,700
PICKENS,10/17/2020,383,313,11,707
PICKENS,10/18/2020,386,313,11,710
PICKENS,10/19/2020,386,313,11,710
PICKENS,10/20/2020,386,313,11,710
SUMTER,1/1/2020,0,0,0,0
SUMTER,1/2/2020,0,0,0,0
SUMTER,1/3/2020,0,0,0,0
SUMTER,1/4/2020,0,0,0,0
SUMTER,1/5/2020,0,0,0,0
SUMTER,1/6/2020,0,0,0,0
SUMTER,1/7/2020,0,0,0,0
SUMTER,1/8/2020,0,0,0,0
SUMTER,1/9/2020,0,0,0,0
SUMTER,1/10/2020,0,0,0,0
SUMTER,1/11/2020,0,0,0,0
SUMTER,1/12/2020,0,0,0,0
SUMTER,1/13/2020,0,0,0,0
SUMTER,1/14/2020,0,0,0,0
SUMTER,1/15/2020,0,0,0,0
SUMTER,1/16/2020,0,0,0,0
SUMTER,1/17/2020,0,0,0,0
SUMTER,1/18/2020,0,0,0,0
SUMTER,1/19/2020,0,0,0,0
SUMTER,1/20/2020,0,0,0,0
SUMTER,1/21/2020,0,0,0,0
SUMTER,1/22/2020,0,0,0,0
SUMTER,1/23/2020,0,0,0,0
SUMTER,1/24/2020,0,0,0,0
SUMTER,1/25/2020,0,0,0,0
SUMTER,1/26/2020,0,0,0,0
SUMTER,1/27/2020,0,0,0,0
SUMTER,1/28/2020,0,0,0,0
SUMTER,1/29/2020,0,0,0,0
SUMTER,1/30/2020,0,0,0,0
SUMTER,1/31/2020,0,0,0,0
SUMTER,2/1/2020,0,0,0,0
SUMTER,2/2/2020,0,0,0,0
SUMTER,2/3/2020,0,0,0,0
SUMTER,2/4/2020,0,0,0,0
SUMTER,2/5/2020,0,0,0,0
SUMTER,2/6/2020,0,0,0,0
SUMTER,2/7/2020,0,0,0,0
SUMTER,2/8/2020,0,0,0,0
SUMTER,2/9/2020,0,0,0,0
SUMTER,2/10/2020,0,0,0,0
SUMTER,2/11/2020,0,0,0,0
SUMTER,2/12/2020,0,0,0,0
SUMTER,2/13/2020,0,0,0,0
SUMTER,2/14/2020,0,0,0,0
SUMTER,2/15/2020,0,0,0,0
SUMTER,2/16/2020,0,0,0,0
SUMTER,2/17/2020,0,0,0,0
SUMTER,2/18/2020,0,0,0,0
SUMTER,2/19/2020,0,0,0,0
SUMTER,2/20/2020,0,0,0,0
SUMTER,2/21/2020,0,0,0,0
SUMTER,2/22/2020,0,0,0,0
SUMTER,2/23/2020,0,0,0,0
SUMTER,2/24/2020,0,0,0,0
SUMTER,2/25/2020,0,0,0,0
SUMTER,2/26/2020,0,0,0,0
SUMTER,2/27/2020,0,0,0,0
SUMTER,2/28/2020,0,0,0,0
SUMTER,2/29/2020,0,0,0,0
SUMTER,3/1/2020,1,0,0,1
SUMTER,3/2/2020,2,0,0,2
SUMTER,3/3/2020,2,0,0,2
SUMTER,3/4/2020,2,0,0,2
SUMTER,3/5/2020,2,0,0,2
SUMTER,3/6/2020,2,0,0,2
SUMTER,3/7/2020,3,1,0,4
SUMTER,3/8/2020,4,1,0,5
SUMTER,3/9/2020,6,1,0,7
SUMTER,3/10/2020,6,2,0,8
SUMTER,3/11/2020,6,2,0,8
SUMTER,3/12/2020,6,2,0,8
SUMTER,3/13/2020,10,5,0,15
SUMTER,3/14/2020,10,5,0,15
SUMTER,3/15/2020,12,6,0,18
SUMTER,3/16/2020,14,8,0,22
SUMTER,3/17/2020,15,9,0,24
SUMTER,3/18/2020,23,9,0,32
SUMTER,3/19/2020,27,9,0,36
SUMTER,3/20/2020,32,12,0,44
SUMTER,3/21/2020,32,12,0,44
SUMTER,3/22/2020,34,13,0,47
SUMTER,3/23/2020,41,18,0,59
SUMTER,3/24/2020,43,19,0,62
SUMTER,3/25/2020,47,23,0,70
SUMTER,3/26/2020,51,25,0,76
SUMTER,3/27/2020,59,27,0,86
SUMTER,3/28/2020,63,30,0,93
SUMTER,3/29/2020,65,30,0,95
SUMTER,3/30/2020,78,33,0,111
SUMTER,3/31/2020,80,38,0,118
SUMTER,4/1/2020,87,45,0,132
SUMTER,4/2/2020,99,56,0,155
SUMTER,4/3/2020,104,65,0,169
SUMTER,4/4/2020,111,70,0,181
SUMTER,4/5/2020,112,76,0,188
SUMTER,4/6/2020,125,82,0,207
SUMTER,4/7/2020,132,90,0,222
SUMTER,4/8/2020,135,95,0,230
SUMTER,4/9/2020,147,105,0,252
SUMTER,4/10/2020,153,107,0,260
SUMTER,4/11/2020,155,114,0,269
SUMTER,4/12/2020,160,115,0,275
SUMTER,4/13/2020,161,118,0,279
SUMTER,4/14/2020,170,129,0,299
SUMTER,4/15/2020,176,131,0,307
SUMTER,4/16/2020,186,134,0,320
SUMTER,4/17/2020,192,136,0,328
SUMTER,4/18/2020,195,137,0,332
SUMTER,4/19/2020,196,138,0,334
SUMTER,4/20/2020,201,141,0,342
SUMTER,4/21/2020,205,142,0,347
SUMTER,4/22/2020,209,144,0,353
SUMTER,4/23/2020,211,144,0,355
SUMTER,4/24/2020,214,147,0,361
SUMTER,4/25/2020,217,147,0,364
SUMTER,4/26/2020,218,148,0,366
SUMTER,4/27/2020,222,150,0,372
SUMTER,4/28/2020,226,151,0,377
SUMTER,4/29/2020,227,153,0,380
SUMTER,4/30/2020,228,154,0,382
SUMTER,5/1/2020,231,154,0,385
SUMTER,5/2/2020,231,154,0,385
SUMTER,5/3/2020,231,154,0,385
SUMTER,5/4/2020,236,157,0,393
SUMTER,5/5/2020,237,157,0,394
SUMTER,5/6/2020,238,161,0,399
SUMTER,5/7/2020,240,161,0,401
SUMTER,5/8/2020,242,163,0,405
SUMTER,5/9/2020,243,164,0,407
SUMTER,5/10/2020,243,164,0,407
SUMTER,5/11/2020,246,167,0,413
SUMTER,5/12/2020,248,169,0,417
SUMTER,5/13/2020,251,172,0,423
SUMTER,5/14/2020,257,175,0,432
SUMTER,5/15/2020,259,176,0,435
SUMTER,5/16/2020,261,176,0,437
SUMTER,5/17/2020,264,177,0,441
SUMTER,5/18/2020,265,178,0,443
SUMTER,5/19/2020,266,179,1,446
SUMTER,5/20/2020,268,187,1,456
SUMTER,5/21/2020,269,188,1,458
SUMTER,5/22/2020,273,189,1,463
SUMTER,5/23/2020,274,191,1,466
SUMTER,5/24/2020,277,191,1,469
SUMTER,5/25/2020,278,191,1,470
SUMTER,5/26/2020,281,196,1,478
SUMTER,5/27/2020,281,197,1,479
SUMTER,5/28/2020,284,198,1,483
SUMTER,5/29/2020,285,199,1,485
SUMTER,5/30/2020,285,199,1,485
SUMTER,5/31/2020,285,199,1,485
SUMTER,6/1/2020,285,199,2,486
SUMTER,6/2/2020,287,199,2,488
SUMTER,6/3/2020,288,200,2,490
SUMTER,6/4/2020,290,200,2,492
SUMTER,6/5/2020,292,200,2,494
SUMTER,6/6/2020,293,200,2,495
SUMTER,6/7/2020,294,201,2,497
SUMTER,6/8/2020,295,201,2,498
SUMTER,6/9/2020,296,202,2,500
SUMTER,6/10/2020,300,203,2,505
SUMTER,6/11/2020,307,209,2,518
SUMTER,6/12/2020,311,209,2,522
SUMTER,6/13/2020,312,209,2,523
SUMTER,6/14/2020,312,211,2,525
SUMTER,6/15/2020,314,212,2,528
SUMTER,6/16/2020,316,212,2,530
SUMTER,6/17/2020,318,213,2,533
SUMTER,6/18/2020,319,214,2,535
SUMTER,6/19/2020,321,215,2,538
SUMTER,6/20/2020,321,215,2,538
SUMTER,6/21/2020,321,215,2,538
SUMTER,6/22/2020,324,219,2,545
SUMTER,6/23/2020,325,219,2,546
SUMTER,6/24/2020,327,221,2,550
SUMTER,6/25/2020,330,223,2,555
SUMTER,6/26/2020,331,225,2,558
SUMTER,6/27/2020,331,226,2,559
SUMTER,6/28/2020,332,228,2,562
SUMTER,6/29/2020,339,232,2,573
SUMTER,6/30/2020,343,235,2,580
SUMTER,7/1/2020,344,237,2,583
SUMTER,7/2/2020,347,237,2,586
SUMTER,7/3/2020,348,239,2,589
SUMTER,7/4/2020,351,241,2,594
SUMTER,7/5/2020,351,246,2,599
SUMTER,7/6/2020,361,252,2,615
SUMTER,7/7/2020,366,255,3,624
SUMTER,7/8/2020,371,257,3,631
SUMTER,7/9/2020,376,258,3,637
SUMTER,7/10/2020,381,260,3,644
SUMTER,7/11/2020,383,261,3,647
SUMTER,7/12/2020,384,262,3,649
SUMTER,7/13/2020,387,265,3,655
SUMTER,7/14/2020,390,267,3,660
SUMTER,7/15/2020,394,272,3,669
SUMTER,7/16/2020,396,272,3,671
SUMTER,7/17/2020,399,274,3,676
SUMTER,7/18/2020,402,279,3,684
SUMTER,7/19/2020,406,279,3,688
SUMTER,7/20/2020,406,280,3,689
SUMTER,7/21/2020,409,283,3,695
SUMTER,7/22/2020,411,288,3,702
SUMTER,7/23/2020,414,288,3,705
SUMTER,7/24/2020,414,290,3,707
SUMTER,7/25/2020,417,293,3,713
SUMTER,7/26/2020,421,295,3,719
SUMTER,7/27/2020,422,295,3,720
SUMTER,7/28/2020,428,296,3,727
SUMTER,7/29/2020,430,300,3,733
SUMTER,7/30/2020,434,300,3,737
SUMTER,7/31/2020,438,300,3,741
SUMTER,8/1/2020,441,301,3,745
SUMTER,8/2/2020,441,303,3,747
SUMTER,8/3/2020,444,305,3,752
SUMTER,8/4/2020,445,308,3,756
SUMTER,8/5/2020,449,310,3,762
SUMTER,8/6/2020,450,311,3,764
SUMTER,8/7/2020,453,315,3,771
SUMTER,8/8/2020,454,315,3,772
SUMTER,8/9/2020,455,317,3,775
SUMTER,8/10/2020,459,323,3,785
SUMTER,8/11/2020,461,325,3,789
SUMTER,8/12/2020,466,327,3,796
SUMTER,8/13/2020,469,331,3,803
SUMTER,8/14/2020,474,331,3,808
SUMTER,8/15/2020,478,333,3,814
SUMTER,8/16/2020,479,336,3,818
SUMTER,8/17/2020,481,340,3,824
SUMTER,8/18/2020,483,344,3,830
SUMTER,8/19/2020,485,345,3,833
SUMTER,8/20/2020,485,346,3,834
SUMTER,8/21/2020,490,348,3,841
SUMTER,8/22/2020,494,350,3,847
SUMTER,8/23/2020,498,350,3,851
SUMTER,8/24/2020,499,352,3,854
SUMTER,8/25/2020,503,352,3,858
SUMTER,8/26/2020,504,355,3,862
SUMTER,8/27/2020,505,356,3,864
SUMTER,8/28/2020,506,358,3,867
SUMTER,8/29/2020,510,360,3,873
SUMTER,8/30/2020,511,362,3,876
SUMTER,8/31/2020,514,364,3,881
SUMTER,9/1/2020,519,365,3,887
SUMTER,9/2/2020,523,365,3,891
SUMTER,9/3/2020,523,367,3,893
SUMTER,9/4/2020,529,367,3,899
SUMTER,9/5/2020,530,368,3,901
SUMTER,9/6/2020,532,370,3,905
SUMTER,9/7/2020,532,371,3,906
SUMTER,9/8/2020,533,371,3,907
SUMTER,9/9/2020,534,372,3,909
SUMTER,9/10/2020,538,373,3,914
SUMTER,9/11/2020,540,375,3,918
SUMTER,9/12/2020,540,375,3,918
SUMTER,9/13/2020,540,376,3,919
SUMTER,9/14/2020,542,379,3,924
SUMTER,9/15/2020,542,379,3,924
SUMTER,9/16/2020,542,380,3,925
MACON,2/18/2020,0,0,0,0
HENRY,8/24/2020,2793,2060,45,4898
MACON,2/19/2020,0,0,0,0
MACON,2/20/2020,0,0,0,0
MACON,2/21/2020,0,0,0,0
MACON,2/22/2020,0,0,0,0
MACON,2/23/2020,0,0,0,0
MACON,2/24/2020,0,0,0,0
MACON,2/25/2020,0,0,0,0
MACON,2/26/2020,0,0,0,0
MACON,2/27/2020,0,0,0,0
MACON,2/28/2020,0,0,0,0
MACON,2/29/2020,0,0,0,0
MACON,3/1/2020,0,0,0,0
MACON,3/2/2020,0,0,0,0
MACON,3/3/2020,0,0,0,0
MACON,3/4/2020,0,0,0,0
MACON,3/5/2020,0,0,0,0
MACON,3/6/2020,0,0,0,0
MACON,3/7/2020,0,0,0,0
MACON,3/8/2020,0,0,0,0
MACON,3/9/2020,0,0,0,0
MACON,3/10/2020,0,0,0,0
MACON,3/11/2020,0,0,0,0
MACON,3/12/2020,0,0,0,0
MACON,3/13/2020,0,0,0,0
MACON,3/14/2020,0,0,0,0
MACON,3/15/2020,0,0,0,0
MACON,3/16/2020,1,0,0,1
MACON,3/17/2020,1,0,0,1
MACON,3/18/2020,1,0,0,1
MACON,3/19/2020,1,0,0,1
MACON,3/20/2020,1,1,0,2
MACON,3/21/2020,2,1,0,3
MACON,3/22/2020,2,1,0,3
MACON,3/23/2020,2,1,0,3
MACON,3/24/2020,3,1,0,4
MACON,3/25/2020,3,1,0,4
MACON,3/26/2020,4,1,0,5
MACON,3/27/2020,4,1,0,5
MACON,3/28/2020,4,1,0,5
MACON,3/29/2020,5,2,0,7
MACON,3/30/2020,6,2,0,8
MACON,3/31/2020,6,6,0,12
HENRY,8/25/2020,2821,2080,45,4946
MACON,4/1/2020,8,7,0,15
MACON,4/2/2020,8,8,0,16
MACON,4/3/2020,8,10,0,18
MACON,4/4/2020,8,10,0,18
MACON,4/5/2020,8,11,0,19
MACON,4/6/2020,11,13,0,24
MACON,4/7/2020,14,15,0,29
MACON,4/8/2020,18,18,0,36
MACON,4/9/2020,23,20,0,43
MACON,4/10/2020,23,21,0,44
MACON,4/11/2020,23,21,0,44
MACON,4/12/2020,24,22,0,46
MACON,4/13/2020,25,25,0,50
MACON,4/14/2020,27,29,0,56
MACON,4/15/2020,29,31,0,60
MACON,4/16/2020,31,31,0,62
MACON,4/17/2020,33,33,0,66
MACON,4/18/2020,35,35,0,70
MACON,4/19/2020,37,35,0,72
MACON,4/20/2020,37,37,0,74
MACON,4/21/2020,39,37,0,76
MACON,4/22/2020,40,38,0,78
MACON,4/23/2020,41,38,0,79
MACON,4/24/2020,41,38,0,79
MACON,4/25/2020,41,38,0,79
MACON,4/26/2020,41,38,0,79
MACON,4/27/2020,43,39,0,82
MACON,4/28/2020,43,39,0,82
MACON,4/29/2020,43,40,0,83
MACON,4/30/2020,43,40,0,83
MACON,5/1/2020,43,41,0,84
MACON,5/2/2020,43,41,0,84
MACON,5/3/2020,43,42,0,85
MACON,5/4/2020,44,43,0,87
MACON,5/5/2020,45,45,0,90
MACON,5/6/2020,45,45,0,90
MACON,5/7/2020,45,46,0,91
MACON,5/8/2020,45,47,0,92
MACON,5/9/2020,45,47,0,92
MACON,5/10/2020,45,49,0,94
MACON,5/11/2020,45,49,0,94
MACON,5/12/2020,45,49,0,94
MACON,5/13/2020,45,51,0,96
MACON,5/14/2020,45,51,0,96
MACON,5/15/2020,46,52,0,98
MACON,5/16/2020,46,52,0,98
MACON,5/17/2020,47,52,0,99
MACON,5/18/2020,47,52,0,99
MACON,5/19/2020,47,54,0,101
MACON,5/20/2020,48,54,0,102
MACON,5/21/2020,48,55,0,103
MACON,5/22/2020,48,55,0,103
MACON,5/23/2020,48,55,0,103
MACON,5/24/2020,48,55,0,103
MACON,5/25/2020,48,56,0,104
MACON,5/26/2020,48,57,0,105
MACON,5/27/2020,48,57,0,105
MACON,5/28/2020,48,57,0,105
MACON,5/29/2020,48,57,0,105
MACON,5/30/2020,48,58,0,106
MACON,5/31/2020,48,59,0,107
MACON,6/1/2020,49,59,0,108
MACON,6/2/2020,51,61,0,112
MACON,6/3/2020,52,61,0,113
MACON,6/4/2020,52,61,0,113
MACON,6/5/2020,52,61,0,113
MACON,6/6/2020,52,61,0,113
MACON,6/7/2020,52,61,0,113
MACON,6/8/2020,53,61,0,114
MACON,6/9/2020,53,61,0,114
MACON,6/10/2020,53,61,0,114
MACON,6/11/2020,54,61,0,115
MACON,6/12/2020,54,61,0,115
MACON,6/13/2020,54,61,0,115
MACON,6/14/2020,54,61,0,115
MACON,6/15/2020,54,62,0,116
MACON,6/16/2020,54,62,0,116
MACON,6/17/2020,54,62,0,116
MACON,6/18/2020,55,62,0,117
MACON,6/19/2020,55,62,0,117
MACON,6/20/2020,56,62,0,118
MACON,6/21/2020,56,62,0,118
MACON,6/22/2020,57,62,0,119
MACON,6/23/2020,58,62,0,120
MACON,6/24/2020,59,62,0,121
MACON,6/25/2020,61,63,0,124
MACON,6/26/2020,61,65,0,126
MACON,6/27/2020,61,65,0,126
MACON,6/28/2020,62,65,0,127
MACON,6/29/2020,64,66,0,130
MACON,6/30/2020,67,66,0,133
MACON,7/1/2020,68,68,0,136
MACON,7/2/2020,69,69,0,138
MACON,7/3/2020,74,71,0,145
MACON,7/4/2020,74,72,0,146
MACON,7/5/2020,74,75,0,149
MACON,7/6/2020,74,77,0,151
MACON,7/7/2020,74,77,0,151
MACON,7/8/2020,75,78,0,153
MACON,7/9/2020,75,79,0,154
MACON,7/10/2020,77,80,1,158
MACON,7/11/2020,77,80,1,158
MACON,7/12/2020,77,81,1,159
MACON,7/13/2020,79,82,1,162
MACON,7/14/2020,81,83,1,165
MACON,7/15/2020,82,83,1,166
MACON,7/16/2020,84,84,1,169
MACON,7/17/2020,84,85,1,170
MACON,7/18/2020,86,85,1,172
MACON,7/19/2020,86,85,1,172
MACON,7/20/2020,86,87,1,174
MACON,7/21/2020,88,87,1,176
MACON,7/22/2020,88,87,1,176
MACON,7/23/2020,89,88,1,178
MACON,7/24/2020,89,88,1,178
MACON,7/25/2020,90,88,1,179
MACON,7/26/2020,92,89,1,182
MACON,7/27/2020,92,89,1,182
MACON,7/28/2020,92,90,1,183
MACON,7/29/2020,92,90,1,183
MACON,7/30/2020,93,90,1,184
MACON,7/31/2020,94,90,1,185
MACON,8/1/2020,95,91,1,187
MACON,8/2/2020,95,91,1,187
MACON,8/3/2020,95,91,1,187
MACON,8/4/2020,95,91,1,187
MACON,8/5/2020,97,91,1,189
MACON,8/6/2020,98,91,1,190
MACON,8/7/2020,99,91,1,191
MACON,8/8/2020,99,91,1,191
MACON,8/9/2020,100,92,1,193
MACON,8/10/2020,101,92,1,194
MACON,8/11/2020,101,93,1,195
MACON,8/12/2020,101,94,1,196
MACON,8/13/2020,101,95,1,197
MACON,8/14/2020,101,95,1,197
MACON,8/15/2020,102,95,1,198
MACON,8/16/2020,102,97,1,200
MACON,8/17/2020,102,97,1,200
MACON,8/18/2020,103,99,1,203
MACON,8/19/2020,103,99,1,203
MACON,8/20/2020,104,99,1,204
MACON,8/21/2020,106,100,1,207
MACON,8/22/2020,107,100,1,208
MACON,8/23/2020,108,100,1,209
MACON,8/24/2020,108,100,1,209
MACON,8/25/2020,108,100,1,209
MACON,8/26/2020,108,100,1,209
MACON,8/27/2020,108,100,1,209
MACON,8/28/2020,109,101,1,211
MACON,8/29/2020,111,101,1,213
MACON,8/30/2020,111,101,1,213
MACON,8/31/2020,112,101,1,214
MACON,9/1/2020,112,102,1,215
MACON,9/2/2020,113,103,1,217
MACON,9/3/2020,113,103,1,217
MACON,9/4/2020,114,104,1,219
MACON,9/5/2020,114,104,1,219
MACON,9/6/2020,115,105,1,221
MACON,9/7/2020,117,106,1,224
MACON,9/8/2020,119,106,1,226
MACON,9/9/2020,119,107,1,227
MACON,9/10/2020,120,108,1,229
MACON,9/11/2020,120,108,1,229
MACON,9/12/2020,120,109,1,230
MACON,9/13/2020,120,109,1,230
MACON,9/14/2020,120,110,1,231
MACON,9/15/2020,120,110,1,231
MACON,9/16/2020,122,110,1,233
MACON,9/17/2020,122,110,1,233
MACON,9/18/2020,122,110,1,233
MACON,9/19/2020,122,110,1,233
MACON,9/20/2020,122,110,1,233
MACON,9/21/2020,122,110,1,233
MACON,9/22/2020,124,111,1,236
MACON,9/23/2020,124,111,1,236
MACON,9/24/2020,124,113,1,238
MACON,9/25/2020,124,113,1,238
MACON,9/26/2020,124,113,1,238
MACON,9/27/2020,124,113,1,238
MACON,9/28/2020,124,113,1,238
MACON,9/29/2020,124,113,1,238
MACON,9/30/2020,124,113,1,238
MACON,10/1/2020,124,113,1,238
MACON,10/2/2020,124,114,1,239
MACON,10/3/2020,124,116,1,241
MACON,10/4/2020,124,116,1,241
MACON,10/5/2020,124,116,1,241
MACON,10/6/2020,124,116,1,241
MACON,10/7/2020,124,116,1,241
MACON,10/8/2020,124,116,1,241
MACON,10/9/2020,124,116,1,241
MACON,10/10/2020,125,116,1,242
MACON,10/11/2020,125,116,1,242
MACON,10/12/2020,125,116,1,242
MACON,10/13/2020,125,116,1,242
MACON,10/14/2020,125,116,1,242
MACON,10/15/2020,126,116,1,243
MACON,10/16/2020,127,116,1,244
MACON,10/17/2020,127,116,1,244
MACON,10/18/2020,127,116,1,244
MACON,10/19/2020,127,116,1,244
MACON,10/20/2020,127,116,1,244
PICKENS,1/1/2020,0,0,0,0
PICKENS,1/2/2020,0,0,0,0
PICKENS,1/3/2020,0,0,0,0
PICKENS,1/4/2020,0,0,0,0
PICKENS,1/5/2020,0,0,0,0
PICKENS,1/6/2020,0,0,0,0
PICKENS,1/7/2020,0,0,0,0
PICKENS,1/8/2020,0,0,0,0
PICKENS,1/9/2020,0,0,0,0
PICKENS,1/10/2020,0,0,0,0
PICKENS,1/11/2020,0,0,0,0
PICKENS,1/12/2020,0,0,0,0
PICKENS,1/13/2020,0,0,0,0
PICKENS,1/14/2020,0,0,0,0
PICKENS,1/15/2020,0,0,0,0
PICKENS,1/16/2020,0,0,0,0
PICKENS,1/17/2020,0,0,0,0
PICKENS,1/18/2020,0,0,0,0
PICKENS,1/19/2020,0,0,0,0
PICKENS,1/20/2020,0,0,0,0
PICKENS,1/21/2020,0,0,0,0
PICKENS,1/22/2020,0,0,0,0
PICKENS,1/23/2020,0,0,0,0
PICKENS,1/24/2020,0,0,0,0
PICKENS,1/25/2020,0,0,0,0
PICKENS,1/26/2020,0,0,0,0
PICKENS,1/27/2020,0,0,0,0
PICKENS,1/28/2020,0,0,0,0
PICKENS,1/29/2020,0,0,0,0
PICKENS,1/30/2020,0,0,0,0
PICKENS,1/31/2020,0,0,0,0
PICKENS,2/1/2020,0,0,0,0
PICKENS,2/2/2020,0,0,0,0
PICKENS,2/3/2020,0,0,0,0
PICKENS,2/4/2020,0,0,0,0
PICKENS,2/5/2020,0,0,0,0
PICKENS,2/6/2020,0,0,0,0
PICKENS,2/7/2020,0,0,0,0
PICKENS,2/8/2020,0,0,0,0
PICKENS,2/9/2020,0,0,0,0
PICKENS,2/10/2020,0,0,0,0
PICKENS,2/11/2020,0,0,0,0
PICKENS,2/12/2020,0,0,0,0
PICKENS,2/13/2020,0,0,0,0
PICKENS,2/14/2020,0,0,0,0
PICKENS,2/15/2020,0,0,0,0
PICKENS,2/16/2020,0,0,0,0
PICKENS,2/17/2020,0,0,0,0
PICKENS,2/18/2020,0,0,0,0
PICKENS,2/19/2020,0,0,0,0
PICKENS,2/20/2020,0,0,0,0
PICKENS,2/21/2020,0,0,0,0
PICKENS,2/22/2020,0,0,0,0
PICKENS,2/23/2020,0,0,0,0
PICKENS,2/24/2020,0,0,0,0
PICKENS,2/25/2020,0,0,0,0
PICKENS,2/26/2020,0,0,0,0
PICKENS,2/27/2020,0,0,0,0
PICKENS,2/28/2020,0,0,0,0
PICKENS,2/29/2020,0,0,0,0
PICKENS,3/1/2020,0,0,0,0
PICKENS,3/2/2020,0,0,0,0
PICKENS,3/3/2020,0,0,0,0
PICKENS,3/4/2020,0,0,0,0
PICKENS,3/5/2020,0,0,0,0
PICKENS,3/6/2020,0,0,0,0
PICKENS,3/7/2020,0,0,0,0
PICKENS,3/8/2020,0,1,0,1
PICKENS,3/9/2020,0,1,0,1
PICKENS,3/10/2020,0,1,0,1
PICKENS,3/11/2020,1,1,0,2
PICKENS,3/12/2020,1,1,0,2
PICKENS,3/13/2020,1,1,0,2
PICKENS,3/14/2020,2,1,0,3
PICKENS,3/15/2020,2,1,0,3
PICKENS,3/16/2020,3,2,0,5
PICKENS,3/17/2020,3,2,0,5
PICKENS,3/18/2020,3,3,0,6
PICKENS,3/19/2020,3,3,0,6
PICKENS,3/20/2020,4,3,0,7
PICKENS,3/21/2020,5,3,0,8
PICKENS,3/22/2020,6,3,0,9
PICKENS,3/23/2020,7,3,0,10
PICKENS,3/24/2020,7,4,0,11
PICKENS,3/25/2020,7,4,0,11
PICKENS,3/26/2020,7,4,0,11
PICKENS,3/27/2020,7,4,0,11
PICKENS,3/28/2020,8,4,0,12
PICKENS,3/29/2020,8,4,0,12
PICKENS,3/30/2020,8,4,0,12
PICKENS,3/31/2020,8,4,0,12
PICKENS,4/1/2020,8,4,0,12
PICKENS,4/2/2020,8,4,0,12
PICKENS,4/3/2020,8,4,0,12
PICKENS,4/4/2020,9,4,0,13
PICKENS,4/5/2020,9,5,0,14
PICKENS,4/6/2020,9,5,0,14
PICKENS,4/7/2020,9,5,0,14
PICKENS,4/8/2020,9,5,0,14
PICKENS,4/9/2020,9,5,0,14
PICKENS,4/10/2020,10,5,0,15
PICKENS,4/11/2020,10,6,0,16
PICKENS,4/12/2020,10,6,0,16
PICKENS,4/13/2020,10,7,0,17
PICKENS,4/14/2020,10,7,0,17
PICKENS,4/15/2020,10,8,0,18
PICKENS,4/16/2020,10,8,0,18
PICKENS,4/17/2020,10,8,0,18
PICKENS,4/18/2020,11,9,0,20
PICKENS,4/19/2020,14,9,0,23
PICKENS,4/20/2020,14,9,0,23
PICKENS,4/21/2020,15,9,0,24
PICKENS,4/22/2020,16,9,0,25
PICKENS,4/23/2020,16,9,0,25
PICKENS,4/24/2020,16,10,0,26
PICKENS,4/25/2020,17,11,0,28
PICKENS,4/26/2020,17,11,0,28
PICKENS,4/27/2020,19,13,0,32
PICKENS,4/28/2020,20,13,0,33
PICKENS,4/29/2020,20,13,0,33
PICKENS,4/30/2020,20,14,0,34
PICKENS,5/1/2020,21,14,0,35
PICKENS,5/2/2020,21,14,0,35
PICKENS,5/3/2020,21,14,0,35
PICKENS,5/4/2020,21,15,0,36
PICKENS,5/5/2020,21,16,0,37
PICKENS,5/6/2020,21,16,0,37
PICKENS,5/7/2020,23,16,0,39
PICKENS,5/8/2020,24,16,0,40
PICKENS,5/9/2020,25,16,0,41
PICKENS,5/10/2020,25,16,0,41
PICKENS,5/11/2020,25,17,0,42
PICKENS,5/12/2020,25,17,0,42
PICKENS,5/13/2020,26,19,0,45
PICKENS,5/14/2020,26,19,0,45
PICKENS,5/15/2020,27,19,0,46
PICKENS,5/16/2020,27,19,0,46
PICKENS,5/17/2020,29,19,0,48
PICKENS,5/18/2020,30,19,0,49
PICKENS,5/19/2020,30,19,0,49
PICKENS,5/20/2020,31,20,0,51
PICKENS,5/21/2020,31,20,0,51
PICKENS,5/22/2020,31,20,0,51
PICKENS,5/23/2020,31,21,0,52
PICKENS,5/24/2020,32,21,0,53
PICKENS,5/25/2020,33,21,0,54
PICKENS,5/26/2020,33,22,0,55
PICKENS,5/27/2020,33,22,0,55
PICKENS,5/28/2020,33,22,0,55
PICKENS,5/29/2020,33,22,0,55
PICKENS,5/30/2020,33,23,0,56
PICKENS,5/31/2020,33,24,0,57
PICKENS,6/1/2020,34,25,0,59
PICKENS,6/2/2020,34,25,0,59
HENRY,8/26/2020,2827,2088,45,4960
HENRY,8/27/2020,2842,2094,45,4981
HENRY,8/28/2020,2853,2102,45,5000
HENRY,8/29/2020,2860,2109,46,5015
HENRY,8/30/2020,2867,2120,46,5033
HENRY,8/31/2020,2889,2131,46,5066
HENRY,9/1/2020,2900,2138,46,5084
HENRY,9/2/2020,2908,2145,46,5099
HENRY,9/3/2020,2919,2154,46,5119
HENRY,9/4/2020,2937,2170,46,5153
HENRY,9/5/2020,2949,2181,46,5176
HENRY,9/6/2020,2952,2185,46,5183
HENRY,9/7/2020,2972,2196,46,5214
HENRY,9/8/2020,2982,2203,46,5231
HENRY,9/9/2020,2996,2207,46,5249
HENRY,9/10/2020,3006,2217,46,5269
HENRY,9/11/2020,3012,2227,46,5285
HENRY,9/12/2020,3021,2233,46,5300
HENRY,9/13/2020,3026,2236,46,5308
HENRY,9/14/2020,3038,2244,46,5328
HENRY,9/15/2020,3054,2254,46,5354
HENRY,9/16/2020,3066,2265,46,5377
HENRY,9/17/2020,3075,2273,46,5394
HENRY,9/18/2020,3085,2286,46,5417
HENRY,9/19/2020,3091,2291,47,5429
HENRY,9/20/2020,3104,2298,47,5449
HENRY,9/21/2020,3114,2311,47,5472
HENRY,9/22/2020,3119,2318,47,5484
HENRY,9/23/2020,3136,2332,47,5515
HENRY,9/24/2020,3146,2347,47,5540
HENRY,9/25/2020,3154,2352,47,5553
HENRY,9/26/2020,3163,2355,47,5565
HENRY,9/27/2020,3176,2363,47,5586
HENRY,9/28/2020,3189,2373,47,5609
HENRY,9/29/2020,3203,2388,47,5638
HENRY,9/30/2020,3216,2396,47,5659
HENRY,10/1/2020,3232,2401,47,5680
HENRY,10/2/2020,3241,2411,47,5699
HENRY,10/3/2020,3248,2417,47,5712
HENRY,10/4/2020,3256,2423,47,5726
HENRY,10/5/2020,3269,2436,47,5752
HENRY,10/6/2020,3281,2443,47,5771
HENRY,10/7/2020,3286,2456,47,5789
HENRY,10/8/2020,3301,2462,47,5810
HENRY,10/9/2020,3307,2471,47,5825
HENRY,10/10/2020,3317,2479,47,5843
HENRY,10/11/2020,3322,2480,47,5849
HENRY,10/12/2020,3336,2497,47,5880
HENRY,10/13/2020,3351,2507,47,5905
HENRY,10/14/2020,3354,2516,47,5917
HENRY,10/15/2020,3361,2523,47,5931
HENRY,10/16/2020,3368,2533,47,5948
HENRY,10/17/2020,3371,2535,47,5953
HENRY,10/18/2020,3372,2537,47,5956
HENRY,10/19/2020,3373,2537,47,5957
HENRY,10/20/2020,3373,2537,47,5957
LOWNDES,1/1/2020,0,0,0,0
LOWNDES,1/2/2020,0,0,0,0
LOWNDES,1/3/2020,0,0,0,0
LOWNDES,1/4/2020,0,0,0,0
LOWNDES,1/5/2020,0,0,0,0
LOWNDES,1/6/2020,0,0,0,0
LOWNDES,1/7/2020,0,0,0,0
LOWNDES,1/8/2020,0,0,0,0
LOWNDES,1/9/2020,0,0,0,0
LOWNDES,1/10/2020,0,0,0,0
LOWNDES,1/11/2020,0,0,0,0
LOWNDES,1/12/2020,0,0,0,0
LOWNDES,1/13/2020,0,0,0,0
LOWNDES,1/14/2020,0,0,0,0
LOWNDES,1/15/2020,0,0,0,0
LOWNDES,1/16/2020,0,0,0,0
LOWNDES,1/17/2020,0,0,0,0
LOWNDES,1/18/2020,0,0,0,0
LOWNDES,1/19/2020,0,0,0,0
LOWNDES,1/20/2020,0,0,0,0
LOWNDES,1/21/2020,0,0,0,0
LOWNDES,1/22/2020,0,0,0,0
LOWNDES,1/23/2020,0,0,0,0
LOWNDES,1/24/2020,0,0,0,0
LOWNDES,1/25/2020,0,0,0,0
LOWNDES,1/26/2020,0,0,0,0
LOWNDES,1/27/2020,0,0,0,0
LOWNDES,1/28/2020,0,0,0,0
LOWNDES,1/29/2020,0,0,0,0
LOWNDES,1/30/2020,0,0,0,0
LOWNDES,1/31/2020,0,0,0,0
LOWNDES,2/1/2020,0,0,0,0
LOWNDES,2/2/2020,0,0,0,0
LOWNDES,2/3/2020,0,0,0,0
LOWNDES,2/4/2020,0,0,0,0
LOWNDES,2/5/2020,0,0,0,0
LOWNDES,2/6/2020,0,0,0,0
LOWNDES,2/7/2020,0,0,0,0
LOWNDES,2/8/2020,0,0,0,0
LOWNDES,2/9/2020,0,0,0,0
LOWNDES,2/10/2020,0,0,0,0
LOWNDES,2/11/2020,0,0,0,0
LOWNDES,2/12/2020,0,0,0,0
LOWNDES,2/13/2020,0,0,0,0
LOWNDES,2/14/2020,0,0,0,0
LOWNDES,2/15/2020,0,0,0,0
LOWNDES,2/16/2020,0,0,0,0
LOWNDES,2/17/2020,0,0,0,0
LOWNDES,2/18/2020,0,0,0,0
LOWNDES,2/19/2020,0,0,0,0
LOWNDES,2/20/2020,0,1,0,1
LOWNDES,2/21/2020,0,2,0,2
LOWNDES,2/22/2020,0,2,0,2
LOWNDES,2/23/2020,0,2,0,2
LOWNDES,2/24/2020,0,2,0,2
LOWNDES,2/25/2020,0,2,0,2
LOWNDES,2/26/2020,0,2,0,2
LOWNDES,2/27/2020,0,2,0,2
LOWNDES,2/28/2020,0,2,0,2
LOWNDES,2/29/2020,0,2,0,2
LOWNDES,3/1/2020,1,2,0,3
LOWNDES,3/2/2020,1,2,0,3
LOWNDES,3/3/2020,2,2,0,4
LOWNDES,3/4/2020,2,2,0,4
LOWNDES,3/5/2020,2,2,0,4
LOWNDES,3/6/2020,2,2,0,4
LOWNDES,3/7/2020,2,2,0,4
LOWNDES,3/8/2020,3,3,0,6
LOWNDES,3/9/2020,3,3,0,6
LOWNDES,3/10/2020,3,4,0,7
LOWNDES,3/11/2020,3,5,0,8
LOWNDES,3/12/2020,3,5,0,8
LOWNDES,3/13/2020,5,6,0,11
LOWNDES,3/14/2020,9,6,0,15
LOWNDES,3/15/2020,10,7,0,17
LOWNDES,3/16/2020,11,7,0,18
LOWNDES,3/17/2020,11,7,0,18
LOWNDES,3/18/2020,12,7,0,19
LOWNDES,3/19/2020,12,8,0,20
LOWNDES,3/20/2020,13,11,0,24
LOWNDES,3/21/2020,13,13,0,26
LOWNDES,3/22/2020,13,14,0,27
LOWNDES,3/23/2020,13,14,0,27
LOWNDES,3/24/2020,14,14,0,28
LOWNDES,3/25/2020,14,14,0,28
LOWNDES,3/26/2020,15,15,0,30
LOWNDES,3/27/2020,18,16,0,34
LOWNDES,3/28/2020,19,17,0,36
LOWNDES,3/29/2020,19,17,0,36
LOWNDES,3/30/2020,22,18,0,40
LOWNDES,3/31/2020,26,19,0,45
LOWNDES,4/1/2020,27,20,0,47
LOWNDES,4/2/2020,29,21,0,50
LOWNDES,4/3/2020,32,24,0,56
LOWNDES,4/4/2020,33,25,0,58
LOWNDES,4/5/2020,34,26,0,60
LOWNDES,4/6/2020,35,28,0,63
LOWNDES,4/7/2020,39,31,0,70
LOWNDES,4/8/2020,40,33,0,73
LOWNDES,4/9/2020,44,35,0,79
LOWNDES,4/10/2020,49,36,0,85
LOWNDES,4/11/2020,51,37,0,88
LOWNDES,4/12/2020,54,41,0,95
LOWNDES,4/13/2020,56,42,0,98
LOWNDES,4/14/2020,60,48,0,108
LOWNDES,4/15/2020,63,51,0,114
LOWNDES,4/16/2020,65,55,0,120
LOWNDES,4/17/2020,67,56,0,123
LOWNDES,4/18/2020,72,59,0,131
LOWNDES,4/19/2020,73,60,0,133
LOWNDES,4/20/2020,87,66,0,153
LOWNDES,4/21/2020,92,69,0,161
LOWNDES,4/22/2020,93,71,0,164
LOWNDES,4/23/2020,98,76,0,174
LOWNDES,4/24/2020,99,78,0,177
LOWNDES,4/25/2020,99,80,0,179
LOWNDES,4/26/2020,100,80,0,180
LOWNDES,4/27/2020,101,82,0,183
LOWNDES,4/28/2020,103,82,0,185
LOWNDES,4/29/2020,106,83,0,189
LOWNDES,4/30/2020,108,84,0,192
LOWNDES,5/1/2020,111,88,0,199
LOWNDES,5/2/2020,112,89,0,201
LOWNDES,5/3/2020,114,89,0,203
LOWNDES,5/4/2020,123,91,0,214
LOWNDES,5/5/2020,124,94,0,218
LOWNDES,5/6/2020,125,96,0,221
LOWNDES,5/7/2020,127,98,0,225
LOWNDES,5/8/2020,130,98,0,228
LOWNDES,5/9/2020,131,98,0,229
LOWNDES,5/10/2020,131,101,0,232
LOWNDES,5/11/2020,132,106,0,238
LOWNDES,5/12/2020,138,110,0,248
LOWNDES,5/13/2020,141,110,0,251
LOWNDES,5/14/2020,148,114,0,262
LOWNDES,5/15/2020,152,117,0,269
LOWNDES,5/16/2020,152,117,0,269
LOWNDES,5/17/2020,153,120,0,273
LOWNDES,5/18/2020,155,124,1,280
LOWNDES,5/19/2020,158,125,1,284
LOWNDES,5/20/2020,158,128,1,287
LOWNDES,5/21/2020,161,133,1,295
LOWNDES,5/22/2020,166,138,1,305
LOWNDES,5/23/2020,171,141,1,313
LOWNDES,5/24/2020,171,143,1,315
LOWNDES,5/25/2020,171,148,1,320
LOWNDES,5/26/2020,180,151,1,332
LOWNDES,5/27/2020,185,158,1,344
LOWNDES,5/28/2020,192,170,1,363
LOWNDES,5/29/2020,202,176,1,379
LOWNDES,5/30/2020,207,178,1,386
LOWNDES,5/31/2020,209,182,1,392
LOWNDES,6/1/2020,242,202,1,445
LOWNDES,6/2/2020,255,214,1,470
LOWNDES,6/3/2020,278,226,1,505
LOWNDES,6/4/2020,295,240,1,536
LOWNDES,6/5/2020,310,250,1,561
LOWNDES,6/6/2020,313,258,1,572
LOWNDES,6/7/2020,321,261,1,583
LOWNDES,6/8/2020,353,287,1,641
LOWNDES,6/9/2020,366,298,1,665
LOWNDES,6/10/2020,384,319,1,704
LOWNDES,6/11/2020,410,336,2,748
LOWNDES,6/12/2020,427,356,2,785
LOWNDES,6/13/2020,441,362,2,805
LOWNDES,6/14/2020,448,370,3,821
LOWNDES,6/15/2020,478,398,3,879
LOWNDES,6/16/2020,495,407,4,906
LOWNDES,6/17/2020,513,419,4,936
LOWNDES,6/18/2020,535,439,4,978
LOWNDES,6/19/2020,560,462,4,1026
LOWNDES,6/20/2020,585,473,4,1062
LOWNDES,6/21/2020,597,478,4,1079
LOWNDES,6/22/2020,624,492,4,1120
LOWNDES,6/23/2020,660,520,4,1184
LOWNDES,6/24/2020,686,541,4,1231
LOWNDES,6/25/2020,711,564,4,1279
LOWNDES,6/26/2020,740,583,4,1327
LOWNDES,6/27/2020,751,592,4,1347
LOWNDES,6/28/2020,761,598,4,1363
LOWNDES,6/29/2020,814,639,5,1458
LOWNDES,6/30/2020,875,674,7,1556
LOWNDES,7/1/2020,928,722,8,1658
LOWNDES,7/2/2020,972,748,16,1736
LOWNDES,7/3/2020,986,757,17,1760
LOWNDES,7/4/2020,998,761,17,1776
LOWNDES,7/5/2020,1020,778,17,1815
LOWNDES,7/6/2020,1074,815,18,1907
LOWNDES,7/7/2020,1123,845,21,1989
LOWNDES,7/8/2020,1164,875,23,2062
LOWNDES,7/9/2020,1200,905,24,2129
LOWNDES,7/10/2020,1231,930,24,2185
LOWNDES,7/11/2020,1245,942,24,2211
LOWNDES,7/12/2020,1252,951,24,2227
LOWNDES,7/13/2020,1299,991,24,2314
LOWNDES,7/14/2020,1324,1010,24,2358
LOWNDES,7/15/2020,1355,1031,24,2410
LOWNDES,7/16/2020,1406,1115,24,2545
LOWNDES,7/17/2020,1428,1138,24,2590
LOWNDES,7/18/2020,1438,1141,24,2603
LOWNDES,7/19/2020,1445,1151,24,2620
LOWNDES,7/20/2020,1488,1193,25,2706
LOWNDES,7/21/2020,1517,1217,26,2760
LOWNDES,7/22/2020,1533,1233,26,2792
LOWNDES,7/23/2020,1544,1246,26,2816
LOWNDES,7/24/2020,1563,1255,26,2844
LOWNDES,7/25/2020,1579,1263,26,2868
LOWNDES,7/26/2020,1584,1270,26,2880
LOWNDES,7/27/2020,1620,1293,26,2939
LOWNDES,7/28/2020,1638,1313,26,2977
LOWNDES,7/29/2020,1660,1329,27,3016
LOWNDES,7/30/2020,1675,1343,28,3046
LOWNDES,7/31/2020,1689,1359,28,3076
LOWNDES,8/1/2020,1700,1368,28,3096
LOWNDES,8/2/2020,1710,1376,28,3114
LOWNDES,8/3/2020,1730,1395,28,3153
LOWNDES,8/4/2020,1744,1404,28,3176
LOWNDES,8/5/2020,1756,1415,29,3200
LOWNDES,8/6/2020,1770,1430,30,3230
LOWNDES,8/7/2020,1777,1441,30,3248
LOWNDES,8/8/2020,1781,1450,30,3261
LOWNDES,8/9/2020,1784,1453,30,3267
LOWNDES,8/10/2020,1800,1475,32,3307
LOWNDES,8/11/2020,1811,1484,32,3327
LOWNDES,8/12/2020,1826,1492,32,3350
LOWNDES,8/13/2020,1835,1496,32,3363
LOWNDES,8/14/2020,1845,1503,32,3380
LOWNDES,8/15/2020,1849,1509,32,3390
LOWNDES,8/16/2020,1855,1511,32,3398
LOWNDES,8/17/2020,1870,1521,33,3424
LOWNDES,8/18/2020,1875,1528,33,3436
LOWNDES,8/19/2020,1882,1535,33,3450
LOWNDES,8/20/2020,1889,1541,33,3463
LOWNDES,8/21/2020,1898,1549,33,3480
LOWNDES,8/22/2020,1902,1553,33,3488
LOWNDES,8/23/2020,1908,1557,33,3498
LOWNDES,8/24/2020,1919,1567,34,3520
LOWNDES,8/25/2020,1922,1574,34,3530
LOWNDES,8/26/2020,1931,1585,35,3551
LOWNDES,8/27/2020,1939,1590,35,3564
LOWNDES,8/28/2020,1946,1598,35,3579
LOWNDES,8/29/2020,1953,1602,35,3590
LOWNDES,8/30/2020,1959,1607,35,3601
LOWNDES,8/31/2020,1974,1615,35,3624
LOWNDES,9/1/2020,1985,1628,35,3648
LOWNDES,9/2/2020,1992,1633,35,3660
LOWNDES,9/3/2020,1997,1643,36,3676
LOWNDES,9/4/2020,2008,1649,36,3693
LOWNDES,9/5/2020,2012,1652,36,3700
LOWNDES,9/6/2020,2019,1655,37,3711
LOWNDES,9/7/2020,2032,1661,37,3730
LOWNDES,9/8/2020,2040,1668,37,3745
LOWNDES,9/9/2020,2046,1677,38,3761
LOWNDES,9/10/2020,2053,1682,42,3777
LOWNDES,9/11/2020,2065,1688,42,3795
LOWNDES,9/12/2020,2069,1690,43,3802
LOWNDES,9/13/2020,2074,1694,43,3811
LOWNDES,9/14/2020,2076,1702,44,3822
LOWNDES,9/15/2020,2082,1708,44,3834
LOWNDES,9/16/2020,2085,1716,44,3845
LOWNDES,9/17/2020,2089,1718,45,3852
LOWNDES,9/18/2020,2096,1724,45,3865
LOWNDES,9/19/2020,2101,1728,45,3874
LOWNDES,9/20/2020,2101,1729,45,3875
LOWNDES,9/21/2020,2106,1740,46,3892
LOWNDES,9/22/2020,2111,1745,46,3902
LOWNDES,9/23/2020,2117,1750,46,3913
LOWNDES,9/24/2020,2125,1756,46,3927
LOWNDES,9/25/2020,2131,1762,47,3940
LOWNDES,9/26/2020,2136,1768,47,3951
LOWNDES,9/27/2020,2139,1772,47,3958
LOWNDES,9/28/2020,2145,1781,47,3973
LOWNDES,9/29/2020,2154,1787,47,3988
LOWNDES,9/30/2020,2165,1794,47,4006
LOWNDES,10/1/2020,2169,1801,47,4017
LOWNDES,10/2/2020,2179,1810,47,4036
LOWNDES,10/3/2020,2190,1817,49,4056
LOWNDES,10/4/2020,2200,1823,49,4072
LOWNDES,10/5/2020,2219,1831,49,4099
LOWNDES,10/6/2020,2228,1837,49,4114
LOWNDES,10/7/2020,2240,1846,49,4135
LOWNDES,10/8/2020,2250,1855,50,4155
LOWNDES,10/9/2020,2255,1867,50,4172
LOWNDES,10/10/2020,2261,1872,50,4183
LOWNDES,10/11/2020,2265,1882,50,4197
LOWNDES,10/12/2020,2278,1895,50,4223
LOWNDES,10/13/2020,2301,1910,50,4261
LOWNDES,10/14/2020,2305,1928,50,4283
LOWNDES,10/15/2020,2318,1937,50,4305
LOWNDES,10/16/2020,2327,1945,50,4322
LOWNDES,10/17/2020,2329,1946,50,4325
LOWNDES,10/18/2020,2330,1946,50,4326
LOWNDES,10/19/2020,2330,1948,50,4328
LOWNDES,10/20/2020,2330,1948,50,4328
MACON,1/1/2020,0,0,0,0
MACON,1/2/2020,0,0,0,0
MACON,1/3/2020,0,0,0,0
MACON,1/4/2020,0,0,0,0
MACON,1/5/2020,0,0,0,0
MACON,1/6/2020,0,0,0,0
MACON,1/7/2020,0,0,0,0
MACON,1/8/2020,0,0,0,0
MACON,1/9/2020,0,0,0,0
MACON,1/10/2020,0,0,0,0
MACON,1/11/2020,0,0,0,0
MACON,1/12/2020,0,0,0,0
MACON,1/13/2020,0,0,0,0
MACON,1/14/2020,0,0,0,0
MACON,1/15/2020,0,0,0,0
MACON,1/16/2020,0,0,0,0
MACON,1/17/2020,0,0,0,0
MACON,1/18/2020,0,0,0,0
MACON,1/19/2020,0,0,0,0
MACON,1/20/2020,0,0,0,0
MACON,1/21/2020,0,0,0,0
MACON,1/22/2020,0,0,0,0
MACON,1/23/2020,0,0,0,0
MACON,1/24/2020,0,0,0,0
MACON,1/25/2020,0,0,0,0
MACON,1/26/2020,0,0,0,0
MACON,1/27/2020,0,0,0,0
MACON,1/28/2020,0,0,0,0
MACON,1/29/2020,0,0,0,0
MACON,1/30/2020,0,0,0,0
MACON,1/31/2020,0,0,0,0
MACON,2/1/2020,0,0,0,0
MACON,2/2/2020,0,0,0,0
MACON,2/3/2020,0,0,0,0
MACON,2/4/2020,0,0,0,0
MACON,2/5/2020,0,0,0,0
MACON,2/6/2020,0,0,0,0
MACON,2/7/2020,0,0,0,0
MACON,2/8/2020,0,0,0,0
MACON,2/9/2020,0,0,0,0
MACON,2/10/2020,0,0,0,0
MACON,2/11/2020,0,0,0,0
MACON,2/12/2020,0,0,0,0
MACON,2/13/2020,0,0,0,0
MACON,2/14/2020,0,0,0,0
MACON,2/15/2020,0,0,0,0
MACON,2/16/2020,0,0,0,0
MACON,2/17/2020,0,0,0,0
SUMTER,9/17/2020,543,380,3,926
SUMTER,9/18/2020,544,381,3,928
SUMTER,9/19/2020,545,381,3,929
SUMTER,9/20/2020,545,381,3,929
SUMTER,9/21/2020,546,381,3,930
SUMTER,9/22/2020,546,381,3,930
SUMTER,9/23/2020,547,381,3,931
SUMTER,9/24/2020,547,383,3,933
SUMTER,9/25/2020,548,384,3,935
SUMTER,9/26/2020,549,384,3,936
SUMTER,9/27/2020,550,384,3,937
SUMTER,9/28/2020,550,385,3,938
SUMTER,9/29/2020,550,386,3,939
SUMTER,9/30/2020,550,386,3,939
SUMTER,10/1/2020,552,386,3,941
SUMTER,10/2/2020,552,387,3,942
SUMTER,10/3/2020,552,388,3,943
SUMTER,10/4/2020,552,390,3,945
SUMTER,10/5/2020,552,390,3,945
SUMTER,10/6/2020,553,390,3,946
SUMTER,10/7/2020,553,392,3,948
SUMTER,10/8/2020,554,393,3,950
SUMTER,10/9/2020,556,394,3,953
SUMTER,10/10/2020,557,394,3,954
SUMTER,10/11/2020,557,394,3,954
SUMTER,10/12/2020,558,394,3,955
SUMTER,10/13/2020,559,394,3,956
SUMTER,10/14/2020,559,394,3,956
SUMTER,10/15/2020,559,395,3,957
SUMTER,10/16/2020,559,395,3,957
SUMTER,10/17/2020,559,395,3,957
SUMTER,10/18/2020,560,395,3,958
SUMTER,10/19/2020,560,395,3,958
SUMTER,10/20/2020,560,395,3,958
WILCOX,1/1/2020,0,0,0,0
WILCOX,1/2/2020,0,0,0,0
WILCOX,1/3/2020,0,0,0,0
WILCOX,1/4/2020,0,0,0,0
WILCOX,1/5/2020,0,0,0,0
WILCOX,1/6/2020,0,0,0,0
WILCOX,1/7/2020,0,0,0,0
WILCOX,1/8/2020,0,0,0,0
WILCOX,1/9/2020,0,0,0,0
WILCOX,1/10/2020,0,0,0,0
WILCOX,1/11/2020,0,0,0,0
WILCOX,1/12/2020,0,0,0,0
WILCOX,1/13/2020,0,0,0,0
WILCOX,1/14/2020,0,0,0,0
WILCOX,1/15/2020,0,0,0,0
WILCOX,1/16/2020,0,0,0,0
WILCOX,1/17/2020,0,0,0,0
WILCOX,1/18/2020,0,0,0,0
WILCOX,1/19/2020,0,0,0,0
WILCOX,1/20/2020,0,0,0,0
WILCOX,1/21/2020,0,0,0,0
WILCOX,1/22/2020,0,0,0,0
WILCOX,1/23/2020,0,0,0,0
WILCOX,1/24/2020,0,0,0,0
WILCOX,1/25/2020,0,0,0,0
WILCOX,1/26/2020,0,0,0,0
WILCOX,1/27/2020,0,0,0,0
WILCOX,1/28/2020,0,0,0,0
WILCOX,1/29/2020,0,0,0,0
WILCOX,1/30/2020,0,0,0,0
WILCOX,1/31/2020,0,0,0,0
WILCOX,2/1/2020,0,0,0,0
WILCOX,2/2/2020,0,0,0,0
WILCOX,2/3/2020,0,0,0,0
WILCOX,2/4/2020,0,0,0,0
WILCOX,2/5/2020,0,0,0,0
WILCOX,2/6/2020,0,0,0,0
WILCOX,2/7/2020,0,0,0,0
WILCOX,2/8/2020,0,0,0,0
WILCOX,2/9/2020,0,0,0,0
WILCOX,2/10/2020,0,0,0,0
WILCOX,2/11/2020,0,0,0,0
WILCOX,2/12/2020,0,0,0,0
WILCOX,2/13/2020,0,0,0,0
WILCOX,2/14/2020,0,0,0,0
WILCOX,2/15/2020,0,0,0,0
WILCOX,2/16/2020,0,0,0,0
WILCOX,2/17/2020,0,0,0,0
WILCOX,2/18/2020,0,0,0,0
WILCOX,2/19/2020,0,0,0,0
WILCOX,2/20/2020,0,0,0,0
WILCOX,2/21/2020,0,0,0,0
WILCOX,2/22/2020,0,0,0,0
WILCOX,2/23/2020,0,0,0,0
WILCOX,2/24/2020,0,0,0,0
WILCOX,2/25/2020,0,0,0,0
WILCOX,2/26/2020,0,0,0,0
WILCOX,2/27/2020,0,0,0,0
WILCOX,2/28/2020,0,0,0,0
WILCOX,2/29/2020,0,0,0,0
WILCOX,3/1/2020,0,0,0,0
WILCOX,3/2/2020,0,0,0,0
WILCOX,3/3/2020,0,0,0,0
WILCOX,3/4/2020,0,0,0,0
WILCOX,3/5/2020,0,0,0,0
WILCOX,3/6/2020,0,0,0,0
WILCOX,3/7/2020,0,0,0,0
WILCOX,3/8/2020,0,0,0,0
WILCOX,3/9/2020,0,0,0,0
WILCOX,3/10/2020,0,0,0,0
WILCOX,3/11/2020,0,0,0,0
WILCOX,3/12/2020,0,0,0,0
COLUMBIA,3/13/2020,4,2,0,6
WILCOX,3/13/2020,0,0,0,0
WILCOX,3/14/2020,0,0,0,0
WILCOX,3/15/2020,0,0,0,0
WILCOX,3/16/2020,0,0,0,0
WILCOX,3/17/2020,0,0,0,0
WILCOX,3/18/2020,0,0,0,0
WILCOX,3/19/2020,0,1,0,1
WILCOX,3/20/2020,0,1,0,1
WILCOX,3/21/2020,0,1,0,1
WILCOX,3/22/2020,0,1,0,1
WILCOX,3/23/2020,1,1,0,2
WILCOX,3/24/2020,1,1,0,2
WILCOX,3/25/2020,1,1,0,2
WILCOX,3/26/2020,1,1,0,2
WILCOX,3/27/2020,1,1,0,2
WILCOX,3/28/2020,1,2,0,3
WILCOX,3/29/2020,1,2,0,3
WILCOX,3/30/2020,1,3,0,4
WILCOX,3/31/2020,1,3,0,4
WILCOX,4/1/2020,1,3,0,4
WILCOX,4/2/2020,1,4,0,5
WILCOX,4/3/2020,3,6,0,9
WILCOX,4/4/2020,5,9,0,14
WILCOX,4/5/2020,6,9,0,15
WILCOX,4/6/2020,7,11,0,18
WILCOX,4/7/2020,8,12,0,20
WILCOX,4/8/2020,13,14,0,27
WILCOX,4/9/2020,17,16,0,33
WILCOX,4/10/2020,19,17,0,36
WILCOX,4/11/2020,20,18,0,38
WILCOX,4/12/2020,20,19,0,39
WILCOX,4/13/2020,21,20,0,41
WILCOX,4/14/2020,22,20,0,42
WILCOX,4/15/2020,24,22,0,46
WILCOX,4/16/2020,26,22,0,48
WILCOX,4/17/2020,29,24,0,53
WILCOX,4/18/2020,30,27,0,57
WILCOX,4/19/2020,32,29,0,61
WILCOX,4/20/2020,33,29,0,62
WILCOX,4/21/2020,35,32,0,67
WILCOX,4/22/2020,36,36,0,72
WILCOX,4/23/2020,36,38,0,74
WILCOX,4/24/2020,38,39,0,77
WILCOX,4/25/2020,46,44,0,90
WILCOX,4/26/2020,46,44,0,90
WILCOX,4/27/2020,48,45,0,93
WILCOX,4/28/2020,48,45,0,93
WILCOX,4/29/2020,48,46,0,94
WILCOX,4/30/2020,48,46,0,94
WILCOX,5/1/2020,48,46,0,94
WILCOX,5/2/2020,48,46,0,94
WILCOX,5/3/2020,48,46,0,94
WILCOX,5/4/2020,48,46,0,94
WILCOX,5/5/2020,49,46,0,95
WILCOX,5/6/2020,49,46,0,95
WILCOX,5/7/2020,49,46,0,95
WILCOX,5/8/2020,49,46,0,95
WILCOX,5/9/2020,49,46,0,95
WILCOX,5/10/2020,49,46,0,95
WILCOX,5/11/2020,50,48,0,98
WILCOX,5/12/2020,50,48,0,98
WILCOX,5/13/2020,50,48,0,98
WILCOX,5/14/2020,51,48,0,99
WILCOX,5/15/2020,51,48,0,99
WILCOX,5/16/2020,54,48,0,102
WILCOX,5/17/2020,54,48,0,102
WILCOX,5/18/2020,54,49,0,103
WILCOX,5/19/2020,54,49,0,103
WILCOX,5/20/2020,55,50,0,105
WILCOX,5/21/2020,55,51,0,106
WILCOX,5/22/2020,55,51,0,106
WILCOX,5/23/2020,55,53,0,108
WILCOX,5/24/2020,55,54,0,109
WILCOX,5/25/2020,56,54,0,110
WILCOX,5/26/2020,56,57,0,113
WILCOX,5/27/2020,57,57,0,114
WILCOX,5/28/2020,57,57,0,114
WILCOX,5/29/2020,57,57,0,114
WILCOX,5/30/2020,57,57,0,114
WILCOX,5/31/2020,57,57,0,114
WILCOX,6/1/2020,57,58,0,115
WILCOX,6/2/2020,57,58,0,115
WILCOX,6/3/2020,57,58,0,115
WILCOX,6/4/2020,57,58,0,115
WILCOX,6/5/2020,57,59,0,116
WILCOX,6/6/2020,57,60,0,117
WILCOX,6/7/2020,58,60,0,118
WILCOX,6/8/2020,58,61,0,119
WILCOX,6/9/2020,58,62,0,120
WILCOX,6/10/2020,58,62,0,120
WILCOX,6/11/2020,58,63,0,121
WILCOX,6/12/2020,58,63,0,121
WILCOX,6/13/2020,58,63,0,121
WILCOX,6/14/2020,60,64,0,124
WILCOX,6/15/2020,60,64,0,124
WILCOX,6/16/2020,60,64,0,124
WILCOX,6/17/2020,60,64,0,124
WILCOX,6/18/2020,61,65,0,126
WILCOX,6/19/2020,61,65,0,126
WILCOX,6/20/2020,61,65,0,126
WILCOX,6/21/2020,61,65,0,126
WILCOX,6/22/2020,62,65,0,127
WILCOX,6/23/2020,62,66,0,128
WILCOX,6/24/2020,62,67,0,129
WILCOX,6/25/2020,62,68,0,130
WILCOX,6/26/2020,63,68,0,131
WILCOX,6/27/2020,63,68,0,131
WILCOX,6/28/2020,63,68,0,131
WILCOX,6/29/2020,63,69,0,132
WILCOX,6/30/2020,63,69,0,132
WILCOX,7/1/2020,63,69,0,132
WILCOX,7/2/2020,64,70,0,134
WILCOX,7/3/2020,64,70,0,134
WILCOX,7/4/2020,64,70,0,134
WILCOX,7/5/2020,64,71,0,135
WILCOX,7/6/2020,64,71,0,135
WILCOX,7/7/2020,65,71,0,136
WILCOX,7/8/2020,67,71,0,138
WILCOX,7/9/2020,67,73,0,140
WILCOX,7/10/2020,67,74,0,141
WILCOX,7/11/2020,67,74,0,141
WILCOX,7/12/2020,67,74,0,141
WILCOX,7/13/2020,67,75,0,142
WILCOX,7/14/2020,67,76,0,143
WILCOX,7/15/2020,67,76,0,143
WILCOX,7/16/2020,68,77,0,145
WILCOX,7/17/2020,68,77,0,145
WILCOX,7/18/2020,68,77,0,145
WILCOX,7/19/2020,68,79,0,147
WILCOX,7/20/2020,68,79,0,147
WILCOX,7/21/2020,68,80,0,148
WILCOX,7/22/2020,68,80,0,148
WILCOX,7/23/2020,68,84,0,152
WILCOX,7/24/2020,68,85,0,153
WILCOX,7/25/2020,69,85,0,154
WILCOX,7/26/2020,70,87,0,157
WILCOX,7/27/2020,72,89,0,161
WILCOX,7/28/2020,73,92,0,165
WILCOX,7/29/2020,73,94,1,168
WILCOX,7/30/2020,74,98,1,173
WILCOX,7/31/2020,75,102,1,178
WILCOX,8/1/2020,75,104,1,180
WILCOX,8/2/2020,75,105,1,181
WILCOX,8/3/2020,78,107,1,186
WILCOX,8/4/2020,78,110,1,189
WILCOX,8/5/2020,80,110,1,191
WILCOX,8/6/2020,80,110,1,191
WILCOX,8/7/2020,81,110,1,192
WILCOX,8/8/2020,82,110,1,193
WILCOX,8/9/2020,82,112,1,195
WILCOX,8/10/2020,82,115,1,198
WILCOX,8/11/2020,83,117,1,201
WILCOX,8/12/2020,84,118,1,203
WILCOX,8/13/2020,85,119,1,205
WILCOX,8/14/2020,86,120,1,207
WILCOX,8/15/2020,87,121,1,209
WILCOX,8/16/2020,88,122,1,211
WILCOX,8/17/2020,88,123,1,212
WILCOX,8/18/2020,89,125,1,215
WILCOX,8/19/2020,89,125,1,215
WILCOX,8/20/2020,89,126,1,216
WILCOX,8/21/2020,89,126,1,216
WILCOX,8/22/2020,90,126,1,217
WILCOX,8/23/2020,90,126,1,217
WILCOX,8/24/2020,91,129,1,221
WILCOX,8/25/2020,92,130,1,223
WILCOX,8/26/2020,92,131,1,224
WILCOX,8/27/2020,92,131,1,224
WILCOX,8/28/2020,93,132,1,226
WILCOX,8/29/2020,93,132,1,226
WILCOX,8/30/2020,93,133,1,227
WILCOX,8/31/2020,93,133,1,227
WILCOX,9/1/2020,95,134,1,230
WILCOX,9/2/2020,95,134,1,230
WILCOX,9/3/2020,95,135,1,231
WILCOX,9/4/2020,95,135,1,231
WILCOX,9/5/2020,95,135,1,231
WILCOX,9/6/2020,95,135,1,231
WILCOX,9/7/2020,95,136,1,232
WILCOX,9/8/2020,95,136,1,232
WILCOX,9/9/2020,97,137,1,235
WILCOX,9/10/2020,97,137,1,235
WILCOX,9/11/2020,98,137,1,236
WILCOX,9/12/2020,99,137,1,237
WILCOX,9/13/2020,100,138,1,239
WILCOX,9/14/2020,100,138,1,239
WILCOX,9/15/2020,102,139,1,242
WILCOX,9/16/2020,103,139,1,243
WILCOX,9/17/2020,103,139,1,243
WILCOX,9/18/2020,103,139,1,243
WILCOX,9/19/2020,103,141,1,245
WILCOX,9/20/2020,103,141,1,245
WILCOX,9/21/2020,104,141,1,246
WILCOX,9/22/2020,105,141,1,247
WILCOX,9/23/2020,105,141,1,247
WILCOX,9/24/2020,105,141,1,247
WILCOX,9/25/2020,105,141,1,247
WILCOX,9/26/2020,105,141,1,247
WILCOX,9/27/2020,105,141,1,247
WILCOX,9/28/2020,105,142,1,248
WILCOX,9/29/2020,105,142,1,248
WILCOX,9/30/2020,105,142,1,248
WILCOX,10/1/2020,105,142,1,248
WILCOX,10/2/2020,105,143,1,249
WILCOX,10/3/2020,105,143,1,249
WILCOX,10/4/2020,105,143,1,249
WILCOX,10/5/2020,105,143,1,249
WILCOX,10/6/2020,105,143,1,249
WILCOX,10/7/2020,106,143,1,250
WILCOX,10/8/2020,106,143,1,250
WILCOX,10/9/2020,106,143,1,250
WILCOX,10/10/2020,107,143,1,251
WILCOX,10/11/2020,107,143,1,251
WILCOX,10/12/2020,107,143,1,251
WILCOX,10/13/2020,107,143,1,251
WILCOX,10/14/2020,108,143,1,252
WILCOX,10/15/2020,108,143,1,252
WILCOX,10/16/2020,109,143,1,253
WILCOX,10/17/2020,109,143,1,253
WILCOX,10/18/2020,109,143,1,253
WILCOX,10/19/2020,109,143,1,253
WILCOX,10/20/2020,109,143,1,253
COLUMBIA,1/1/2020,0,0,0,0
COLUMBIA,1/2/2020,0,0,0,0
COLUMBIA,1/3/2020,0,0,0,0
COLUMBIA,1/4/2020,0,0,0,0
COLUMBIA,1/5/2020,0,0,0,0
COLUMBIA,1/6/2020,0,0,0,0
COLUMBIA,1/7/2020,0,0,0,0
COLUMBIA,1/8/2020,0,0,0,0
COLUMBIA,1/9/2020,0,0,0,0
COLUMBIA,1/10/2020,0,0,0,0
COLUMBIA,1/11/2020,0,0,0,0
COLUMBIA,1/12/2020,0,0,0,0
COLUMBIA,1/13/2020,0,0,0,0
COLUMBIA,1/14/2020,0,0,0,0
COLUMBIA,1/15/2020,0,0,0,0
COLUMBIA,1/16/2020,0,0,0,0
COLUMBIA,1/17/2020,0,0,0,0
COLUMBIA,1/18/2020,0,0,0,0
COLUMBIA,1/19/2020,0,0,0,0
COLUMBIA,1/20/2020,0,0,0,0
COLUMBIA,1/21/2020,0,0,0,0
COLUMBIA,1/22/2020,0,0,0,0
COLUMBIA,1/23/2020,0,0,0,0
COLUMBIA,1/24/2020,0,0,0,0
COLUMBIA,1/25/2020,0,0,0,0
COLUMBIA,1/26/2020,0,0,0,0
COLUMBIA,1/27/2020,0,0,0,0
COLUMBIA,1/28/2020,0,0,0,0
COLUMBIA,1/29/2020,0,0,0,0
COLUMBIA,1/30/2020,0,0,0,0
COLUMBIA,1/31/2020,0,0,0,0
COLUMBIA,2/1/2020,0,0,0,0
COLUMBIA,2/2/2020,0,0,0,0
COLUMBIA,2/3/2020,0,0,0,0
COLUMBIA,2/4/2020,0,0,0,0
COLUMBIA,2/5/2020,0,0,0,0
COLUMBIA,2/6/2020,0,0,0,0
COLUMBIA,2/7/2020,0,0,0,0
COLUMBIA,2/8/2020,0,0,0,0
COLUMBIA,2/9/2020,0,0,0,0
COLUMBIA,2/10/2020,0,0,0,0
COLUMBIA,2/11/2020,0,0,0,0
COLUMBIA,2/12/2020,0,0,0,0
COLUMBIA,2/13/2020,0,0,0,0
COLUMBIA,2/14/2020,0,0,0,0
COLUMBIA,2/15/2020,0,0,0,0
COLUMBIA,2/16/2020,0,0,0,0
COLUMBIA,2/17/2020,0,0,0,0
COLUMBIA,2/18/2020,0,0,0,0
COLUMBIA,2/19/2020,0,0,0,0
COLUMBIA,2/20/2020,0,0,0,0
COLUMBIA,2/21/2020,0,0,0,0
COLUMBIA,2/22/2020,0,0,0,0
COLUMBIA,2/23/2020,0,0,0,0
COLUMBIA,2/24/2020,0,0,0,0
COLUMBIA,2/25/2020,0,0,0,0
COLUMBIA,2/26/2020,0,0,0,0
COLUMBIA,2/27/2020,0,0,0,0
COLUMBIA,2/28/2020,0,0,0,0
COLUMBIA,2/29/2020,0,0,0,0
COLUMBIA,3/1/2020,0,0,0,0
COLUMBIA,3/2/2020,0,0,0,0
COLUMBIA,3/3/2020,0,0,0,0
COLUMBIA,3/4/2020,0,0,0,0
COLUMBIA,3/5/2020,0,0,0,0
COLUMBIA,3/6/2020,0,0,0,0
COLUMBIA,3/7/2020,1,0,0,1
COLUMBIA,3/8/2020,1,0,0,1
COLUMBIA,3/9/2020,1,0,0,1
COLUMBIA,3/10/2020,2,0,0,2
COLUMBIA,3/11/2020,2,0,0,2
COLUMBIA,3/12/2020,2,0,0,2
COLUMBIA,3/14/2020,4,3,0,7
COLUMBIA,3/15/2020,4,3,0,7
COLUMBIA,3/16/2020,5,5,0,10
COLUMBIA,3/17/2020,5,5,0,10
COLUMBIA,3/18/2020,7,7,0,14
COLUMBIA,3/19/2020,8,8,0,16
COLUMBIA,3/20/2020,8,9,0,17
COLUMBIA,3/21/2020,10,12,0,22
COLUMBIA,3/22/2020,11,12,0,23
COLUMBIA,3/23/2020,13,14,0,27
COLUMBIA,3/24/2020,14,16,0,30
COLUMBIA,3/25/2020,14,16,0,30
COLUMBIA,3/26/2020,14,18,0,32
COLUMBIA,3/27/2020,14,19,0,33
COLUMBIA,3/28/2020,15,21,0,36
COLUMBIA,3/29/2020,17,22,0,39
COLUMBIA,3/30/2020,20,23,0,43
COLUMBIA,3/31/2020,20,24,0,44
COLUMBIA,4/1/2020,21,25,0,46
COLUMBIA,4/2/2020,22,28,0,50
COLUMBIA,4/3/2020,23,31,0,54
COLUMBIA,4/4/2020,27,32,0,59
COLUMBIA,4/5/2020,27,33,0,60
COLUMBIA,4/6/2020,28,37,0,65
COLUMBIA,4/7/2020,33,42,0,75
COLUMBIA,4/8/2020,34,44,0,78
COLUMBIA,4/9/2020,35,44,0,79
COLUMBIA,4/10/2020,39,46,0,85
COLUMBIA,4/11/2020,40,47,0,87
COLUMBIA,4/12/2020,41,47,0,88
COLUMBIA,4/13/2020,44,49,0,93
COLUMBIA,4/14/2020,47,52,0,99
COLUMBIA,4/15/2020,51,53,0,104
COLUMBIA,4/16/2020,57,56,0,113
COLUMBIA,4/17/2020,60,61,0,121
COLUMBIA,4/18/2020,67,66,0,133
COLUMBIA,4/19/2020,69,68,0,137
COLUMBIA,4/20/2020,72,73,0,145
COLUMBIA,4/21/2020,76,75,0,151
COLUMBIA,4/22/2020,79,77,0,156
COLUMBIA,4/23/2020,80,82,0,162
COLUMBIA,4/24/2020,82,84,0,166
COLUMBIA,4/25/2020,82,86,0,168
COLUMBIA,4/26/2020,82,87,0,169
COLUMBIA,4/27/2020,87,92,0,179
COLUMBIA,4/28/2020,89,94,1,184
COLUMBIA,4/29/2020,92,95,1,188
COLUMBIA,4/30/2020,93,98,2,193
COLUMBIA,5/1/2020,93,100,2,195
COLUMBIA,5/2/2020,96,101,2,199
COLUMBIA,5/3/2020,97,101,2,200
COLUMBIA,5/4/2020,98,103,2,203
COLUMBIA,5/5/2020,100,105,2,207
COLUMBIA,5/6/2020,100,108,2,210
COLUMBIA,5/7/2020,102,108,2,212
COLUMBIA,5/8/2020,104,109,2,215
COLUMBIA,5/9/2020,104,109,2,215
COLUMBIA,5/10/2020,105,109,2,216
COLUMBIA,5/11/2020,105,109,2,216
COLUMBIA,5/12/2020,108,110,2,220
COLUMBIA,5/13/2020,113,114,2,229
COLUMBIA,5/14/2020,117,118,2,237
COLUMBIA,5/15/2020,119,120,2,241
COLUMBIA,5/16/2020,119,121,2,242
COLUMBIA,5/17/2020,119,121,2,242
COLUMBIA,5/18/2020,120,124,2,246
COLUMBIA,5/19/2020,120,124,2,246
COLUMBIA,5/20/2020,122,125,2,249
COLUMBIA,5/21/2020,124,125,2,251
COLUMBIA,5/22/2020,127,128,2,257
COLUMBIA,5/23/2020,128,130,2,260
COLUMBIA,5/24/2020,130,133,2,265
COLUMBIA,5/25/2020,131,138,2,271
COLUMBIA,5/26/2020,135,140,2,277
COLUMBIA,5/27/2020,135,143,2,280
COLUMBIA,5/28/2020,140,147,2,289
COLUMBIA,5/29/2020,140,149,2,291
COLUMBIA,5/30/2020,141,150,2,293
COLUMBIA,5/31/2020,141,150,2,293
COLUMBIA,6/1/2020,143,153,2,298
COLUMBIA,6/2/2020,146,156,2,304
COLUMBIA,6/3/2020,147,157,2,306
COLUMBIA,6/4/2020,152,159,2,313
COLUMBIA,6/5/2020,153,160,2,315
COLUMBIA,6/6/2020,153,160,2,315
COLUMBIA,6/7/2020,153,161,2,316
COLUMBIA,6/8/2020,154,162,2,318
COLUMBIA,6/9/2020,160,165,2,327
COLUMBIA,6/10/2020,163,169,2,334
COLUMBIA,6/11/2020,166,172,2,340
COLUMBIA,6/12/2020,171,174,2,347
COLUMBIA,6/13/2020,173,176,2,351
COLUMBIA,6/14/2020,175,178,2,355
COLUMBIA,6/15/2020,178,181,2,361
COLUMBIA,6/16/2020,181,183,2,366
COLUMBIA,6/17/2020,185,187,2,374
COLUMBIA,6/18/2020,190,191,2,383
COLUMBIA,6/19/2020,197,195,2,394
COLUMBIA,6/20/2020,201,201,2,404
COLUMBIA,6/21/2020,204,210,2,416
COLUMBIA,6/22/2020,213,224,2,439
COLUMBIA,6/23/2020,228,231,2,461
COLUMBIA,6/24/2020,257,248,2,507
COLUMBIA,6/25/2020,276,267,2,545
COLUMBIA,6/26/2020,285,277,2,564
COLUMBIA,6/27/2020,297,289,2,588
COLUMBIA,6/28/2020,311,299,2,612
COLUMBIA,6/29/2020,347,332,2,681
COLUMBIA,6/30/2020,369,348,2,719
COLUMBIA,7/1/2020,421,371,2,794
COLUMBIA,7/2/2020,464,406,2,872
COLUMBIA,7/3/2020,473,415,2,890
COLUMBIA,7/4/2020,483,423,2,908
COLUMBIA,7/5/2020,494,435,3,932
COLUMBIA,7/6/2020,512,461,3,976
COLUMBIA,7/7/2020,554,491,3,1048
COLUMBIA,7/8/2020,575,522,3,1100
COLUMBIA,7/9/2020,603,543,4,1150
COLUMBIA,7/10/2020,628,566,4,1198
COLUMBIA,7/11/2020,653,580,4,1237
COLUMBIA,7/12/2020,666,593,4,1263
COLUMBIA,7/13/2020,698,618,4,1320
COLUMBIA,7/14/2020,735,641,5,1381
COLUMBIA,7/15/2020,760,666,5,1431
COLUMBIA,7/16/2020,789,694,7,1490
COLUMBIA,7/17/2020,819,716,7,1542
COLUMBIA,7/18/2020,836,737,7,1580
COLUMBIA,7/19/2020,860,759,7,1626
COLUMBIA,7/20/2020,895,787,8,1690
COLUMBIA,7/21/2020,922,815,10,1747
COLUMBIA,7/22/2020,957,840,10,1807
COLUMBIA,7/23/2020,985,867,10,1862
COLUMBIA,7/24/2020,1012,897,11,1920
COLUMBIA,7/25/2020,1028,921,11,1960
COLUMBIA,7/26/2020,1050,936,11,1997
COLUMBIA,7/27/2020,1081,962,12,2055
COLUMBIA,7/28/2020,1102,984,12,2098
COLUMBIA,7/29/2020,1134,1003,12,2149
COLUMBIA,7/30/2020,1174,1030,12,2216
COLUMBIA,7/31/2020,1204,1051,14,2269
COLUMBIA,8/1/2020,1221,1074,14,2309
COLUMBIA,8/2/2020,1231,1087,14,2332
COLUMBIA,8/3/2020,1257,1118,14,2389
COLUMBIA,8/4/2020,1277,1140,14,2431
COLUMBIA,8/5/2020,1301,1167,16,2484
COLUMBIA,8/6/2020,1319,1192,17,2528
COLUMBIA,8/7/2020,1340,1211,17,2568
COLUMBIA,8/8/2020,1353,1225,17,2595
COLUMBIA,8/9/2020,1364,1231,17,2612
COLUMBIA,8/10/2020,1396,1254,17,2667
COLUMBIA,8/11/2020,1417,1283,17,2717
COLUMBIA,8/12/2020,1445,1309,17,2771
COLUMBIA,8/13/2020,1470,1332,17,2819
COLUMBIA,8/14/2020,1486,1351,17,2854
COLUMBIA,8/15/2020,1498,1362,17,2877
COLUMBIA,8/16/2020,1512,1367,17,2896
COLUMBIA,8/17/2020,1535,1393,17,2945
COLUMBIA,8/18/2020,1558,1407,17,2982
COLUMBIA,8/19/2020,1573,1418,17,3008
COLUMBIA,8/20/2020,1582,1433,17,3032
COLUMBIA,8/21/2020,1593,1451,17,3061
COLUMBIA,8/22/2020,1599,1460,17,3076
COLUMBIA,8/23/2020,1608,1473,17,3098
COLUMBIA,8/24/2020,1633,1491,17,3141
COLUMBIA,8/25/2020,1652,1504,17,3173
COLUMBIA,8/26/2020,1672,1518,17,3207
COLUMBIA,8/27/2020,1683,1530,17,3230
COLUMBIA,8/28/2020,1697,1538,17,3252
COLUMBIA,8/29/2020,1707,1550,17,3274
COLUMBIA,8/30/2020,1721,1560,17,3298
COLUMBIA,8/31/2020,1740,1571,17,3328
COLUMBIA,9/1/2020,1757,1581,17,3355
COLUMBIA,9/2/2020,1769,1600,17,3386
COLUMBIA,9/3/2020,1784,1610,17,3411
COLUMBIA,9/4/2020,1794,1618,17,3429
COLUMBIA,9/5/2020,1806,1625,17,3448
COLUMBIA,9/6/2020,1814,1630,17,3461
COLUMBIA,9/7/2020,1819,1641,17,3477
COLUMBIA,9/8/2020,1833,1653,17,3503
COLUMBIA,9/9/2020,1850,1659,18,3527
COLUMBIA,9/10/2020,1868,1669,18,3555
COLUMBIA,9/11/2020,1878,1687,18,3583
COLUMBIA,9/12/2020,1886,1694,18,3598
COLUMBIA,9/13/2020,1892,1699,18,3609
COLUMBIA,9/14/2020,1908,1712,18,3638
COLUMBIA,9/15/2020,1914,1724,18,3656
COLUMBIA,9/16/2020,1919,1727,18,3664
COLUMBIA,9/17/2020,1922,1732,18,3672
COLUMBIA,9/18/2020,1931,1741,18,3690
COLUMBIA,9/19/2020,1936,1747,18,3701
COLUMBIA,9/20/2020,1940,1753,18,3711
COLUMBIA,9/21/2020,1950,1758,18,3726
COLUMBIA,9/22/2020,1960,1770,18,3748
COLUMBIA,9/23/2020,1968,1775,18,3761
COLUMBIA,9/24/2020,1979,1786,18,3783
COLUMBIA,9/25/2020,1989,1792,19,3800
COLUMBIA,9/26/2020,1996,1799,19,3814
COLUMBIA,9/27/2020,2001,1801,19,3821
COLUMBIA,9/28/2020,2011,1813,20,3844
COLUMBIA,9/29/2020,2016,1825,20,3861
COLUMBIA,9/30/2020,2026,1839,20,3885
COLUMBIA,10/1/2020,2030,1849,20,3899
COLUMBIA,10/2/2020,2039,1855,20,3914
COLUMBIA,10/3/2020,2043,1859,21,3923
COLUMBIA,10/4/2020,2050,1864,21,3935
COLUMBIA,10/5/2020,2068,1871,21,3960
COLUMBIA,10/6/2020,2079,1879,21,3979
COLUMBIA,10/7/2020,2088,1892,21,4001
COLUMBIA,10/8/2020,2095,1900,21,4016
COLUMBIA,10/9/2020,2104,1915,21,4040
COLUMBIA,10/10/2020,2110,1920,22,4052
COLUMBIA,10/11/2020,2122,1923,22,4067
COLUMBIA,10/12/2020,2139,1934,22,4095
COLUMBIA,10/13/2020,2154,1948,22,4124
COLUMBIA,10/14/2020,2164,1963,22,4149
COLUMBIA,10/15/2020,2179,1972,22,4173
COLUMBIA,10/16/2020,2185,1980,23,4188
COLUMBIA,10/17/2020,2190,1991,23,4204
COLUMBIA,10/18/2020,2191,1992,23,4206
COLUMBIA,10/19/2020,2191,1992,23,4206
COLUMBIA,10/20/2020,2191,1992,23,4206
FULTON,1/1/2020,0,0,0,0
FULTON,1/2/2020,0,0,0,0
FULTON,1/3/2020,0,0,0,0
FULTON,1/4/2020,0,0,0,0
FULTON,1/5/2020,0,0,0,0
FULTON,1/6/2020,1,0,0,1
FULTON,1/7/2020,1,0,0,1
FULTON,1/8/2020,2,0,0,2
FULTON,1/9/2020,2,0,0,2
FULTON,1/10/2020,2,0,0,2
FULTON,1/11/2020,2,0,0,2
FULTON,1/12/2020,2,1,0,3
FULTON,1/13/2020,2,1,0,3
FULTON,1/14/2020,2,1,0,3
FULTON,1/15/2020,2,1,0,3
FULTON,1/16/2020,2,1,0,3
FULTON,1/17/2020,2,1,0,3
FULTON,1/18/2020,2,1,0,3
FULTON,1/19/2020,2,1,0,3
FULTON,1/20/2020,3,1,0,4
FULTON,1/21/2020,3,1,0,4
FULTON,1/22/2020,3,1,0,4
FULTON,1/23/2020,3,1,0,4
FULTON,1/24/2020,3,1,0,4
FULTON,1/25/2020,3,1,0,4
FULTON,1/26/2020,3,1,0,4
FULTON,1/27/2020,3,1,0,4
FULTON,1/28/2020,3,1,0,4
FULTON,1/29/2020,3,1,0,4
FULTON,1/30/2020,3,1,0,4
FULTON,1/31/2020,3,1,0,4
FULTON,2/1/2020,3,2,0,5
FULTON,2/2/2020,3,2,0,5
FULTON,2/3/2020,3,2,0,5
FULTON,2/4/2020,3,2,0,5
FULTON,2/5/2020,3,2,0,5
FULTON,2/6/2020,3,2,0,5
FULTON,2/7/2020,3,2,0,5
FULTON,2/8/2020,3,2,0,5
FULTON,2/9/2020,3,2,0,5
FULTON,2/10/2020,4,2,0,6
FULTON,2/11/2020,4,2,0,6
FULTON,2/12/2020,4,2,0,6
FULTON,2/13/2020,4,2,0,6
FULTON,2/14/2020,4,2,0,6
FULTON,2/15/2020,5,3,0,8
FULTON,2/16/2020,5,3,0,8
FULTON,2/17/2020,5,4,0,9
FULTON,2/18/2020,5,5,0,10
FULTON,2/19/2020,7,6,0,13
FULTON,2/20/2020,7,7,0,14
FULTON,2/21/2020,7,7,0,14
FULTON,2/22/2020,7,8,0,15
FULTON,2/23/2020,8,8,0,16
FULTON,2/24/2020,8,8,0,16
FULTON,2/25/2020,8,9,0,17
FULTON,2/26/2020,9,11,0,20
FULTON,2/27/2020,10,13,0,23
FULTON,2/28/2020,11,15,0,26
FULTON,2/29/2020,11,15,0,26
FULTON,3/1/2020,19,23,0,42
FULTON,3/2/2020,22,26,0,48
FULTON,3/3/2020,26,32,0,58
FULTON,3/4/2020,32,36,0,68
FULTON,3/5/2020,38,38,0,76
FULTON,3/6/2020,45,44,0,89
FULTON,3/7/2020,47,49,0,96
FULTON,3/8/2020,51,54,0,105
FULTON,3/9/2020,59,70,0,129
FULTON,3/10/2020,73,85,0,158
FULTON,3/11/2020,83,102,0,185
FULTON,3/12/2020,103,135,0,238
FULTON,3/13/2020,123,158,0,281
FULTON,3/14/2020,148,176,0,324
FULTON,3/15/2020,168,193,0,361
FULTON,3/16/2020,204,228,0,432
FULTON,3/17/2020,233,270,0,503
FULTON,3/18/2020,259,310,0,569
FULTON,3/19/2020,284,348,0,632
FULTON,3/20/2020,315,384,0,699
FULTON,3/21/2020,336,407,0,743
FULTON,3/22/2020,355,431,0,786
FULTON,3/23/2020,397,468,0,865
FULTON,3/24/2020,434,492,0,926
FULTON,3/25/2020,471,523,0,994
FULTON,3/26/2020,502,546,0,1048
FULTON,3/27/2020,523,579,0,1102
FULTON,3/28/2020,546,599,0,1145
FULTON,3/29/2020,564,632,0,1196
FULTON,3/30/2020,590,668,0,1258
FULTON,3/31/2020,621,692,0,1313
FULTON,4/1/2020,672,731,0,1403
FULTON,4/2/2020,705,746,0,1451
FULTON,4/3/2020,746,770,2,1518
FULTON,4/4/2020,771,784,2,1557
FULTON,4/5/2020,787,798,2,1587
FULTON,4/6/2020,818,830,3,1651
FULTON,4/7/2020,859,864,3,1726
FULTON,4/8/2020,893,900,3,1796
FULTON,4/9/2020,928,924,3,1855
FULTON,4/10/2020,954,958,3,1915
FULTON,4/11/2020,992,977,3,1972
FULTON,4/12/2020,1010,998,3,2011
FULTON,4/13/2020,1033,1031,3,2067
FULTON,4/14/2020,1066,1056,3,2125
FULTON,4/15/2020,1116,1085,3,2204
FULTON,4/16/2020,1144,1114,3,2261
FULTON,4/17/2020,1175,1150,3,2328
FULTON,4/18/2020,1193,1170,3,2366
FULTON,4/19/2020,1225,1211,3,2439
FULTON,4/20/2020,1288,1230,3,2521
FULTON,4/21/2020,1312,1265,4,2581
FULTON,4/22/2020,1342,1292,4,2638
FULTON,4/23/2020,1362,1307,4,2673
FULTON,4/24/2020,1392,1338,4,2734
FULTON,4/25/2020,1408,1360,4,2772
FULTON,4/26/2020,1427,1378,4,2809
FULTON,4/27/2020,1452,1404,5,2861
FULTON,4/28/2020,1503,1430,5,2938
FULTON,4/29/2020,1533,1478,5,3016
FULTON,4/30/2020,1566,1519,6,3091
FULTON,5/1/2020,1595,1545,6,3146
FULTON,5/2/2020,1615,1556,6,3177
FULTON,5/3/2020,1631,1572,6,3209
FULTON,5/4/2020,1663,1589,6,3258
FULTON,5/5/2020,1702,1614,6,3322
FULTON,5/6/2020,1729,1644,7,3380
FULTON,5/7/2020,1766,1680,7,3453
FULTON,5/8/2020,1796,1699,7,3502
FULTON,5/9/2020,1805,1712,7,3524
FULTON,5/10/2020,1822,1733,7,3562
FULTON,5/11/2020,1860,1773,8,3641
FULTON,5/12/2020,1877,1806,8,3691
FULTON,5/13/2020,1914,1824,8,3746
FULTON,5/14/2020,1966,1846,10,3822
FULTON,5/15/2020,2000,1875,10,3885
FULTON,5/16/2020,2009,1896,10,3915
FULTON,5/17/2020,2019,1909,10,3938
FULTON,5/18/2020,2052,1951,10,4013
FULTON,5/19/2020,2085,1974,10,4069
FULTON,5/20/2020,2106,1989,10,4105
FULTON,5/21/2020,2136,2011,10,4157
FULTON,5/22/2020,2162,2036,10,4208
FULTON,5/23/2020,2181,2050,10,4241
FULTON,5/24/2020,2196,2061,10,4267
FULTON,5/25/2020,2211,2075,10,4296
FULTON,5/26/2020,2247,2109,10,4366
FULTON,5/27/2020,2282,2146,10,4438
FULTON,5/28/2020,2302,2173,10,4485
FULTON,5/29/2020,2328,2201,10,4539
FULTON,5/30/2020,2342,2213,10,4565
FULTON,5/31/2020,2344,2231,10,4585
FULTON,6/1/2020,2394,2269,17,4680
FULTON,6/2/2020,2432,2295,19,4746
FULTON,6/3/2020,2466,2333,21,4820
FULTON,6/4/2020,2484,2360,22,4866
FULTON,6/5/2020,2549,2412,22,4983
FULTON,6/6/2020,2588,2461,24,5073
FULTON,6/7/2020,2606,2481,24,5111
FULTON,6/8/2020,2656,2517,27,5200
FULTON,6/9/2020,2703,2560,29,5292
FULTON,6/10/2020,2757,2613,33,5403
FULTON,6/11/2020,2832,2658,33,5523
FULTON,6/12/2020,2881,2691,35,5607
FULTON,6/13/2020,2923,2732,36,5691
FULTON,6/14/2020,2950,2754,36,5740
FULTON,6/15/2020,3024,2852,38,5914
FULTON,6/16/2020,3108,2936,41,6085
FULTON,6/17/2020,3191,3020,48,6259
FULTON,6/18/2020,3274,3093,56,6423
FULTON,6/19/2020,3384,3171,59,6614
FULTON,6/20/2020,3490,3246,67,6803
FULTON,6/21/2020,3571,3316,69,6956
FULTON,6/22/2020,3717,3473,81,7271
FULTON,6/23/2020,3897,3647,96,7640
FULTON,6/24/2020,4069,3832,130,8031
FULTON,6/25/2020,4237,4013,162,8412
FULTON,6/26/2020,4449,4197,192,8838
FULTON,6/27/2020,4585,4303,206,9094
FULTON,6/28/2020,4723,4420,216,9359
FULTON,6/29/2020,4978,4630,251,9859
ELBERT,1/15/2020,0,0,0,0
FULTON,6/30/2020,5230,4877,270,10377
FULTON,7/1/2020,5473,5111,293,10877
FULTON,7/2/2020,5725,5323,325,11373
FULTON,7/3/2020,5896,5475,335,11706
FULTON,7/4/2020,6039,5568,344,11951
FULTON,7/5/2020,6190,5695,351,12236
FULTON,7/6/2020,6484,5960,395,12839
FULTON,7/7/2020,6761,6205,430,13396
FULTON,7/8/2020,7040,6442,496,13978
FULTON,7/9/2020,7300,6658,538,14496
FULTON,7/10/2020,7587,6885,555,15027
FULTON,7/11/2020,7737,7016,562,15315
FULTON,7/12/2020,7856,7119,580,15555
FULTON,7/13/2020,8132,7383,604,16119
FULTON,7/14/2020,8364,7591,627,16582
FULTON,7/15/2020,8582,7780,653,17015
FULTON,7/16/2020,8822,8014,673,17509
FULTON,7/17/2020,9039,8192,690,17921
FULTON,7/18/2020,9166,8299,695,18160
FULTON,7/19/2020,9244,8368,706,18318
FULTON,7/20/2020,9468,8564,708,18740
FULTON,7/21/2020,9647,8721,721,19089
FULTON,7/22/2020,9818,8887,731,19436
FULTON,7/23/2020,9960,9028,731,19719
FULTON,7/24/2020,10132,9176,739,20047
FULTON,7/25/2020,10231,9261,741,20233
FULTON,7/26/2020,10298,9325,741,20364
FULTON,7/27/2020,10431,9448,744,20623
FULTON,7/28/2020,10585,9577,752,20914
FULTON,7/29/2020,10710,9701,756,21167
FULTON,7/30/2020,10834,9808,758,21400
FULTON,7/31/2020,10956,9920,762,21638
FULTON,8/1/2020,11041,9998,763,21802
FULTON,8/2/2020,11095,10057,763,21915
FULTON,8/3/2020,11227,10185,767,22179
FULTON,8/4/2020,11331,10291,767,22389
FULTON,8/5/2020,11464,10402,769,22635
FULTON,8/6/2020,11566,10488,769,22823
FULTON,8/7/2020,11659,10567,769,22995
FULTON,8/8/2020,11735,10625,770,23130
FULTON,8/9/2020,11779,10666,770,23215
FULTON,8/10/2020,11892,10746,774,23412
FULTON,8/11/2020,11979,10813,776,23568
FULTON,8/12/2020,12046,10877,776,23699
FULTON,8/13/2020,12126,10934,778,23838
FULTON,8/14/2020,12210,11002,781,23993
FULTON,8/15/2020,12280,11057,783,24120
FULTON,8/16/2020,12327,11101,783,24211
FULTON,8/17/2020,12397,11177,783,24357
FULTON,8/18/2020,12480,11244,785,24509
FULTON,8/19/2020,12564,11315,786,24665
FULTON,8/20/2020,12640,11401,789,24830
FULTON,8/21/2020,12725,11479,789,24993
FULTON,8/22/2020,12772,11530,790,25092
FULTON,8/23/2020,12821,11589,791,25201
FULTON,8/24/2020,12908,11696,795,25399
FULTON,8/25/2020,12964,11801,795,25560
FULTON,8/26/2020,13039,11878,796,25713
FULTON,8/27/2020,13102,11943,797,25842
FULTON,8/28/2020,13150,11989,799,25938
FULTON,8/29/2020,13213,12027,800,26040
FULTON,8/30/2020,13255,12056,802,26113
FULTON,8/31/2020,13325,12135,805,26265
FULTON,9/1/2020,13394,12196,806,26396
FULTON,9/2/2020,13448,12250,807,26505
FULTON,9/3/2020,13506,12313,809,26628
FULTON,9/4/2020,13559,12363,809,26731
FULTON,9/5/2020,13595,12401,810,26806
FULTON,9/6/2020,13629,12433,810,26872
FULTON,9/7/2020,13666,12476,810,26952
FULTON,9/8/2020,13725,12538,812,27075
FULTON,9/9/2020,13777,12593,812,27182
FULTON,9/10/2020,13825,12634,814,27273
FULTON,9/11/2020,13871,12667,814,27352
FULTON,9/12/2020,13899,12686,816,27401
FULTON,9/13/2020,13928,12713,816,27457
FULTON,9/14/2020,13987,12760,817,27564
FULTON,9/15/2020,14024,12817,819,27660
FULTON,9/16/2020,14063,12854,819,27736
FULTON,9/17/2020,14094,12889,821,27804
FULTON,9/18/2020,14127,12908,823,27858
FULTON,9/19/2020,14162,12943,823,27928
FULTON,9/20/2020,14185,12957,823,27965
FULTON,9/21/2020,14235,12994,825,28054
FULTON,9/22/2020,14272,13026,825,28123
FULTON,9/23/2020,14310,13056,825,28191
FULTON,9/24/2020,14347,13093,825,28265
FULTON,9/25/2020,14388,13137,825,28350
FULTON,9/26/2020,14417,13163,825,28405
FULTON,9/27/2020,14440,13187,825,28452
FULTON,9/28/2020,14490,13233,825,28548
FULTON,9/29/2020,14535,13272,825,28632
FULTON,9/30/2020,14579,13327,826,28732
FULTON,10/1/2020,14619,13359,826,28804
FULTON,10/2/2020,14659,13398,826,28883
FULTON,10/3/2020,14702,13435,828,28965
FULTON,10/4/2020,14729,13455,829,29013
FULTON,10/5/2020,14786,13512,830,29128
FULTON,10/6/2020,14825,13556,831,29212
FULTON,10/7/2020,14882,13594,831,29307
FULTON,10/8/2020,14923,13623,831,29377
FULTON,10/9/2020,14975,13654,832,29461
FULTON,10/10/2020,14995,13675,832,29502
FULTON,10/11/2020,15023,13695,832,29550
FULTON,10/12/2020,15067,13741,838,29646
FULTON,10/13/2020,15105,13786,838,29729
FULTON,10/14/2020,15138,13820,839,29797
FULTON,10/15/2020,15181,13846,841,29868
FULTON,10/16/2020,15219,13882,844,29945
FULTON,10/17/2020,15235,13904,845,29984
FULTON,10/18/2020,15241,13907,845,29993
FULTON,10/19/2020,15242,13907,845,29994
FULTON,10/20/2020,15243,13907,846,29996
MILLER,1/1/2020,0,0,0,0
MILLER,1/2/2020,0,0,0,0
MILLER,1/3/2020,0,0,0,0
MILLER,1/4/2020,0,0,0,0
MILLER,1/5/2020,0,0,0,0
MILLER,1/6/2020,0,0,0,0
MILLER,1/7/2020,0,0,0,0
MILLER,1/8/2020,0,0,0,0
MILLER,1/9/2020,0,0,0,0
MILLER,1/10/2020,0,0,0,0
MILLER,1/11/2020,0,0,0,0
MILLER,1/12/2020,0,0,0,0
MILLER,1/13/2020,0,0,0,0
MILLER,1/14/2020,0,0,0,0
MILLER,1/15/2020,0,0,0,0
MILLER,1/16/2020,0,0,0,0
MILLER,1/17/2020,0,0,0,0
MILLER,1/18/2020,0,0,0,0
MILLER,1/19/2020,0,0,0,0
MILLER,1/20/2020,0,0,0,0
MILLER,1/21/2020,0,0,0,0
MILLER,1/22/2020,0,0,0,0
MILLER,1/23/2020,0,0,0,0
MILLER,1/24/2020,0,0,0,0
MILLER,1/25/2020,0,0,0,0
MILLER,1/26/2020,0,0,0,0
MILLER,1/27/2020,0,0,0,0
MILLER,1/28/2020,0,0,0,0
MILLER,1/29/2020,0,0,0,0
MILLER,1/30/2020,0,0,0,0
MILLER,1/31/2020,0,0,0,0
MILLER,2/1/2020,0,0,0,0
MILLER,2/2/2020,0,0,0,0
MILLER,2/3/2020,0,0,0,0
MILLER,2/4/2020,0,0,0,0
MILLER,2/5/2020,0,0,0,0
MILLER,2/6/2020,0,0,0,0
MILLER,2/7/2020,0,0,0,0
MILLER,2/8/2020,0,0,0,0
MILLER,2/9/2020,0,0,0,0
MILLER,2/10/2020,0,0,0,0
MILLER,2/11/2020,0,0,0,0
MILLER,2/12/2020,0,0,0,0
MILLER,2/13/2020,0,0,0,0
MILLER,2/14/2020,0,0,0,0
MILLER,2/15/2020,0,0,0,0
MILLER,2/16/2020,0,0,0,0
MILLER,2/17/2020,0,0,0,0
MILLER,2/18/2020,0,0,0,0
MILLER,2/19/2020,0,0,0,0
MILLER,2/20/2020,0,0,0,0
MILLER,2/21/2020,0,0,0,0
MILLER,2/22/2020,0,0,0,0
MILLER,2/23/2020,0,0,0,0
MILLER,2/24/2020,0,0,0,0
MILLER,2/25/2020,0,0,0,0
MILLER,2/26/2020,0,0,0,0
MILLER,2/27/2020,0,0,0,0
MILLER,2/28/2020,0,0,0,0
MILLER,2/29/2020,0,0,0,0
MILLER,3/1/2020,0,0,0,0
MILLER,3/2/2020,0,0,0,0
MILLER,3/3/2020,0,0,0,0
MILLER,3/4/2020,0,0,0,0
MILLER,3/5/2020,0,0,0,0
MILLER,3/6/2020,0,0,0,0
MILLER,3/7/2020,0,0,0,0
MILLER,3/8/2020,0,0,0,0
MILLER,3/9/2020,0,0,0,0
MILLER,3/10/2020,0,0,0,0
MILLER,3/11/2020,1,0,0,1
MILLER,3/12/2020,1,0,0,1
MILLER,3/13/2020,1,0,0,1
MILLER,3/14/2020,1,0,0,1
MILLER,3/15/2020,1,0,0,1
MILLER,3/16/2020,1,0,0,1
MILLER,3/17/2020,1,0,0,1
MILLER,3/18/2020,1,0,0,1
MILLER,3/19/2020,1,0,0,1
MILLER,3/20/2020,1,0,0,1
MILLER,3/21/2020,2,0,0,2
MILLER,3/22/2020,2,1,0,3
MILLER,3/23/2020,3,2,0,5
MILLER,3/24/2020,3,2,0,5
MILLER,3/25/2020,3,2,0,5
MILLER,3/26/2020,3,2,0,5
MILLER,3/27/2020,5,2,0,7
MILLER,3/28/2020,5,3,0,8
MILLER,3/29/2020,6,3,0,9
MILLER,3/30/2020,7,4,0,11
MILLER,3/31/2020,8,4,0,12
MILLER,4/1/2020,8,5,0,13
MILLER,4/2/2020,8,5,0,13
MILLER,4/3/2020,8,5,0,13
MILLER,4/4/2020,9,5,0,14
MILLER,4/5/2020,10,5,0,15
MILLER,4/6/2020,12,5,0,17
MILLER,4/7/2020,12,5,0,17
MILLER,4/8/2020,12,7,0,19
MILLER,4/9/2020,12,7,0,19
MILLER,4/10/2020,12,7,0,19
MILLER,4/11/2020,13,7,0,20
MILLER,4/12/2020,14,7,0,21
MILLER,4/13/2020,15,7,0,22
MILLER,4/14/2020,18,9,0,27
MILLER,4/15/2020,18,9,0,27
MILLER,4/16/2020,19,9,0,28
MILLER,4/17/2020,19,9,0,28
MILLER,4/18/2020,19,9,0,28
MILLER,4/19/2020,20,9,0,29
MILLER,4/20/2020,21,10,0,31
MILLER,4/21/2020,21,10,0,31
MILLER,4/22/2020,21,10,0,31
MILLER,4/23/2020,22,10,0,32
MILLER,4/24/2020,23,10,0,33
MILLER,4/25/2020,23,10,0,33
MILLER,4/26/2020,23,10,0,33
MILLER,4/27/2020,23,10,0,33
MILLER,4/28/2020,23,10,0,33
MILLER,4/29/2020,23,10,0,33
MILLER,4/30/2020,23,11,0,34
MILLER,5/1/2020,23,12,0,35
MILLER,5/2/2020,23,12,0,35
MILLER,5/3/2020,23,12,0,35
MILLER,5/4/2020,24,12,0,36
MILLER,5/5/2020,24,12,0,36
MILLER,5/6/2020,25,12,0,37
MILLER,5/7/2020,25,12,0,37
MILLER,5/8/2020,25,12,0,37
MILLER,5/9/2020,25,12,0,37
MILLER,5/10/2020,25,12,0,37
MILLER,5/11/2020,25,12,0,37
MILLER,5/12/2020,25,12,0,37
MILLER,5/13/2020,25,12,0,37
MILLER,5/14/2020,25,13,0,38
MILLER,5/15/2020,25,13,0,38
MILLER,5/16/2020,25,13,0,38
MILLER,5/17/2020,25,13,0,38
MILLER,5/18/2020,25,13,0,38
MILLER,5/19/2020,25,14,0,39
MILLER,5/20/2020,25,14,0,39
MILLER,5/21/2020,25,14,0,39
MILLER,5/22/2020,26,15,0,41
MILLER,5/23/2020,27,15,0,42
MILLER,5/24/2020,27,15,0,42
MILLER,5/25/2020,27,15,0,42
MILLER,5/26/2020,27,15,0,42
MILLER,5/27/2020,27,16,0,43
MILLER,5/28/2020,27,16,0,43
MILLER,5/29/2020,28,16,0,44
MILLER,5/30/2020,28,16,0,44
MILLER,5/31/2020,28,16,0,44
MILLER,6/1/2020,29,16,0,45
MILLER,6/2/2020,29,16,0,45
MILLER,6/3/2020,29,16,0,45
MILLER,6/4/2020,29,16,0,45
MILLER,6/5/2020,29,16,0,45
MILLER,6/6/2020,30,16,0,46
MILLER,6/7/2020,30,16,0,46
MILLER,6/8/2020,30,16,0,46
MILLER,6/9/2020,30,16,0,46
MILLER,6/10/2020,30,16,0,46
MILLER,6/11/2020,30,16,0,46
MILLER,6/12/2020,30,16,0,46
MILLER,6/13/2020,30,16,0,46
MILLER,6/14/2020,30,16,0,46
MILLER,6/15/2020,30,16,0,46
MILLER,6/16/2020,30,17,0,47
MILLER,6/17/2020,30,17,0,47
MILLER,6/18/2020,30,17,0,47
MILLER,6/19/2020,30,18,0,48
MILLER,6/20/2020,30,18,0,48
MILLER,6/21/2020,30,18,0,48
MILLER,6/22/2020,30,18,0,48
MILLER,6/23/2020,30,18,0,48
MILLER,6/24/2020,30,18,0,48
MILLER,6/25/2020,30,18,0,48
MILLER,6/26/2020,30,19,0,49
MILLER,6/27/2020,30,21,0,51
MILLER,6/28/2020,32,21,0,53
MILLER,6/29/2020,32,21,0,53
MILLER,6/30/2020,34,21,0,55
MILLER,7/1/2020,36,21,0,57
MILLER,7/2/2020,38,21,0,59
MILLER,7/3/2020,38,21,0,59
MILLER,7/4/2020,38,23,0,61
MILLER,7/5/2020,39,25,0,64
MILLER,7/6/2020,39,25,0,64
MILLER,7/7/2020,39,26,0,65
MILLER,7/8/2020,40,26,0,66
MILLER,7/9/2020,42,26,0,68
MILLER,7/10/2020,46,26,0,72
MILLER,7/11/2020,46,27,0,73
MILLER,7/12/2020,47,27,0,74
MILLER,7/13/2020,49,31,0,80
MILLER,7/14/2020,50,31,1,82
MILLER,7/15/2020,53,36,1,90
MILLER,7/16/2020,54,37,1,92
MILLER,7/17/2020,60,37,1,98
MILLER,7/18/2020,60,38,1,99
MILLER,7/19/2020,61,41,1,103
MILLER,7/20/2020,64,43,1,108
MILLER,7/21/2020,64,46,1,111
MILLER,7/22/2020,66,46,1,113
MILLER,7/23/2020,72,47,1,120
MILLER,7/24/2020,74,48,1,123
MILLER,7/25/2020,75,49,1,125
MILLER,7/26/2020,76,49,1,126
MILLER,7/27/2020,78,52,1,131
MILLER,7/28/2020,81,54,1,136
MILLER,7/29/2020,81,55,1,137
MILLER,7/30/2020,82,55,1,138
MILLER,7/31/2020,82,56,1,139
MILLER,8/1/2020,84,56,1,141
MILLER,8/2/2020,84,57,1,142
MILLER,8/3/2020,86,57,1,144
MILLER,8/4/2020,88,57,1,146
MILLER,8/5/2020,90,59,1,150
MILLER,8/6/2020,93,61,1,155
MILLER,8/7/2020,95,62,1,158
MILLER,8/8/2020,97,63,1,161
MILLER,8/9/2020,97,64,1,162
MILLER,8/10/2020,99,65,1,165
MILLER,8/11/2020,100,68,1,169
MILLER,8/12/2020,100,73,1,174
MILLER,8/13/2020,102,74,1,177
MILLER,8/14/2020,102,75,1,178
MILLER,8/15/2020,105,77,1,183
MILLER,8/16/2020,108,78,1,187
MILLER,8/17/2020,108,84,1,193
MILLER,8/18/2020,113,84,1,198
MILLER,8/19/2020,116,86,1,203
MILLER,8/20/2020,116,87,1,204
MILLER,8/21/2020,116,90,1,207
MILLER,8/22/2020,116,90,1,207
MILLER,8/23/2020,118,92,1,211
MILLER,8/24/2020,119,94,1,214
MILLER,8/25/2020,120,95,1,216
MILLER,8/26/2020,121,95,1,217
MILLER,8/27/2020,123,95,1,219
MILLER,8/28/2020,123,96,1,220
MILLER,8/29/2020,123,98,1,222
MILLER,8/30/2020,124,99,1,224
MILLER,8/31/2020,125,101,1,227
MILLER,9/1/2020,127,101,1,229
MILLER,9/2/2020,128,102,1,231
MILLER,9/3/2020,128,102,1,231
MILLER,9/4/2020,129,103,1,233
MILLER,9/5/2020,129,103,1,233
MILLER,9/6/2020,130,103,1,234
MILLER,9/7/2020,132,103,1,236
MILLER,9/8/2020,133,104,1,238
MILLER,9/9/2020,133,104,2,239
MILLER,9/10/2020,133,106,2,241
MILLER,9/11/2020,134,106,2,242
MILLER,9/12/2020,135,106,2,243
MILLER,9/13/2020,135,106,2,243
MILLER,9/14/2020,136,106,2,244
MILLER,9/15/2020,137,108,2,247
MILLER,9/16/2020,137,108,2,247
MILLER,9/17/2020,138,109,2,249
MILLER,9/18/2020,138,111,2,251
MILLER,9/19/2020,138,111,2,251
MILLER,9/20/2020,140,111,2,253
MILLER,9/21/2020,141,111,2,254
MILLER,9/22/2020,143,113,2,258
MILLER,9/23/2020,145,113,2,260
MILLER,9/24/2020,147,113,2,262
MILLER,9/25/2020,150,116,2,268
MILLER,9/26/2020,152,116,2,270
MILLER,9/27/2020,152,117,3,272
MILLER,9/28/2020,153,117,3,273
MILLER,9/29/2020,155,119,3,277
MILLER,9/30/2020,157,119,3,279
MILLER,10/1/2020,160,120,3,283
MILLER,10/2/2020,161,120,3,284
MILLER,10/3/2020,162,121,3,286
MILLER,10/4/2020,164,121,3,288
MILLER,10/5/2020,165,123,3,291
MILLER,10/6/2020,165,123,3,291
MILLER,10/7/2020,165,126,3,294
MILLER,10/8/2020,166,126,3,295
MILLER,10/9/2020,166,126,3,295
MILLER,10/10/2020,166,126,3,295
MILLER,10/11/2020,166,126,3,295
PULASKI,4/6/2020,8,6,0,14
MILLER,10/12/2020,166,126,3,295
ELBERT,1/16/2020,0,0,0,0
MILLER,10/13/2020,166,126,3,295
MILLER,10/14/2020,166,127,3,296
MILLER,10/15/2020,167,128,3,298
MILLER,10/16/2020,167,128,3,298
MILLER,10/17/2020,167,129,3,299
MILLER,10/18/2020,167,130,3,300
MILLER,10/19/2020,167,130,3,300
MILLER,10/20/2020,167,130,3,300
MONROE,1/1/2020,0,0,0,0
MONROE,1/2/2020,0,0,0,0
MONROE,1/3/2020,0,0,0,0
MONROE,1/4/2020,0,0,0,0
MONROE,1/5/2020,0,0,0,0
MONROE,1/6/2020,0,0,0,0
MONROE,1/7/2020,0,0,0,0
MONROE,1/8/2020,0,0,0,0
MONROE,1/9/2020,0,0,0,0
MONROE,1/10/2020,0,0,0,0
MONROE,1/11/2020,0,0,0,0
MONROE,1/12/2020,0,0,0,0
MONROE,1/13/2020,0,0,0,0
MONROE,1/14/2020,0,0,0,0
MONROE,1/15/2020,0,0,0,0
MONROE,1/16/2020,0,0,0,0
MONROE,1/17/2020,0,0,0,0
MONROE,1/18/2020,0,0,0,0
MONROE,1/19/2020,0,0,0,0
MONROE,1/20/2020,0,0,0,0
MONROE,1/21/2020,0,0,0,0
MONROE,1/22/2020,0,0,0,0
MONROE,1/23/2020,0,0,0,0
MONROE,1/24/2020,0,0,0,0
MONROE,1/25/2020,0,0,0,0
MONROE,1/26/2020,0,0,0,0
MONROE,1/27/2020,0,0,0,0
MONROE,1/28/2020,0,0,0,0
MONROE,1/29/2020,0,0,0,0
MONROE,1/30/2020,0,0,0,0
MONROE,1/31/2020,0,0,0,0
MONROE,2/1/2020,0,0,0,0
MONROE,2/2/2020,0,0,0,0
MONROE,2/3/2020,0,0,0,0
MONROE,2/4/2020,0,0,0,0
MONROE,2/5/2020,0,0,0,0
MONROE,2/6/2020,0,0,0,0
MONROE,2/7/2020,0,0,0,0
MONROE,2/8/2020,0,0,0,0
MONROE,2/9/2020,0,0,0,0
MONROE,2/10/2020,0,0,0,0
MONROE,2/11/2020,0,0,0,0
MONROE,2/12/2020,0,0,0,0
MONROE,2/13/2020,0,0,0,0
MONROE,2/14/2020,0,0,0,0
MONROE,2/15/2020,0,0,0,0
MONROE,2/16/2020,0,0,0,0
MONROE,2/17/2020,0,0,0,0
MONROE,2/18/2020,0,0,0,0
MONROE,2/19/2020,0,0,0,0
MONROE,2/20/2020,0,0,0,0
MONROE,2/21/2020,0,0,0,0
MONROE,2/22/2020,0,0,0,0
MONROE,2/23/2020,0,0,0,0
MONROE,2/24/2020,0,0,0,0
MONROE,2/25/2020,0,0,0,0
MONROE,2/26/2020,0,0,0,0
MONROE,2/27/2020,0,0,0,0
MONROE,2/28/2020,0,0,0,0
MONROE,2/29/2020,0,0,0,0
MONROE,3/1/2020,0,0,0,0
MONROE,3/2/2020,0,0,0,0
MONROE,3/3/2020,0,0,0,0
MONROE,3/4/2020,0,0,0,0
MONROE,3/5/2020,0,0,0,0
MONROE,3/6/2020,0,0,0,0
MONROE,3/7/2020,0,0,0,0
MONROE,3/8/2020,0,0,0,0
MONROE,3/9/2020,1,2,0,3
MONROE,3/10/2020,1,2,0,3
MONROE,3/11/2020,1,2,0,3
MONROE,3/12/2020,1,2,0,3
MONROE,3/13/2020,1,2,0,3
MONROE,3/14/2020,2,2,0,4
MONROE,3/15/2020,2,3,0,5
MONROE,3/16/2020,2,3,0,5
MONROE,3/17/2020,3,3,0,6
MONROE,3/18/2020,3,3,0,6
MONROE,3/19/2020,3,3,0,6
MONROE,3/20/2020,3,3,0,6
MONROE,3/21/2020,3,3,0,6
MONROE,3/22/2020,4,3,0,7
MONROE,3/23/2020,4,3,0,7
MONROE,3/24/2020,5,4,0,9
MONROE,3/25/2020,5,4,0,9
MONROE,3/26/2020,5,4,0,9
MONROE,3/27/2020,5,4,0,9
MONROE,3/28/2020,6,4,0,10
MONROE,3/29/2020,6,4,0,10
MONROE,3/30/2020,6,4,0,10
MONROE,3/31/2020,6,5,0,11
MONROE,4/1/2020,6,6,0,12
MONROE,4/2/2020,6,6,0,12
MONROE,4/3/2020,6,7,0,13
MONROE,4/4/2020,7,7,0,14
MONROE,4/5/2020,7,7,0,14
MONROE,4/6/2020,7,7,0,14
MONROE,4/7/2020,7,7,0,14
MONROE,4/8/2020,7,7,0,14
MONROE,4/9/2020,7,7,0,14
MONROE,4/10/2020,7,7,0,14
MONROE,4/11/2020,7,7,0,14
MONROE,4/12/2020,8,8,0,16
MONROE,4/13/2020,8,8,0,16
MONROE,4/14/2020,9,8,0,17
MONROE,4/15/2020,10,9,0,19
MONROE,4/16/2020,11,9,0,20
MONROE,4/17/2020,11,9,0,20
MONROE,4/18/2020,11,10,0,21
MONROE,4/19/2020,12,10,0,22
MONROE,4/20/2020,12,10,0,22
MONROE,4/21/2020,12,10,0,22
MONROE,4/22/2020,12,10,0,22
MONROE,4/23/2020,13,10,0,23
MONROE,4/24/2020,13,11,0,24
MONROE,4/25/2020,13,11,0,24
MONROE,4/26/2020,13,11,0,24
MONROE,4/27/2020,14,11,0,25
MONROE,4/28/2020,14,11,0,25
MONROE,4/29/2020,14,11,0,25
MONROE,4/30/2020,14,11,0,25
MONROE,5/1/2020,15,11,0,26
MONROE,5/2/2020,15,11,0,26
MONROE,5/3/2020,18,13,0,31
MONROE,5/4/2020,22,16,0,38
MONROE,5/5/2020,24,16,0,40
MONROE,5/6/2020,42,29,2,73
MONROE,5/7/2020,43,29,2,74
MONROE,5/8/2020,43,29,2,74
MONROE,5/9/2020,44,30,2,76
MONROE,5/10/2020,46,30,2,78
MONROE,5/11/2020,53,34,2,89
MONROE,5/12/2020,53,34,2,89
MONROE,5/13/2020,55,38,2,95
MONROE,5/14/2020,58,39,2,99
MONROE,5/15/2020,66,42,2,110
MONROE,5/16/2020,66,43,2,111
MONROE,5/17/2020,66,44,2,112
MONROE,5/18/2020,68,47,2,117
MONROE,5/19/2020,68,47,2,117
MONROE,5/20/2020,70,48,2,120
MONROE,5/21/2020,70,48,2,120
MONROE,5/22/2020,70,49,2,121
MONROE,5/23/2020,70,49,2,121
MONROE,5/24/2020,70,49,2,121
MONROE,5/25/2020,71,50,2,123
MONROE,5/26/2020,72,51,3,126
MONROE,5/27/2020,72,51,3,126
MONROE,5/28/2020,73,51,3,127
MONROE,5/29/2020,73,51,3,127
MONROE,5/30/2020,75,51,3,129
MONROE,5/31/2020,75,51,3,129
MONROE,6/1/2020,76,51,3,130
MONROE,6/2/2020,76,51,3,130
MONROE,6/3/2020,76,51,3,130
MONROE,6/4/2020,76,52,3,131
MONROE,6/5/2020,76,52,3,131
MONROE,6/6/2020,77,52,3,132
MONROE,6/7/2020,77,52,3,132
MONROE,6/8/2020,77,52,3,132
MONROE,6/9/2020,79,52,3,134
MONROE,6/10/2020,79,53,3,135
MONROE,6/11/2020,79,54,3,136
MONROE,6/12/2020,80,55,3,138
MONROE,6/13/2020,80,55,3,138
MONROE,6/14/2020,80,55,3,138
MONROE,6/15/2020,80,55,3,138
MONROE,6/16/2020,80,56,3,139
MONROE,6/17/2020,80,60,3,143
MONROE,6/18/2020,82,63,3,148
MONROE,6/19/2020,84,65,3,152
MONROE,6/20/2020,85,67,3,155
MONROE,6/21/2020,85,68,3,156
MONROE,6/22/2020,89,69,3,161
MONROE,6/23/2020,91,70,3,164
MONROE,6/24/2020,95,75,3,173
MONROE,6/25/2020,95,76,3,174
MONROE,6/26/2020,96,78,3,177
MONROE,6/27/2020,98,80,4,182
MONROE,6/28/2020,98,81,4,183
MONROE,6/29/2020,101,84,4,189
MONROE,6/30/2020,110,91,5,206
MONROE,7/1/2020,114,93,5,212
MONROE,7/2/2020,117,97,5,219
MONROE,7/3/2020,122,101,5,228
MONROE,7/4/2020,124,105,5,234
MONROE,7/5/2020,127,106,5,238
MONROE,7/6/2020,131,109,5,245
MONROE,7/7/2020,138,111,6,255
MONROE,7/8/2020,145,118,6,269
MONROE,7/9/2020,160,129,6,295
MONROE,7/10/2020,162,135,6,303
MONROE,7/11/2020,165,136,6,307
MONROE,7/12/2020,170,144,6,320
MONROE,7/13/2020,180,150,10,340
MONROE,7/14/2020,189,154,10,353
MONROE,7/15/2020,193,158,11,362
MONROE,7/16/2020,196,161,13,370
MONROE,7/17/2020,198,163,13,374
MONROE,7/18/2020,203,164,14,381
MONROE,7/19/2020,205,165,14,384
MONROE,7/20/2020,212,171,14,397
MONROE,7/21/2020,215,175,14,404
MONROE,7/22/2020,218,180,15,413
MONROE,7/23/2020,222,181,17,420
MONROE,7/24/2020,230,187,17,434
MONROE,7/25/2020,234,190,17,441
MONROE,7/26/2020,237,190,17,444
MONROE,7/27/2020,241,193,17,451
MONROE,7/28/2020,244,197,17,458
MONROE,7/29/2020,248,199,18,465
MONROE,7/30/2020,249,204,18,471
MONROE,7/31/2020,252,208,18,478
MONROE,8/1/2020,255,209,18,482
MONROE,8/2/2020,256,210,18,484
MONROE,8/3/2020,258,210,18,486
MONROE,8/4/2020,259,213,18,490
MONROE,8/5/2020,263,213,18,494
MONROE,8/6/2020,264,217,18,499
MONROE,8/7/2020,265,220,18,503
MONROE,8/8/2020,266,224,18,508
MONROE,8/9/2020,269,230,18,517
MONROE,8/10/2020,271,234,18,523
MONROE,8/11/2020,273,237,18,528
MONROE,8/12/2020,277,240,18,535
MONROE,8/13/2020,281,243,18,542
MONROE,8/14/2020,283,247,18,548
MONROE,8/15/2020,285,247,18,550
MONROE,8/16/2020,288,248,18,554
MONROE,8/17/2020,292,248,18,558
MONROE,8/18/2020,293,249,18,560
MONROE,8/19/2020,296,250,18,564
MONROE,8/20/2020,299,251,18,568
MONROE,8/21/2020,300,256,18,574
MONROE,8/22/2020,303,257,18,578
MONROE,8/23/2020,303,257,18,578
MONROE,8/24/2020,305,258,18,581
MONROE,8/25/2020,308,259,18,585
MONROE,8/26/2020,310,260,18,588
MONROE,8/27/2020,312,261,18,591
MONROE,8/28/2020,315,267,18,600
MONROE,8/29/2020,315,268,18,601
MONROE,8/30/2020,316,268,18,602
MONROE,8/31/2020,317,270,18,605
MONROE,9/1/2020,317,270,18,605
MONROE,9/2/2020,319,274,18,611
MONROE,9/3/2020,322,276,18,616
MONROE,9/4/2020,324,278,18,620
MONROE,9/5/2020,326,279,18,623
MONROE,9/6/2020,329,281,18,628
MONROE,9/7/2020,330,283,18,631
MONROE,9/8/2020,332,286,18,636
MONROE,9/9/2020,334,289,18,641
MONROE,9/10/2020,334,290,18,642
MONROE,9/11/2020,336,292,18,646
MONROE,9/12/2020,338,293,18,649
MONROE,9/13/2020,339,294,18,651
MONROE,9/14/2020,342,296,18,656
MONROE,9/15/2020,344,300,18,662
MONROE,9/16/2020,344,300,18,662
MONROE,9/17/2020,344,300,18,662
MONROE,9/18/2020,347,300,18,665
MONROE,9/19/2020,348,303,18,669
MONROE,9/20/2020,350,304,18,672
MONROE,9/21/2020,354,306,18,678
MONROE,9/22/2020,357,308,18,683
MONROE,9/23/2020,358,312,18,688
MONROE,9/24/2020,359,313,18,690
MONROE,9/25/2020,361,313,18,692
MONROE,9/26/2020,365,315,19,699
MONROE,9/27/2020,365,316,19,700
MONROE,9/28/2020,367,316,19,702
MONROE,9/29/2020,367,319,19,705
MONROE,9/30/2020,368,320,19,707
MONROE,10/1/2020,370,321,19,710
MONROE,10/2/2020,372,321,19,712
MONROE,10/3/2020,373,322,19,714
MONROE,10/4/2020,374,324,19,717
MONROE,10/5/2020,376,327,19,722
MONROE,10/6/2020,378,327,19,724
MONROE,10/7/2020,378,331,19,728
MONROE,10/8/2020,381,333,19,733
MONROE,10/9/2020,382,333,19,734
MONROE,10/10/2020,384,333,19,736
MONROE,10/11/2020,384,334,19,737
MONROE,10/12/2020,384,334,19,737
MONROE,10/13/2020,385,334,19,738
MONROE,10/14/2020,388,334,19,741
MONROE,10/15/2020,389,336,19,744
MONROE,10/16/2020,390,336,19,745
MONROE,10/17/2020,390,337,19,746
MONROE,10/18/2020,390,337,19,746
MONROE,10/19/2020,391,337,19,747
MONROE,10/20/2020,391,337,19,747
PULASKI,1/1/2020,0,0,0,0
PULASKI,1/2/2020,0,0,0,0
PULASKI,1/3/2020,0,0,0,0
PULASKI,1/4/2020,0,0,0,0
PULASKI,1/5/2020,0,0,0,0
PULASKI,1/6/2020,0,0,0,0
PULASKI,1/7/2020,0,0,0,0
PULASKI,1/8/2020,0,0,0,0
PULASKI,1/9/2020,0,0,0,0
PULASKI,1/10/2020,0,0,0,0
PULASKI,1/11/2020,0,0,0,0
PULASKI,1/12/2020,0,0,0,0
PULASKI,1/13/2020,0,0,0,0
PULASKI,1/14/2020,0,0,0,0
PULASKI,1/15/2020,0,0,0,0
PULASKI,1/16/2020,0,0,0,0
PULASKI,1/17/2020,0,0,0,0
PULASKI,1/18/2020,0,0,0,0
PULASKI,1/19/2020,0,0,0,0
PULASKI,1/20/2020,0,0,0,0
PULASKI,1/21/2020,0,0,0,0
PULASKI,1/22/2020,0,0,0,0
PULASKI,1/23/2020,0,0,0,0
PULASKI,1/24/2020,0,0,0,0
PULASKI,1/25/2020,0,0,0,0
PULASKI,1/26/2020,0,0,0,0
PULASKI,1/27/2020,0,0,0,0
PULASKI,1/28/2020,0,0,0,0
PULASKI,1/29/2020,0,0,0,0
PULASKI,1/30/2020,0,0,0,0
PULASKI,1/31/2020,0,0,0,0
PULASKI,2/1/2020,0,0,0,0
PULASKI,2/2/2020,0,0,0,0
PULASKI,2/3/2020,0,0,0,0
PULASKI,2/4/2020,0,0,0,0
PULASKI,2/5/2020,0,0,0,0
PULASKI,2/6/2020,0,0,0,0
PULASKI,2/7/2020,0,0,0,0
PULASKI,2/8/2020,0,0,0,0
PULASKI,2/9/2020,0,0,0,0
PULASKI,2/10/2020,0,0,0,0
PULASKI,2/11/2020,0,0,0,0
PULASKI,2/12/2020,0,0,0,0
PULASKI,2/13/2020,0,0,0,0
PULASKI,2/14/2020,0,0,0,0
PULASKI,2/15/2020,0,0,0,0
PULASKI,2/16/2020,0,0,0,0
PULASKI,2/17/2020,0,0,0,0
PULASKI,2/18/2020,0,0,0,0
PULASKI,2/19/2020,0,0,0,0
PULASKI,2/20/2020,0,0,0,0
PULASKI,2/21/2020,0,0,0,0
PULASKI,2/22/2020,0,0,0,0
PULASKI,2/23/2020,0,0,0,0
PULASKI,2/24/2020,0,0,0,0
PULASKI,2/25/2020,0,0,0,0
PULASKI,2/26/2020,0,0,0,0
PULASKI,2/27/2020,0,0,0,0
PULASKI,2/28/2020,0,0,0,0
PULASKI,2/29/2020,0,0,0,0
PULASKI,3/1/2020,1,0,0,1
PULASKI,3/2/2020,1,0,0,1
PULASKI,3/3/2020,1,0,0,1
PULASKI,3/4/2020,1,0,0,1
PULASKI,3/5/2020,1,0,0,1
PULASKI,3/6/2020,1,0,0,1
PULASKI,3/7/2020,1,0,0,1
PULASKI,3/8/2020,1,0,0,1
PULASKI,3/9/2020,1,0,0,1
PULASKI,3/10/2020,1,0,0,1
PULASKI,3/11/2020,1,0,0,1
PULASKI,3/12/2020,1,0,0,1
PULASKI,3/13/2020,1,0,0,1
PULASKI,3/14/2020,1,0,0,1
PULASKI,3/15/2020,1,0,0,1
PULASKI,3/16/2020,1,1,0,2
PULASKI,3/17/2020,1,1,0,2
PULASKI,3/18/2020,1,1,0,2
PULASKI,3/19/2020,1,1,0,2
PULASKI,3/20/2020,2,1,0,3
PULASKI,3/21/2020,2,1,0,3
PULASKI,3/22/2020,2,1,0,3
PULASKI,3/23/2020,3,2,0,5
PULASKI,3/24/2020,4,3,0,7
PULASKI,3/25/2020,4,3,0,7
PULASKI,3/26/2020,4,3,0,7
PULASKI,3/27/2020,4,3,0,7
PULASKI,3/28/2020,5,3,0,8
PULASKI,3/29/2020,6,3,0,9
PULASKI,3/30/2020,6,3,0,9
PULASKI,3/31/2020,6,3,0,9
PULASKI,4/1/2020,6,4,0,10
PULASKI,4/2/2020,6,4,0,10
PULASKI,4/3/2020,7,5,0,12
PULASKI,4/4/2020,7,5,0,12
PULASKI,4/5/2020,8,5,0,13
ELBERT,1/17/2020,0,0,0,0
ELBERT,1/18/2020,0,0,0,0
ELBERT,1/19/2020,0,0,0,0
ELBERT,1/20/2020,0,0,0,0
ELBERT,1/21/2020,0,0,0,0
ELBERT,1/22/2020,0,0,0,0
ELBERT,1/23/2020,0,0,0,0
ELBERT,1/24/2020,0,0,0,0
ELBERT,1/25/2020,0,0,0,0
ELBERT,1/26/2020,0,0,0,0
ELBERT,1/27/2020,0,0,0,0
ELBERT,1/28/2020,0,0,0,0
ELBERT,1/29/2020,0,0,0,0
ELBERT,1/30/2020,0,0,0,0
ELBERT,1/31/2020,0,0,0,0
ELBERT,2/1/2020,0,0,0,0
ELBERT,2/2/2020,0,0,0,0
ELBERT,2/3/2020,0,0,0,0
ELBERT,2/4/2020,0,0,0,0
ELBERT,2/5/2020,0,0,0,0
ELBERT,2/6/2020,0,0,0,0
ELBERT,2/7/2020,0,0,0,0
ELBERT,2/8/2020,0,0,0,0
ELBERT,2/9/2020,0,0,0,0
ELBERT,2/10/2020,0,0,0,0
ELBERT,2/11/2020,0,0,0,0
ELBERT,2/12/2020,0,0,0,0
ELBERT,2/13/2020,0,0,0,0
ELBERT,2/14/2020,0,0,0,0
ELBERT,2/15/2020,0,0,0,0
ELBERT,2/16/2020,0,0,0,0
ELBERT,2/17/2020,0,0,0,0
ELBERT,2/18/2020,0,0,0,0
ELBERT,2/19/2020,0,0,0,0
ELBERT,2/20/2020,0,0,0,0
ELBERT,2/21/2020,0,0,0,0
ELBERT,2/22/2020,0,0,0,0
ELBERT,2/23/2020,0,0,0,0
ELBERT,2/24/2020,0,0,0,0
ELBERT,2/25/2020,0,0,0,0
ELBERT,2/26/2020,0,0,0,0
ELBERT,2/27/2020,0,0,0,0
ELBERT,2/28/2020,0,0,0,0
ELBERT,2/29/2020,0,0,0,0
ELBERT,3/1/2020,0,0,0,0
ELBERT,3/2/2020,0,0,0,0
ELBERT,3/3/2020,0,0,0,0
ELBERT,3/4/2020,0,0,0,0
ELBERT,3/5/2020,0,0,0,0
ELBERT,3/6/2020,0,0,0,0
ELBERT,3/7/2020,0,0,0,0
ELBERT,3/8/2020,0,0,0,0
ELBERT,3/9/2020,0,0,0,0
ELBERT,3/10/2020,0,0,0,0
ELBERT,3/11/2020,0,0,0,0
ELBERT,3/12/2020,0,0,0,0
ELBERT,3/13/2020,0,0,0,0
ELBERT,3/14/2020,0,0,0,0
ELBERT,3/15/2020,0,0,0,0
ELBERT,3/16/2020,0,0,0,0
ELBERT,3/17/2020,1,0,0,1
ELBERT,3/18/2020,1,0,0,1
ELBERT,3/19/2020,1,0,0,1
ELBERT,3/20/2020,1,0,0,1
ELBERT,3/21/2020,1,0,0,1
ELBERT,3/22/2020,1,0,0,1
ELBERT,3/23/2020,1,0,0,1
ELBERT,3/24/2020,1,0,0,1
ELBERT,3/25/2020,1,0,0,1
ELBERT,3/26/2020,1,0,0,1
ELBERT,3/27/2020,1,0,0,1
ELBERT,3/28/2020,1,0,0,1
ELBERT,3/29/2020,1,0,0,1
ELBERT,3/30/2020,1,0,0,1
ELBERT,3/31/2020,1,0,0,1
ELBERT,4/1/2020,2,1,0,3
ELBERT,4/2/2020,2,1,0,3
ELBERT,4/3/2020,2,1,0,3
ELBERT,4/4/2020,2,1,0,3
ELBERT,4/5/2020,3,1,0,4
ELBERT,4/6/2020,3,1,0,4
ELBERT,4/7/2020,4,3,0,7
ELBERT,4/8/2020,4,3,0,7
ELBERT,4/9/2020,5,3,0,8
ELBERT,4/10/2020,5,3,0,8
ELBERT,4/11/2020,5,3,0,8
ELBERT,4/12/2020,5,3,0,8
ELBERT,4/13/2020,5,3,0,8
ELBERT,4/14/2020,5,3,0,8
ELBERT,4/15/2020,5,3,0,8
ELBERT,4/16/2020,5,3,0,8
ELBERT,4/17/2020,7,3,0,10
ELBERT,4/18/2020,8,3,0,11
ELBERT,4/19/2020,8,3,0,11
ELBERT,4/20/2020,10,4,0,14
ELBERT,4/21/2020,15,6,0,21
ELBERT,4/22/2020,17,7,0,24
ELBERT,4/23/2020,17,7,0,24
ELBERT,4/24/2020,18,7,0,25
ELBERT,4/25/2020,19,7,0,26
ELBERT,4/26/2020,20,8,0,28
ELBERT,4/27/2020,23,9,0,32
ELBERT,4/28/2020,24,9,0,33
ELBERT,4/29/2020,26,26,0,52
ELBERT,4/30/2020,27,30,0,57
ELBERT,5/1/2020,27,30,0,57
ELBERT,5/2/2020,27,30,0,57
ELBERT,5/3/2020,27,30,0,57
ELBERT,5/4/2020,28,32,0,60
ELBERT,5/5/2020,29,34,0,63
ELBERT,5/6/2020,29,35,0,64
ELBERT,5/7/2020,29,35,0,64
ELBERT,5/8/2020,29,38,0,67
ELBERT,5/9/2020,29,38,0,67
ELBERT,5/10/2020,29,38,0,67
ELBERT,5/11/2020,29,39,0,68
ELBERT,5/12/2020,30,40,0,70
ELBERT,5/13/2020,31,40,0,71
ELBERT,5/14/2020,31,40,0,71
ELBERT,5/15/2020,33,40,0,73
ELBERT,5/16/2020,34,40,0,74
ELBERT,5/17/2020,34,41,0,75
ELBERT,5/18/2020,34,41,0,75
ELBERT,5/19/2020,34,41,0,75
ELBERT,5/20/2020,34,41,0,75
ELBERT,5/21/2020,34,42,0,76
ELBERT,5/22/2020,34,42,0,76
ELBERT,5/23/2020,34,42,0,76
ELBERT,5/24/2020,35,42,0,77
ELBERT,5/25/2020,35,42,0,77
ELBERT,5/26/2020,35,42,0,77
ELBERT,5/27/2020,36,42,0,78
ELBERT,5/28/2020,36,42,0,78
ELBERT,5/29/2020,36,42,0,78
ELBERT,5/30/2020,36,42,0,78
ELBERT,5/31/2020,36,42,0,78
ELBERT,6/1/2020,36,43,0,79
ELBERT,6/2/2020,37,43,0,80
ELBERT,6/3/2020,38,43,0,81
ELBERT,6/4/2020,39,43,0,82
ELBERT,6/5/2020,39,45,0,84
ELBERT,6/6/2020,39,46,0,85
ELBERT,6/7/2020,39,46,0,85
ELBERT,6/8/2020,41,49,0,90
ELBERT,6/9/2020,41,49,0,90
ELBERT,6/10/2020,42,50,0,92
ELBERT,6/11/2020,42,50,0,92
ELBERT,6/12/2020,42,50,0,92
ELBERT,6/13/2020,42,50,0,92
ELBERT,6/14/2020,42,50,0,92
ELBERT,6/15/2020,44,51,0,95
ELBERT,6/16/2020,45,52,0,97
ELBERT,6/17/2020,47,52,0,99
ELBERT,6/18/2020,47,52,0,99
ELBERT,6/19/2020,47,52,0,99
ELBERT,6/20/2020,48,53,0,101
ELBERT,6/21/2020,50,53,0,103
ELBERT,6/22/2020,53,53,0,106
ELBERT,6/23/2020,56,55,0,111
ELBERT,6/24/2020,57,59,0,116
ELBERT,6/25/2020,63,60,0,123
ELBERT,6/26/2020,65,60,0,125
ELBERT,6/27/2020,65,62,0,127
ELBERT,6/28/2020,66,63,0,129
ELBERT,6/29/2020,67,65,0,132
ELBERT,6/30/2020,71,68,0,139
ELBERT,7/1/2020,73,70,1,144
ELBERT,7/2/2020,80,72,1,153
ELBERT,7/3/2020,82,75,1,158
ELBERT,7/4/2020,91,76,1,168
ELBERT,7/5/2020,96,78,1,175
ELBERT,7/6/2020,111,83,1,195
ELBERT,7/7/2020,119,84,1,204
ELBERT,7/8/2020,126,91,1,218
ELBERT,7/9/2020,130,95,1,226
ELBERT,7/10/2020,137,102,1,240
ELBERT,7/11/2020,139,102,2,243
ELBERT,7/12/2020,142,104,2,248
ELBERT,7/13/2020,152,113,2,267
ELBERT,7/14/2020,156,117,2,275
ELBERT,7/15/2020,161,118,2,281
ELBERT,7/16/2020,167,124,2,293
ELBERT,7/17/2020,171,126,2,299
ELBERT,7/18/2020,174,127,2,303
ELBERT,7/19/2020,174,128,2,304
ELBERT,7/20/2020,177,130,2,309
ELBERT,7/21/2020,181,132,2,315
ELBERT,7/22/2020,185,133,2,320
ELBERT,7/23/2020,188,135,2,325
ELBERT,7/24/2020,195,136,2,333
ELBERT,7/25/2020,200,138,2,340
ELBERT,7/26/2020,203,140,2,345
ELBERT,7/27/2020,208,144,2,354
ELBERT,7/28/2020,210,145,3,358
ELBERT,7/29/2020,213,146,3,362
ELBERT,7/30/2020,217,148,3,368
ELBERT,7/31/2020,221,149,3,373
ELBERT,8/1/2020,223,150,3,376
ELBERT,8/2/2020,226,150,3,379
ELBERT,8/3/2020,228,152,4,384
ELBERT,8/4/2020,232,154,4,390
ELBERT,8/5/2020,234,155,4,393
ELBERT,8/6/2020,237,156,4,397
PULASKI,4/7/2020,10,6,0,16
ELBERT,8/7/2020,240,158,4,402
ELBERT,8/8/2020,240,158,4,402
ELBERT,8/9/2020,242,158,4,404
ELBERT,8/10/2020,246,162,4,412
ELBERT,8/11/2020,248,163,4,415
ELBERT,8/12/2020,249,165,4,418
ELBERT,8/13/2020,253,170,4,427
ELBERT,8/14/2020,256,171,4,431
ELBERT,8/15/2020,259,171,4,434
ELBERT,8/16/2020,263,171,4,438
ELBERT,8/17/2020,266,172,4,442
ELBERT,8/18/2020,270,175,4,449
ELBERT,8/19/2020,270,178,4,452
ELBERT,8/20/2020,273,182,4,459
ELBERT,8/21/2020,276,186,5,467
ELBERT,8/22/2020,278,186,5,469
ELBERT,8/23/2020,279,186,11,476
ELBERT,8/24/2020,281,193,18,492
ELBERT,8/25/2020,283,195,20,498
ELBERT,8/26/2020,285,196,20,501
ELBERT,8/27/2020,285,198,20,503
ELBERT,8/28/2020,295,200,20,515
ELBERT,8/29/2020,296,203,20,519
ELBERT,8/30/2020,296,204,20,520
ELBERT,8/31/2020,297,207,20,524
ELBERT,9/1/2020,310,214,20,544
ELBERT,9/2/2020,315,218,20,553
ELBERT,9/3/2020,319,220,20,559
ELBERT,9/4/2020,322,221,20,563
ELBERT,9/5/2020,325,221,20,566
ELBERT,9/6/2020,328,221,20,569
ELBERT,9/7/2020,332,222,20,574
ELBERT,9/8/2020,336,222,20,578
ELBERT,9/9/2020,353,227,20,600
ELBERT,9/10/2020,356,229,20,605
ELBERT,9/11/2020,356,230,20,606
ELBERT,9/12/2020,359,231,20,610
ELBERT,9/13/2020,361,234,20,615
ELBERT,9/14/2020,367,234,20,621
ELBERT,9/15/2020,370,240,20,630
ELBERT,9/16/2020,376,242,20,638
ELBERT,9/17/2020,377,243,20,640
ELBERT,9/18/2020,378,247,20,645
ELBERT,9/19/2020,381,248,20,649
ELBERT,9/20/2020,384,251,20,655
ELBERT,9/21/2020,390,257,20,667
ELBERT,9/22/2020,392,261,20,673
ELBERT,9/23/2020,396,263,20,679
ELBERT,9/24/2020,399,263,20,682
ELBERT,9/25/2020,402,266,20,688
ELBERT,9/26/2020,408,266,20,694
ELBERT,9/27/2020,411,267,20,698
ELBERT,9/28/2020,412,272,20,704
ELBERT,9/29/2020,414,273,20,707
ELBERT,9/30/2020,415,274,20,709
ELBERT,10/1/2020,415,277,20,712
ELBERT,10/2/2020,415,277,20,712
ELBERT,10/3/2020,415,279,20,714
ELBERT,10/4/2020,416,282,20,718
ELBERT,10/5/2020,416,284,20,720
ELBERT,10/6/2020,417,284,20,721
ELBERT,10/7/2020,417,286,20,723
ELBERT,10/8/2020,419,287,20,726
ELBERT,10/9/2020,421,290,20,731
ELBERT,10/10/2020,423,292,20,735
ELBERT,10/11/2020,424,292,20,736
ELBERT,10/12/2020,425,296,20,741
ELBERT,10/13/2020,426,297,20,743
ELBERT,10/14/2020,427,298,20,745
ELBERT,10/15/2020,431,299,20,750
ELBERT,10/16/2020,431,301,20,752
ELBERT,10/17/2020,431,301,20,752
ELBERT,10/18/2020,431,301,20,752
ELBERT,10/19/2020,431,301,20,752
ELBERT,10/20/2020,431,301,20,752
JEFFERSON,1/1/2020,0,0,0,0
JEFFERSON,1/2/2020,0,0,0,0
JEFFERSON,1/3/2020,0,0,0,0
JEFFERSON,1/4/2020,0,0,0,0
JEFFERSON,1/5/2020,0,0,0,0
JEFFERSON,1/6/2020,0,0,0,0
JEFFERSON,1/7/2020,0,0,0,0
JEFFERSON,1/8/2020,0,0,0,0
JEFFERSON,1/9/2020,0,0,0,0
JEFFERSON,1/10/2020,0,0,0,0
JEFFERSON,1/11/2020,0,0,0,0
JEFFERSON,1/12/2020,0,0,0,0
JEFFERSON,1/13/2020,0,0,0,0
JEFFERSON,1/14/2020,0,0,0,0
JEFFERSON,1/15/2020,0,0,0,0
JEFFERSON,1/16/2020,0,0,0,0
JEFFERSON,1/17/2020,0,0,0,0
JEFFERSON,1/18/2020,0,0,0,0
JEFFERSON,1/19/2020,0,0,0,0
JEFFERSON,1/20/2020,0,0,0,0
JEFFERSON,1/21/2020,0,0,0,0
JEFFERSON,1/22/2020,0,0,0,0
JEFFERSON,1/23/2020,0,0,0,0
JEFFERSON,1/24/2020,0,0,0,0
JEFFERSON,1/25/2020,0,0,0,0
JEFFERSON,1/26/2020,0,0,0,0
JEFFERSON,1/27/2020,0,0,0,0
JEFFERSON,1/28/2020,0,0,0,0
JEFFERSON,1/29/2020,0,0,0,0
JEFFERSON,1/30/2020,0,0,0,0
JEFFERSON,1/31/2020,0,0,0,0
JEFFERSON,2/1/2020,0,0,0,0
JEFFERSON,2/2/2020,0,0,0,0
JEFFERSON,2/3/2020,0,0,0,0
JEFFERSON,2/4/2020,0,0,0,0
JEFFERSON,2/5/2020,0,0,0,0
JEFFERSON,2/6/2020,0,0,0,0
JEFFERSON,2/7/2020,0,0,0,0
JEFFERSON,2/8/2020,0,0,0,0
JEFFERSON,2/9/2020,0,0,0,0
JEFFERSON,2/10/2020,0,0,0,0
JEFFERSON,2/11/2020,0,0,0,0
JEFFERSON,2/12/2020,0,0,0,0
JEFFERSON,2/13/2020,0,0,0,0
JEFFERSON,2/14/2020,0,0,0,0
JEFFERSON,2/15/2020,0,0,0,0
JEFFERSON,2/16/2020,0,0,0,0
JEFFERSON,2/17/2020,0,0,0,0
JEFFERSON,2/18/2020,0,0,0,0
JEFFERSON,2/19/2020,0,0,0,0
JEFFERSON,2/20/2020,0,0,0,0
JEFFERSON,2/21/2020,0,0,0,0
JEFFERSON,2/22/2020,0,0,0,0
JEFFERSON,2/23/2020,0,0,0,0
JEFFERSON,2/24/2020,0,0,0,0
JEFFERSON,2/25/2020,0,0,0,0
JEFFERSON,2/26/2020,0,0,0,0
JEFFERSON,2/27/2020,0,0,0,0
JEFFERSON,2/28/2020,0,0,0,0
JEFFERSON,2/29/2020,0,0,0,0
JEFFERSON,3/1/2020,0,0,0,0
JEFFERSON,3/2/2020,0,0,0,0
JEFFERSON,3/3/2020,0,0,0,0
JEFFERSON,3/4/2020,0,0,0,0
JEFFERSON,3/5/2020,0,0,0,0
JEFFERSON,3/6/2020,0,0,0,0
JEFFERSON,3/7/2020,0,0,0,0
JEFFERSON,3/8/2020,0,0,0,0
JEFFERSON,3/9/2020,0,0,0,0
JEFFERSON,3/10/2020,0,0,0,0
JEFFERSON,3/11/2020,0,0,0,0
JEFFERSON,3/12/2020,0,0,0,0
JEFFERSON,3/13/2020,0,0,0,0
JEFFERSON,3/14/2020,0,0,0,0
JEFFERSON,3/15/2020,0,0,0,0
JEFFERSON,3/16/2020,0,0,0,0
JEFFERSON,3/17/2020,1,0,0,1
JEFFERSON,3/18/2020,1,0,0,1
JEFFERSON,3/19/2020,1,0,0,1
JEFFERSON,3/20/2020,2,0,0,2
JEFFERSON,3/21/2020,2,0,0,2
JEFFERSON,3/22/2020,2,0,0,2
JEFFERSON,3/23/2020,4,0,0,4
JEFFERSON,3/24/2020,5,0,0,5
JEFFERSON,3/25/2020,5,0,0,5
JEFFERSON,3/26/2020,5,0,0,5
JEFFERSON,3/27/2020,6,0,0,6
JEFFERSON,3/28/2020,6,1,0,7
JEFFERSON,3/29/2020,7,1,0,8
JEFFERSON,3/30/2020,8,1,0,9
JEFFERSON,3/31/2020,8,1,0,9
JEFFERSON,4/1/2020,8,1,0,9
JEFFERSON,4/2/2020,8,1,0,9
JEFFERSON,4/3/2020,8,1,0,9
JEFFERSON,4/4/2020,9,1,0,10
JEFFERSON,4/5/2020,9,1,0,10
JEFFERSON,4/6/2020,9,1,0,10
JEFFERSON,4/7/2020,9,1,0,10
JEFFERSON,4/8/2020,9,2,0,11
JEFFERSON,4/9/2020,9,2,0,11
JEFFERSON,4/10/2020,9,2,0,11
JEFFERSON,4/11/2020,9,2,0,11
JEFFERSON,4/12/2020,9,2,0,11
JEFFERSON,4/13/2020,9,2,0,11
JEFFERSON,4/14/2020,9,2,0,11
JEFFERSON,4/15/2020,10,2,0,12
JEFFERSON,4/16/2020,10,2,0,12
JEFFERSON,4/17/2020,10,2,0,12
JEFFERSON,4/18/2020,10,2,0,12
JEFFERSON,4/19/2020,10,2,0,12
JEFFERSON,4/20/2020,11,3,0,14
JEFFERSON,4/21/2020,11,3,0,14
JEFFERSON,4/22/2020,11,3,0,14
JEFFERSON,4/23/2020,11,4,0,15
JEFFERSON,4/24/2020,11,4,0,15
JEFFERSON,4/25/2020,13,4,0,17
JEFFERSON,4/26/2020,13,4,0,17
JEFFERSON,4/27/2020,13,4,0,17
JEFFERSON,4/28/2020,13,5,0,18
JEFFERSON,4/29/2020,13,5,0,18
PULASKI,4/8/2020,10,6,0,16
PULASKI,4/9/2020,10,6,0,16
PULASKI,4/10/2020,10,6,0,16
PULASKI,4/11/2020,10,6,0,16
PULASKI,4/12/2020,11,6,0,17
PULASKI,4/13/2020,11,6,0,17
PULASKI,4/14/2020,11,6,0,17
PULASKI,4/15/2020,11,6,0,17
PULASKI,4/16/2020,12,7,0,19
PULASKI,4/17/2020,12,7,0,19
PULASKI,4/18/2020,12,7,0,19
PULASKI,4/19/2020,12,7,0,19
PULASKI,4/20/2020,12,7,0,19
PULASKI,4/21/2020,12,7,0,19
PULASKI,4/22/2020,14,10,0,24
PULASKI,4/23/2020,15,11,0,26
PULASKI,4/24/2020,16,11,0,27
PULASKI,4/25/2020,17,11,0,28
PULASKI,4/26/2020,17,11,0,28
PULASKI,4/27/2020,17,11,0,28
PULASKI,4/28/2020,18,11,0,29
PULASKI,4/29/2020,18,11,0,29
PULASKI,4/30/2020,20,11,0,31
PULASKI,5/1/2020,20,11,0,31
PULASKI,5/2/2020,20,11,0,31
PULASKI,5/3/2020,20,12,0,32
PULASKI,5/4/2020,20,12,0,32
PULASKI,5/5/2020,20,12,0,32
PULASKI,5/6/2020,20,12,0,32
PULASKI,5/7/2020,20,13,0,33
PULASKI,5/8/2020,20,13,0,33
PULASKI,5/9/2020,20,13,0,33
PULASKI,5/10/2020,20,13,0,33
PULASKI,5/11/2020,20,13,0,33
PULASKI,5/12/2020,20,13,0,33
PULASKI,5/13/2020,20,13,0,33
PULASKI,5/14/2020,21,17,0,38
PULASKI,5/15/2020,21,17,0,38
PULASKI,5/16/2020,21,17,0,38
PULASKI,5/17/2020,21,17,0,38
PULASKI,5/18/2020,21,17,0,38
PULASKI,5/19/2020,21,17,0,38
PULASKI,5/20/2020,22,17,0,39
PULASKI,5/21/2020,22,17,0,39
PULASKI,5/22/2020,22,18,0,40
PULASKI,5/23/2020,22,19,0,41
PULASKI,5/24/2020,28,19,0,47
PULASKI,5/25/2020,28,19,0,47
PULASKI,5/26/2020,39,22,0,61
PULASKI,5/27/2020,39,22,0,61
PULASKI,5/28/2020,39,22,0,61
PULASKI,5/29/2020,39,22,0,61
PULASKI,5/30/2020,39,23,0,62
PULASKI,5/31/2020,41,23,0,64
PULASKI,6/1/2020,41,23,0,64
PULASKI,6/2/2020,41,23,0,64
PULASKI,6/3/2020,41,23,0,64
PULASKI,6/4/2020,42,23,0,65
PULASKI,6/5/2020,42,23,0,65
PULASKI,6/6/2020,42,23,0,65
PULASKI,6/7/2020,42,23,0,65
PULASKI,6/8/2020,42,23,0,65
PULASKI,6/9/2020,42,23,0,65
PULASKI,6/10/2020,42,23,0,65
PULASKI,6/11/2020,43,23,0,66
PULASKI,6/12/2020,43,23,0,66
PULASKI,6/13/2020,43,23,0,66
PULASKI,6/14/2020,43,23,0,66
PULASKI,6/15/2020,43,23,0,66
PULASKI,6/16/2020,43,23,0,66
PULASKI,6/17/2020,43,23,0,66
PULASKI,6/18/2020,43,23,0,66
PULASKI,6/19/2020,43,23,0,66
PULASKI,6/20/2020,43,23,0,66
PULASKI,6/21/2020,43,23,0,66
PULASKI,6/22/2020,43,24,0,67
PULASKI,6/23/2020,44,26,0,70
PULASKI,6/24/2020,44,26,0,70
PULASKI,6/25/2020,45,26,0,71
PULASKI,6/26/2020,45,26,0,71
PULASKI,6/27/2020,45,27,0,72
PULASKI,6/28/2020,46,27,0,73
PULASKI,6/29/2020,47,28,0,75
PULASKI,6/30/2020,47,28,0,75
PULASKI,7/1/2020,48,28,0,76
PULASKI,7/2/2020,48,29,0,77
PULASKI,7/3/2020,48,29,0,77
PULASKI,7/4/2020,48,30,0,78
PULASKI,7/5/2020,48,30,0,78
PULASKI,7/6/2020,48,31,0,79
PULASKI,7/7/2020,48,32,0,80
PULASKI,7/8/2020,48,32,0,80
PULASKI,7/9/2020,48,32,0,80
PULASKI,7/10/2020,48,33,0,81
PULASKI,7/11/2020,48,33,0,81
PULASKI,7/12/2020,49,33,0,82
PULASKI,7/13/2020,54,35,0,89
PULASKI,7/14/2020,54,35,0,89
PULASKI,7/15/2020,54,35,0,89
PULASKI,7/16/2020,55,37,0,92
PULASKI,7/17/2020,55,37,0,92
PULASKI,7/18/2020,56,37,0,93
PULASKI,7/19/2020,57,38,0,95
PULASKI,7/20/2020,57,40,0,97
PULASKI,7/21/2020,57,41,0,98
PULASKI,7/22/2020,57,42,0,99
PULASKI,7/23/2020,58,42,0,100
PULASKI,7/24/2020,58,43,0,101
PULASKI,7/25/2020,59,43,0,102
PULASKI,7/26/2020,60,43,0,103
PULASKI,7/27/2020,63,46,0,109
PULASKI,7/28/2020,64,47,0,111
PULASKI,7/29/2020,65,48,0,113
PULASKI,7/30/2020,65,48,0,113
PULASKI,7/31/2020,65,50,0,115
PULASKI,8/1/2020,67,50,0,117
PULASKI,8/2/2020,68,52,0,120
PULASKI,8/3/2020,68,54,0,122
PULASKI,8/4/2020,69,55,0,124
PULASKI,8/5/2020,71,55,0,126
PULASKI,8/6/2020,71,56,0,127
PULASKI,8/7/2020,93,60,0,153
PULASKI,8/8/2020,95,60,0,155
PULASKI,8/9/2020,95,60,0,155
PULASKI,8/10/2020,97,61,0,158
PULASKI,8/11/2020,99,62,0,161
PULASKI,8/12/2020,102,63,0,165
PULASKI,8/13/2020,106,64,0,170
PULASKI,8/14/2020,109,66,0,175
PULASKI,8/15/2020,112,68,0,180
PULASKI,8/16/2020,114,68,0,182
PULASKI,8/17/2020,117,68,0,185
PULASKI,8/18/2020,118,70,0,188
PULASKI,8/19/2020,120,73,0,193
PULASKI,8/20/2020,122,73,0,195
PULASKI,8/21/2020,124,73,0,197
PULASKI,8/22/2020,126,77,0,203
PULASKI,8/23/2020,127,83,0,210
PULASKI,8/24/2020,130,84,0,214
PULASKI,8/25/2020,136,89,0,225
PULASKI,8/26/2020,143,89,0,232
PULASKI,8/27/2020,149,89,0,238
PULASKI,8/28/2020,150,89,0,239
PULASKI,8/29/2020,151,91,0,242
PULASKI,8/30/2020,155,91,0,246
PULASKI,8/31/2020,163,91,0,254
PULASKI,9/1/2020,169,92,0,261
PULASKI,9/2/2020,172,92,0,264
PULASKI,9/3/2020,180,92,0,272
PULASKI,9/4/2020,185,95,1,281
PULASKI,9/5/2020,185,95,1,281
PULASKI,9/6/2020,185,95,1,281
PULASKI,9/7/2020,185,96,1,282
PULASKI,9/8/2020,186,97,1,284
PULASKI,9/9/2020,195,97,1,293
PULASKI,9/10/2020,197,97,1,295
PULASKI,9/11/2020,204,97,1,302
PULASKI,9/12/2020,204,98,1,303
PULASKI,9/13/2020,204,98,1,303
PULASKI,9/14/2020,205,98,1,304
PULASKI,9/15/2020,206,98,1,305
PULASKI,9/16/2020,207,98,1,306
PULASKI,9/17/2020,209,99,1,309
PULASKI,9/18/2020,209,99,1,309
PULASKI,9/19/2020,209,99,1,309
PULASKI,9/20/2020,209,100,1,310
PULASKI,9/21/2020,209,100,1,310
PULASKI,9/22/2020,209,100,1,310
PULASKI,9/23/2020,209,101,1,311
PULASKI,9/24/2020,209,101,1,311
PULASKI,9/25/2020,209,101,1,311
PULASKI,9/26/2020,209,102,1,312
PULASKI,9/27/2020,209,103,1,313
PULASKI,9/28/2020,209,103,1,313
PULASKI,9/29/2020,210,104,1,315
PULASKI,9/30/2020,211,105,1,317
PULASKI,10/1/2020,212,105,1,318
PULASKI,10/2/2020,214,105,1,320
PULASKI,10/3/2020,214,105,1,320
PULASKI,10/4/2020,214,106,1,321
PULASKI,10/5/2020,214,106,1,321
PULASKI,10/6/2020,214,106,1,321
PULASKI,10/7/2020,214,106,1,321
PULASKI,10/8/2020,215,107,1,323
PULASKI,10/9/2020,215,108,1,324
PULASKI,10/10/2020,216,108,1,325
PULASKI,10/11/2020,216,108,1,325
PULASKI,10/12/2020,216,108,1,325
PULASKI,10/13/2020,216,108,1,325
PULASKI,10/14/2020,217,108,1,326
PULASKI,10/15/2020,217,108,1,326
PULASKI,10/16/2020,217,108,1,326
PULASKI,10/17/2020,217,109,1,327
PULASKI,10/18/2020,217,109,1,327
PULASKI,10/19/2020,217,109,1,327
PULASKI,10/20/2020,217,109,1,327
RANDOLPH,1/1/2020,0,0,0,0
RANDOLPH,1/2/2020,0,0,0,0
RANDOLPH,1/3/2020,0,0,0,0
RANDOLPH,1/4/2020,0,0,0,0
RANDOLPH,1/5/2020,0,0,0,0
RANDOLPH,1/6/2020,0,0,0,0
RANDOLPH,1/7/2020,0,0,0,0
RANDOLPH,1/8/2020,0,0,0,0
RANDOLPH,1/9/2020,0,0,0,0
RANDOLPH,1/10/2020,0,0,0,0
RANDOLPH,1/11/2020,0,0,0,0
RANDOLPH,1/12/2020,0,0,0,0
RANDOLPH,1/13/2020,0,0,0,0
RANDOLPH,1/14/2020,0,0,0,0
RANDOLPH,1/15/2020,0,0,0,0
RANDOLPH,1/16/2020,0,0,0,0
RANDOLPH,1/17/2020,0,0,0,0
RANDOLPH,1/18/2020,0,0,0,0
RANDOLPH,1/19/2020,0,0,0,0
RANDOLPH,1/20/2020,0,0,0,0
RANDOLPH,1/21/2020,0,0,0,0
RANDOLPH,1/22/2020,0,0,0,0
RANDOLPH,1/23/2020,0,0,0,0
RANDOLPH,1/24/2020,0,0,0,0
RANDOLPH,1/25/2020,0,0,0,0
RANDOLPH,1/26/2020,0,0,0,0
RANDOLPH,1/27/2020,0,0,0,0
RANDOLPH,1/28/2020,0,0,0,0
RANDOLPH,1/29/2020,0,0,0,0
RANDOLPH,1/30/2020,0,0,0,0
RANDOLPH,1/31/2020,0,0,0,0
RANDOLPH,2/1/2020,0,0,0,0
RANDOLPH,2/2/2020,0,0,0,0
RANDOLPH,2/3/2020,0,0,0,0
RANDOLPH,2/4/2020,0,0,0,0
RANDOLPH,2/5/2020,0,0,0,0
RANDOLPH,2/6/2020,0,0,0,0
RANDOLPH,2/7/2020,0,0,0,0
RANDOLPH,2/8/2020,0,0,0,0
RANDOLPH,2/9/2020,0,0,0,0
RANDOLPH,2/10/2020,0,0,0,0
RANDOLPH,2/11/2020,0,0,0,0
RANDOLPH,2/12/2020,0,0,0,0
RANDOLPH,2/13/2020,0,0,0,0
RANDOLPH,2/14/2020,0,0,0,0
RANDOLPH,2/15/2020,0,0,0,0
RANDOLPH,2/16/2020,0,0,0,0
RANDOLPH,2/17/2020,0,0,0,0
RANDOLPH,2/18/2020,0,0,0,0
RANDOLPH,2/19/2020,0,0,0,0
RANDOLPH,2/20/2020,0,0,0,0
RANDOLPH,2/21/2020,0,0,0,0
RANDOLPH,2/22/2020,0,0,0,0
RANDOLPH,2/23/2020,0,0,0,0
RANDOLPH,2/24/2020,0,0,0,0
RANDOLPH,2/25/2020,0,0,0,0
RANDOLPH,2/26/2020,0,0,0,0
RANDOLPH,2/27/2020,0,0,0,0
RANDOLPH,2/28/2020,0,0,0,0
RANDOLPH,2/29/2020,0,0,0,0
RANDOLPH,3/1/2020,0,0,0,0
RANDOLPH,3/2/2020,0,0,0,0
RANDOLPH,3/3/2020,0,0,0,0
RANDOLPH,3/4/2020,0,0,0,0
RANDOLPH,3/5/2020,0,0,0,0
RANDOLPH,3/6/2020,0,0,0,0
RANDOLPH,3/7/2020,0,0,0,0
RANDOLPH,3/8/2020,0,0,0,0
RANDOLPH,3/9/2020,1,0,0,1
RANDOLPH,3/10/2020,2,0,0,2
RANDOLPH,3/11/2020,3,0,0,3
RANDOLPH,3/12/2020,3,0,0,3
RANDOLPH,3/13/2020,4,0,0,4
RANDOLPH,3/14/2020,4,0,0,4
RANDOLPH,3/15/2020,5,0,0,5
RANDOLPH,3/16/2020,6,0,0,6
RANDOLPH,3/17/2020,6,0,0,6
RANDOLPH,3/18/2020,6,0,0,6
RANDOLPH,3/19/2020,6,0,0,6
RANDOLPH,3/20/2020,7,1,0,8
RANDOLPH,3/21/2020,7,1,0,8
RANDOLPH,3/22/2020,7,3,0,10
RANDOLPH,3/23/2020,8,4,0,12
RANDOLPH,3/24/2020,9,5,0,14
RANDOLPH,3/25/2020,11,6,0,17
RANDOLPH,3/26/2020,16,7,0,23
RANDOLPH,3/27/2020,17,9,0,26
RANDOLPH,3/28/2020,18,11,0,29
RANDOLPH,3/29/2020,24,13,0,37
RANDOLPH,3/30/2020,27,13,0,40
RANDOLPH,3/31/2020,33,13,0,46
RANDOLPH,4/1/2020,36,16,0,52
RANDOLPH,4/2/2020,42,19,0,61
RANDOLPH,4/3/2020,74,36,0,110
RANDOLPH,4/4/2020,77,40,0,117
RANDOLPH,4/5/2020,79,41,0,120
RANDOLPH,4/6/2020,80,43,0,123
RANDOLPH,4/7/2020,81,45,0,126
RANDOLPH,4/8/2020,85,48,0,133
RANDOLPH,4/9/2020,87,53,0,140
RANDOLPH,4/10/2020,92,55,0,147
RANDOLPH,4/11/2020,93,56,0,149
RANDOLPH,4/12/2020,93,56,0,149
RANDOLPH,4/13/2020,93,56,0,149
RANDOLPH,4/14/2020,93,57,0,150
RANDOLPH,4/15/2020,95,57,0,152
RANDOLPH,4/16/2020,97,57,0,154
RANDOLPH,4/17/2020,98,58,0,156
RANDOLPH,4/18/2020,100,58,0,158
RANDOLPH,4/19/2020,100,58,0,158
RANDOLPH,4/20/2020,101,58,0,159
RANDOLPH,4/21/2020,101,60,0,161
RANDOLPH,4/22/2020,101,60,0,161
RANDOLPH,4/23/2020,102,60,0,162
RANDOLPH,4/24/2020,103,60,0,163
RANDOLPH,4/25/2020,103,61,0,164
RANDOLPH,4/26/2020,103,61,0,164
RANDOLPH,4/27/2020,103,61,0,164
RANDOLPH,4/28/2020,103,62,0,165
RANDOLPH,4/29/2020,103,63,0,166
RANDOLPH,4/30/2020,103,63,0,166
RANDOLPH,5/1/2020,104,63,0,167
RANDOLPH,5/2/2020,105,63,0,168
RANDOLPH,5/3/2020,105,64,0,169
RANDOLPH,5/4/2020,106,65,0,171
RANDOLPH,5/5/2020,106,65,0,171
RANDOLPH,5/6/2020,106,65,0,171
RANDOLPH,5/7/2020,106,65,0,171
RANDOLPH,5/8/2020,106,65,0,171
RANDOLPH,5/9/2020,106,66,0,172
RANDOLPH,5/10/2020,106,66,0,172
RANDOLPH,5/11/2020,106,66,0,172
RANDOLPH,5/12/2020,108,66,0,174
RANDOLPH,5/13/2020,108,66,0,174
RANDOLPH,5/14/2020,109,67,0,176
RANDOLPH,5/15/2020,109,67,0,176
RANDOLPH,5/16/2020,109,67,0,176
RANDOLPH,5/17/2020,109,67,0,176
RANDOLPH,5/18/2020,110,69,0,179
RANDOLPH,5/19/2020,111,69,0,180
RANDOLPH,5/20/2020,111,69,0,180
RANDOLPH,5/21/2020,111,69,0,180
RANDOLPH,5/22/2020,112,70,0,182
RANDOLPH,5/23/2020,112,70,0,182
RANDOLPH,5/24/2020,112,70,0,182
RANDOLPH,5/25/2020,112,70,0,182
RANDOLPH,5/26/2020,112,71,0,183
RANDOLPH,5/27/2020,113,73,0,186
RANDOLPH,5/28/2020,113,73,0,186
RANDOLPH,5/29/2020,113,73,0,186
RANDOLPH,5/30/2020,114,73,0,187
RANDOLPH,5/31/2020,114,73,0,187
RANDOLPH,6/1/2020,114,73,0,187
RANDOLPH,6/2/2020,115,74,0,189
RANDOLPH,6/3/2020,115,74,0,189
RANDOLPH,6/4/2020,115,74,0,189
RANDOLPH,6/5/2020,115,74,0,189
RANDOLPH,6/6/2020,117,74,0,191
RANDOLPH,6/7/2020,119,74,0,193
RANDOLPH,6/8/2020,119,74,0,193
RANDOLPH,6/9/2020,119,74,0,193
RANDOLPH,6/10/2020,120,74,0,194
RANDOLPH,6/11/2020,120,74,0,194
RANDOLPH,6/12/2020,120,74,0,194
RANDOLPH,6/13/2020,120,74,0,194
RANDOLPH,6/14/2020,120,74,0,194
RANDOLPH,6/15/2020,120,75,0,195
RANDOLPH,6/16/2020,121,76,0,197
RANDOLPH,6/17/2020,121,77,0,198
RANDOLPH,6/18/2020,121,77,0,198
RANDOLPH,6/19/2020,121,77,0,198
RANDOLPH,6/20/2020,121,77,0,198
RANDOLPH,6/21/2020,121,77,0,198
RANDOLPH,6/22/2020,122,78,0,200
RANDOLPH,6/23/2020,124,78,0,202
RANDOLPH,6/24/2020,124,78,0,202
RANDOLPH,6/25/2020,124,78,0,202
RANDOLPH,6/26/2020,124,79,0,203
RANDOLPH,6/27/2020,124,79,0,203
RANDOLPH,6/28/2020,124,79,1,204
RANDOLPH,6/29/2020,127,80,1,208
RANDOLPH,6/30/2020,129,80,1,210
RANDOLPH,7/1/2020,129,80,1,210
RANDOLPH,7/2/2020,131,80,1,212
RANDOLPH,7/3/2020,131,80,1,212
RANDOLPH,7/4/2020,132,80,1,213
RANDOLPH,7/5/2020,132,81,1,214
RANDOLPH,7/6/2020,132,81,1,214
RANDOLPH,7/7/2020,132,82,1,215
RANDOLPH,7/8/2020,135,82,1,218
RANDOLPH,7/9/2020,136,84,1,221
RANDOLPH,7/10/2020,137,84,1,222
RANDOLPH,7/11/2020,138,86,1,225
RANDOLPH,7/12/2020,140,88,1,229
RANDOLPH,7/13/2020,140,88,1,229
RANDOLPH,7/14/2020,140,88,1,229
RANDOLPH,7/15/2020,141,89,1,231
RANDOLPH,7/16/2020,142,90,1,233
RANDOLPH,7/17/2020,143,90,1,234
RANDOLPH,7/18/2020,144,91,1,236
RANDOLPH,7/19/2020,144,92,1,237
RANDOLPH,7/20/2020,146,93,1,240
RANDOLPH,7/21/2020,149,93,1,243
RANDOLPH,7/22/2020,152,95,1,248
RANDOLPH,7/23/2020,153,95,1,249
RANDOLPH,7/24/2020,156,97,1,254
RANDOLPH,7/25/2020,156,99,1,256
RANDOLPH,7/26/2020,158,100,1,259
RANDOLPH,7/27/2020,159,101,1,261
RANDOLPH,7/28/2020,161,103,1,265
RANDOLPH,7/29/2020,162,104,1,267
RANDOLPH,7/30/2020,162,104,1,267
RANDOLPH,7/31/2020,164,107,1,272
RANDOLPH,8/1/2020,166,107,1,274
RANDOLPH,8/2/2020,167,108,1,276
RANDOLPH,8/3/2020,170,111,1,282
RANDOLPH,8/4/2020,171,112,1,284
RANDOLPH,8/5/2020,172,112,1,285
RANDOLPH,8/6/2020,174,113,1,288
RANDOLPH,8/7/2020,176,113,1,290
RANDOLPH,8/8/2020,176,116,1,293
RANDOLPH,8/9/2020,177,116,1,294
RANDOLPH,8/10/2020,177,118,1,296
RANDOLPH,8/11/2020,177,118,1,296
RANDOLPH,8/12/2020,181,119,1,301
RANDOLPH,8/13/2020,181,120,1,302
RANDOLPH,8/14/2020,181,121,1,303
RANDOLPH,8/15/2020,185,121,1,307
RANDOLPH,8/16/2020,186,121,1,308
RANDOLPH,8/17/2020,188,122,1,311
RANDOLPH,8/18/2020,189,122,1,312
RANDOLPH,8/19/2020,189,122,1,312
RANDOLPH,8/20/2020,190,122,1,313
RANDOLPH,8/21/2020,190,122,1,313
RANDOLPH,8/22/2020,190,123,1,314
RANDOLPH,8/23/2020,191,124,1,316
RANDOLPH,8/24/2020,191,124,1,316
RANDOLPH,8/25/2020,191,124,1,316
RANDOLPH,8/26/2020,192,125,1,318
RANDOLPH,8/27/2020,192,126,1,319
RANDOLPH,8/28/2020,193,127,1,321
RANDOLPH,8/29/2020,193,127,1,321
RANDOLPH,8/30/2020,193,127,1,321
RANDOLPH,8/31/2020,194,127,1,322
RANDOLPH,9/1/2020,195,127,1,323
RANDOLPH,9/2/2020,195,128,1,324
RANDOLPH,9/3/2020,195,128,1,324
RANDOLPH,9/4/2020,196,131,1,328
RANDOLPH,9/5/2020,196,132,1,329
RANDOLPH,9/6/2020,196,133,1,330
RANDOLPH,9/7/2020,196,133,1,330
RANDOLPH,9/8/2020,196,134,1,331
RANDOLPH,9/9/2020,196,134,1,331
RANDOLPH,9/10/2020,196,134,1,331
RANDOLPH,9/11/2020,196,135,1,332
RANDOLPH,9/12/2020,196,136,1,333
RANDOLPH,9/13/2020,197,136,1,334
RANDOLPH,9/14/2020,197,136,1,334
RANDOLPH,9/15/2020,197,136,1,334
RANDOLPH,9/16/2020,197,136,1,334
RANDOLPH,9/17/2020,197,136,1,334
RANDOLPH,9/18/2020,197,136,1,334
RANDOLPH,9/19/2020,197,136,1,334
RANDOLPH,9/20/2020,197,136,1,334
RANDOLPH,9/21/2020,197,136,1,334
RANDOLPH,9/22/2020,197,136,1,334
RANDOLPH,9/23/2020,197,136,1,334
RANDOLPH,9/24/2020,197,136,1,334
RANDOLPH,9/25/2020,197,136,1,334
RANDOLPH,9/26/2020,197,136,1,334
RANDOLPH,9/27/2020,197,137,1,335
RANDOLPH,9/28/2020,197,137,1,335
RANDOLPH,9/29/2020,197,137,1,335
RANDOLPH,9/30/2020,197,137,1,335
RANDOLPH,10/1/2020,197,137,1,335
RANDOLPH,10/2/2020,197,137,1,335
RANDOLPH,10/3/2020,197,137,1,335
RANDOLPH,10/4/2020,198,137,1,336
RANDOLPH,10/5/2020,198,137,1,336
RANDOLPH,10/6/2020,198,137,1,336
RANDOLPH,10/7/2020,198,137,1,336
RANDOLPH,10/8/2020,199,137,1,337
RANDOLPH,10/9/2020,199,138,1,338
RANDOLPH,10/10/2020,199,138,1,338
RANDOLPH,10/11/2020,199,138,1,338
RANDOLPH,10/12/2020,199,138,1,338
RANDOLPH,10/13/2020,199,138,1,338
RANDOLPH,10/14/2020,199,138,1,338
RANDOLPH,10/15/2020,199,138,1,338
RANDOLPH,10/16/2020,199,138,1,338
RANDOLPH,10/17/2020,199,138,1,338
RANDOLPH,10/18/2020,199,138,1,338
RANDOLPH,10/19/2020,199,138,1,338
RANDOLPH,10/20/2020,199,138,1,338
WHITE,1/1/2020,0,0,0,0
WHITE,1/2/2020,0,0,0,0
WHITE,1/3/2020,0,0,0,0
WHITE,1/4/2020,0,0,0,0
WHITE,1/5/2020,0,0,0,0
WHITE,1/6/2020,0,0,0,0
WHITE,1/7/2020,0,0,0,0
WHITE,1/8/2020,0,0,0,0
WHITE,1/9/2020,0,0,0,0
WHITE,1/10/2020,0,0,0,0
WHITE,1/11/2020,0,0,0,0
WHITE,1/12/2020,0,0,0,0
WHITE,1/13/2020,0,0,0,0
WHITE,1/14/2020,0,0,0,0
WHITE,1/15/2020,0,0,0,0
WHITE,1/16/2020,0,0,0,0
WHITE,1/17/2020,0,0,0,0
WHITE,1/18/2020,0,0,0,0
WHITE,1/19/2020,0,0,0,0
WHITE,1/20/2020,0,0,0,0
WHITE,1/21/2020,0,0,0,0
WHITE,1/22/2020,0,0,0,0
WHITE,1/23/2020,0,0,0,0
WHITE,1/24/2020,0,0,0,0
WHITE,1/25/2020,0,0,0,0
WHITE,1/26/2020,0,0,0,0
WHITE,1/27/2020,0,0,0,0
WHITE,1/28/2020,0,0,0,0
WHITE,1/29/2020,0,0,0,0
WHITE,1/30/2020,0,0,0,0
WHITE,1/31/2020,0,0,0,0
WHITE,2/1/2020,0,0,0,0
WHITE,2/2/2020,0,0,0,0
WHITE,2/3/2020,0,0,0,0
WHITE,2/4/2020,0,0,0,0
WHITE,2/5/2020,0,0,0,0
WHITE,2/6/2020,0,0,0,0
WHITE,2/7/2020,0,0,0,0
WHITE,2/8/2020,0,0,0,0
WHITE,2/9/2020,0,0,0,0
WHITE,2/10/2020,0,0,0,0
WHITE,2/11/2020,0,0,0,0
WHITE,2/12/2020,0,0,0,0
WHITE,2/13/2020,0,0,0,0
WHITE,2/14/2020,0,0,0,0
WHITE,2/15/2020,0,0,0,0
WHITE,2/16/2020,0,0,0,0
WHITE,2/17/2020,0,0,0,0
WHITE,2/18/2020,0,0,0,0
WHITE,2/19/2020,0,0,0,0
WHITE,2/20/2020,0,0,0,0
WHITE,2/21/2020,0,0,0,0
WHITE,2/22/2020,0,0,0,0
WHITE,2/23/2020,0,0,0,0
WHITE,2/24/2020,0,0,0,0
WHITE,2/25/2020,0,0,0,0
WHITE,2/26/2020,0,0,0,0
WHITE,2/27/2020,0,0,0,0
WHITE,2/28/2020,0,0,0,0
WHITE,2/29/2020,0,0,0,0
WHITE,3/1/2020,0,0,0,0
WHITE,3/2/2020,0,0,0,0
WHITE,3/3/2020,0,0,0,0
WHITE,3/4/2020,0,0,0,0
WHITE,3/5/2020,0,0,0,0
WHITE,3/6/2020,0,0,0,0
WHITE,3/7/2020,0,0,0,0
WHITE,3/8/2020,0,0,0,0
WHITE,3/9/2020,0,0,0,0
WHITE,3/10/2020,0,0,0,0
WHITE,3/11/2020,0,0,0,0
WHITE,3/12/2020,0,0,0,0
WHITE,3/13/2020,0,0,0,0
WHITE,3/14/2020,0,0,0,0
WHITE,3/15/2020,1,0,0,1
WHITE,3/16/2020,1,0,0,1
WHITE,3/17/2020,1,0,0,1
WHITE,3/18/2020,1,0,0,1
WHITE,3/19/2020,1,1,0,2
WHITE,3/20/2020,2,1,0,3
WHITE,3/21/2020,2,1,0,3
WHITE,3/22/2020,3,1,0,4
WHITE,3/23/2020,3,2,0,5
WHITE,3/24/2020,3,2,0,5
WHITE,3/25/2020,3,2,0,5
WHITE,3/26/2020,3,2,0,5
WHITE,3/27/2020,3,2,0,5
WHITE,3/28/2020,4,2,0,6
WHITE,3/29/2020,4,2,0,6
WHITE,3/30/2020,4,3,0,7
WHITE,3/31/2020,5,3,0,8
WHITE,4/1/2020,6,4,0,10
WHITE,4/2/2020,11,6,0,17
WHITE,4/3/2020,12,6,0,18
WHITE,4/4/2020,15,6,0,21
WHITE,4/5/2020,15,7,0,22
WHITE,4/6/2020,15,9,0,24
WHITE,4/7/2020,17,9,0,26
WHITE,4/8/2020,17,9,0,26
WHITE,4/9/2020,19,11,0,30
WHITE,4/10/2020,21,12,0,33
WHITE,4/11/2020,21,13,0,34
WHITE,4/12/2020,21,13,0,34
WHITE,4/13/2020,24,14,0,38
WHITE,4/14/2020,26,15,0,41
WHITE,4/15/2020,26,15,0,41
WHITE,4/16/2020,27,17,0,44
WHITE,4/17/2020,31,18,0,49
WHITE,4/18/2020,33,19,0,52
WHITE,4/19/2020,35,21,0,56
WHITE,4/20/2020,36,22,0,58
WHITE,4/21/2020,39,23,0,62
WHITE,4/22/2020,40,27,0,67
WHITE,4/23/2020,40,30,0,70
WHITE,4/24/2020,41,33,0,74
WHITE,4/25/2020,42,35,0,77
WHITE,4/26/2020,42,37,0,79
WHITE,4/27/2020,43,37,0,80
WHITE,4/28/2020,43,37,0,80
WHITE,4/29/2020,43,37,0,80
WHITE,4/30/2020,43,39,0,82
WHITE,5/1/2020,44,41,0,85
WHITE,5/2/2020,45,41,0,86
WHITE,5/3/2020,45,42,0,87
WHITE,5/4/2020,45,42,0,87
WHITE,5/5/2020,46,42,0,88
WHITE,5/6/2020,46,42,0,88
WHITE,5/7/2020,46,43,0,89
WHITE,5/8/2020,46,43,0,89
WHITE,5/9/2020,47,43,0,90
WHITE,5/10/2020,47,43,0,90
WHITE,5/11/2020,47,43,0,90
WHITE,5/12/2020,47,43,0,90
WHITE,5/13/2020,48,44,0,92
WHITE,5/14/2020,48,44,0,92
WHITE,5/15/2020,49,44,0,93
WHITE,5/16/2020,49,45,0,94
WHITE,5/17/2020,50,48,0,98
WHITE,5/18/2020,50,48,0,98
WHITE,5/19/2020,50,48,0,98
WHITE,5/20/2020,51,49,0,100
WHITE,5/21/2020,51,49,0,100
WHITE,5/22/2020,53,49,0,102
WHITE,5/23/2020,55,49,0,104
WHITE,5/24/2020,55,49,0,104
WHITE,5/25/2020,55,50,0,105
WHITE,5/26/2020,56,50,0,106
WHITE,5/27/2020,56,51,0,107
WHITE,5/28/2020,56,52,0,108
WHITE,5/29/2020,57,52,0,109
WHITE,5/30/2020,57,54,0,111
WHITE,5/31/2020,58,54,0,112
WHITE,6/1/2020,58,55,0,113
WHITE,6/2/2020,58,56,0,114
WHITE,6/3/2020,59,57,0,116
WHITE,6/4/2020,61,59,0,120
WHITE,6/5/2020,63,60,0,123
WHITE,6/6/2020,64,60,0,124
WHITE,6/7/2020,64,60,0,124
WHITE,6/8/2020,64,61,0,125
WHITE,6/9/2020,64,62,0,126
WHITE,6/10/2020,65,63,0,128
WHITE,6/11/2020,65,64,0,129
WHITE,6/12/2020,65,64,0,129
WHITE,6/13/2020,66,65,0,131
WHITE,6/14/2020,66,65,0,131
WHITE,6/15/2020,68,66,0,134
WHITE,6/16/2020,70,68,0,138
WHITE,6/17/2020,71,70,0,141
WHITE,6/18/2020,71,70,0,141
WHITE,6/19/2020,71,72,0,143
WHITE,6/20/2020,72,75,0,147
WHITE,6/21/2020,72,75,0,147
WHITE,6/22/2020,73,77,0,150
WHITE,6/23/2020,74,77,0,151
WHITE,6/24/2020,76,78,0,154
WHITE,6/25/2020,77,79,0,156
WHITE,6/26/2020,77,81,0,158
WHITE,6/27/2020,77,82,0,159
WHITE,6/28/2020,79,82,0,161
WHITE,6/29/2020,80,83,0,163
WHITE,6/30/2020,82,84,0,166
WHITE,7/1/2020,84,86,0,170
WHITE,7/2/2020,88,86,0,174
WHITE,7/3/2020,91,89,0,180
WHITE,7/4/2020,94,92,0,186
WHITE,7/5/2020,97,94,0,191
WHITE,7/6/2020,104,97,0,201
WHITE,7/7/2020,109,98,1,208
WHITE,7/8/2020,119,100,2,221
WHITE,7/9/2020,131,107,3,241
WHITE,7/10/2020,133,113,3,249
WHITE,7/11/2020,135,115,4,254
WHITE,7/12/2020,139,122,5,266
WHITE,7/13/2020,145,126,5,276
WHITE,7/14/2020,151,134,5,290
WHITE,7/15/2020,160,143,7,310
WHITE,7/16/2020,163,148,8,319
WHITE,7/17/2020,167,148,8,323
WHITE,7/18/2020,169,152,10,331
WHITE,7/19/2020,170,154,10,334
WHITE,7/20/2020,181,159,11,351
WHITE,7/21/2020,187,164,13,364
WHITE,7/22/2020,195,168,14,377
WHITE,7/23/2020,197,173,16,386
WHITE,7/24/2020,204,177,16,397
WHITE,7/25/2020,207,182,16,405
WHITE,7/26/2020,211,184,16,411
WHITE,7/27/2020,218,190,16,424
WHITE,7/28/2020,224,194,17,435
WHITE,7/29/2020,229,198,18,445
WHITE,7/30/2020,234,202,19,455
WHITE,7/31/2020,254,208,19,481
WHITE,8/1/2020,259,214,19,492
WHITE,8/2/2020,264,218,19,501
WHITE,8/3/2020,270,225,19,514
WHITE,8/4/2020,275,233,19,527
WHITE,8/5/2020,277,235,19,531
WHITE,8/6/2020,279,238,19,536
WHITE,8/7/2020,289,244,19,552
WHITE,8/8/2020,292,246,19,557
WHITE,8/9/2020,294,252,19,565
WHITE,8/10/2020,295,253,20,568
WHITE,8/11/2020,302,257,21,580
WHITE,8/12/2020,305,258,21,584
WHITE,8/13/2020,311,264,21,596
WHITE,8/14/2020,315,266,21,602
WHITE,8/15/2020,321,275,21,617
WHITE,8/16/2020,324,276,21,621
WHITE,8/17/2020,329,280,21,630
WHITE,8/18/2020,331,285,21,637
WHITE,8/19/2020,332,287,21,640
WHITE,8/20/2020,334,294,21,649
WHITE,8/21/2020,335,297,21,653
WHITE,8/22/2020,340,301,21,662
WHITE,8/23/2020,345,306,21,672
WHITE,8/24/2020,353,311,21,685
WHITE,8/25/2020,359,311,21,691
WHITE,8/26/2020,363,316,21,700
WHITE,8/27/2020,366,319,21,706
WHITE,8/28/2020,368,325,21,714
WHITE,8/29/2020,370,326,21,717
WHITE,8/30/2020,373,329,21,723
WHITE,8/31/2020,378,333,21,732
WHITE,9/1/2020,380,339,21,740
WHITE,9/2/2020,386,347,21,754
WHITE,9/3/2020,391,352,21,764
WHITE,9/4/2020,397,354,21,772
WHITE,9/5/2020,401,355,21,777
WHITE,9/6/2020,402,359,21,782
WHITE,9/7/2020,405,362,21,788
WHITE,9/8/2020,409,367,21,797
WHITE,9/9/2020,414,370,21,805
WHITE,9/10/2020,416,371,21,808
WHITE,9/11/2020,419,375,21,815
WHITE,9/12/2020,426,375,21,822
WHITE,9/13/2020,428,377,21,826
WHITE,9/14/2020,430,378,21,829
WHITE,9/15/2020,435,381,21,837
WHITE,9/16/2020,440,383,21,844
WHITE,9/17/2020,444,384,21,849
WHITE,9/18/2020,447,390,21,858
WHITE,9/19/2020,449,393,21,863
WHITE,9/20/2020,451,397,21,869
WHITE,9/21/2020,457,402,21,880
WHITE,9/22/2020,457,404,21,882
WHITE,9/23/2020,464,406,21,891
WHITE,9/24/2020,466,407,21,894
WHITE,9/25/2020,471,411,21,903
WHITE,9/26/2020,473,413,21,907
WHITE,9/27/2020,474,416,21,911
WHITE,9/28/2020,478,419,21,918
WHITE,9/29/2020,482,421,21,924
WHITE,9/30/2020,486,423,21,930
WHITE,10/1/2020,489,427,21,937
WHITE,10/2/2020,494,428,21,943
WHITE,10/3/2020,498,432,21,951
WHITE,10/4/2020,502,433,21,956
WHITE,10/5/2020,504,435,21,960
WHITE,10/6/2020,506,436,21,963
WHITE,10/7/2020,508,436,21,965
WHITE,10/8/2020,509,437,22,968
WHITE,10/9/2020,511,439,22,972
WHITE,10/10/2020,511,440,22,973
WHITE,10/11/2020,512,440,22,974
WHITE,10/12/2020,513,442,22,977
WHITE,10/13/2020,516,444,22,982
WHITE,10/14/2020,517,444,22,983
WHITE,10/15/2020,519,444,22,985
WHITE,10/16/2020,521,445,22,988
WHITE,10/17/2020,521,445,22,988
WHITE,10/18/2020,521,445,22,988
WHITE,10/19/2020,521,445,22,988
WHITE,10/20/2020,521,445,22,988
ELBERT,1/1/2020,0,0,0,0
ELBERT,1/2/2020,0,0,0,0
ELBERT,1/3/2020,0,0,0,0
ELBERT,1/4/2020,0,0,0,0
ELBERT,1/5/2020,0,0,0,0
ELBERT,1/6/2020,0,0,0,0
ELBERT,1/7/2020,0,0,0,0
ELBERT,1/8/2020,0,0,0,0
ELBERT,1/9/2020,0,0,0,0
ELBERT,1/10/2020,0,0,0,0
ELBERT,1/11/2020,0,0,0,0
ELBERT,1/12/2020,0,0,0,0
ELBERT,1/13/2020,0,0,0,0
ELBERT,1/14/2020,0,0,0,0
ATKINSON,5/24/2020,30,22,0,52
ATKINSON,5/25/2020,32,24,0,56
WALTON,8/14/2020,827,555,15,1397
ATKINSON,5/26/2020,33,25,0,58
ATKINSON,5/27/2020,37,26,0,63
ATKINSON,5/28/2020,38,27,0,65
ATKINSON,5/29/2020,38,28,0,66
ATKINSON,5/30/2020,38,29,0,67
ATKINSON,5/31/2020,38,29,0,67
ATKINSON,6/1/2020,40,30,0,70
ATKINSON,6/2/2020,41,30,0,71
ATKINSON,6/3/2020,41,30,0,71
ATKINSON,6/4/2020,41,31,0,72
ATKINSON,6/5/2020,42,31,0,73
ATKINSON,6/6/2020,44,31,0,75
ATKINSON,6/7/2020,45,32,0,77
ATKINSON,6/8/2020,48,32,0,80
ATKINSON,6/9/2020,49,34,0,83
ATKINSON,6/10/2020,51,37,0,88
ATKINSON,6/11/2020,53,38,0,91
ATKINSON,6/12/2020,54,41,0,95
ATKINSON,6/13/2020,58,43,0,101
ATKINSON,6/14/2020,60,43,0,103
ATKINSON,6/15/2020,63,47,0,110
ATKINSON,6/16/2020,65,47,0,112
ATKINSON,6/17/2020,73,52,0,125
ATKINSON,6/18/2020,73,54,0,127
ATKINSON,6/19/2020,74,56,0,130
ATKINSON,6/20/2020,77,59,0,136
ATKINSON,6/21/2020,80,61,0,141
ATKINSON,6/22/2020,84,67,0,151
ATKINSON,6/23/2020,88,72,0,160
ATKINSON,6/24/2020,93,74,0,167
ATKINSON,6/25/2020,97,75,0,172
ATKINSON,6/26/2020,100,75,0,175
ATKINSON,6/27/2020,102,78,0,180
ATKINSON,6/28/2020,103,80,0,183
ATKINSON,6/29/2020,107,85,0,192
ATKINSON,6/30/2020,111,90,0,201
ATKINSON,7/1/2020,115,96,0,211
ATKINSON,7/2/2020,115,97,1,213
ATKINSON,7/3/2020,117,99,1,217
ATKINSON,7/4/2020,117,100,1,218
ATKINSON,7/5/2020,119,103,1,223
ATKINSON,7/6/2020,123,108,1,232
ATKINSON,7/7/2020,126,110,1,237
ATKINSON,7/8/2020,132,114,1,247
ATKINSON,7/9/2020,137,119,1,257
ATKINSON,7/10/2020,140,123,1,264
ATKINSON,7/11/2020,142,124,1,267
ATKINSON,7/12/2020,143,124,1,268
ATKINSON,7/13/2020,143,125,1,269
ATKINSON,7/14/2020,143,125,1,269
ATKINSON,7/15/2020,145,131,1,277
ATKINSON,7/16/2020,149,134,1,284
ATKINSON,7/17/2020,150,138,1,289
ATKINSON,7/18/2020,151,138,1,290
ATKINSON,7/19/2020,154,139,1,294
ATKINSON,7/20/2020,157,142,1,300
ATKINSON,7/21/2020,157,143,1,301
ATKINSON,7/22/2020,160,145,1,306
ATKINSON,7/23/2020,163,146,1,310
ATKINSON,7/24/2020,163,147,1,311
ATKINSON,7/25/2020,166,148,1,315
ATKINSON,7/26/2020,166,148,1,315
ATKINSON,7/27/2020,167,149,1,317
ATKINSON,7/28/2020,169,153,1,323
ATKINSON,7/29/2020,170,154,1,325
ATKINSON,7/30/2020,171,154,1,326
ATKINSON,7/31/2020,172,158,1,331
ATKINSON,8/1/2020,172,159,1,332
ATKINSON,8/2/2020,172,161,1,334
ATKINSON,8/3/2020,175,162,1,338
ATKINSON,8/4/2020,177,163,1,341
ATKINSON,8/5/2020,179,167,1,347
ATKINSON,8/6/2020,182,170,1,353
ATKINSON,8/7/2020,185,174,1,360
ATKINSON,8/8/2020,190,175,1,366
ATKINSON,8/9/2020,194,177,1,372
ATKINSON,8/10/2020,199,179,1,379
ATKINSON,8/11/2020,201,180,1,382
ATKINSON,8/12/2020,201,181,1,383
ATKINSON,8/13/2020,203,182,1,386
ATKINSON,8/14/2020,203,185,1,389
ATKINSON,8/15/2020,205,185,1,391
ATKINSON,8/16/2020,208,185,1,394
ATKINSON,8/17/2020,209,185,1,395
ATKINSON,8/18/2020,210,186,1,397
ATKINSON,8/19/2020,210,187,1,398
ATKINSON,8/20/2020,212,192,1,405
ATKINSON,8/21/2020,214,193,1,408
ATKINSON,8/22/2020,215,193,1,409
ATKINSON,8/23/2020,216,193,1,410
ATKINSON,8/24/2020,216,193,1,410
ATKINSON,8/25/2020,216,193,1,410
ATKINSON,8/26/2020,218,194,1,413
ATKINSON,8/27/2020,218,195,1,414
ATKINSON,8/28/2020,218,196,1,415
ATKINSON,8/29/2020,219,197,1,417
ATKINSON,8/30/2020,219,197,1,417
ATKINSON,8/31/2020,221,197,1,419
ATKINSON,9/1/2020,221,197,1,419
ATKINSON,9/2/2020,221,197,1,419
ATKINSON,9/3/2020,221,197,1,419
ATKINSON,9/4/2020,222,198,1,421
ATKINSON,9/5/2020,228,199,1,428
ATKINSON,9/6/2020,228,200,1,429
ATKINSON,9/7/2020,229,200,1,430
ATKINSON,9/8/2020,232,203,1,436
ATKINSON,9/9/2020,232,204,1,437
ATKINSON,9/10/2020,232,204,1,437
ATKINSON,9/11/2020,232,204,1,437
ATKINSON,9/12/2020,232,205,1,438
ATKINSON,9/13/2020,232,205,1,438
ATKINSON,9/14/2020,232,206,1,439
ATKINSON,9/15/2020,232,206,1,439
ATKINSON,9/16/2020,234,209,1,444
ATKINSON,9/17/2020,234,210,1,445
ATKINSON,9/18/2020,234,210,1,445
ATKINSON,9/19/2020,235,211,1,447
ATKINSON,9/20/2020,235,211,1,447
ATKINSON,9/21/2020,236,211,1,448
ATKINSON,9/22/2020,236,211,1,448
ATKINSON,9/23/2020,236,211,1,448
ATKINSON,9/24/2020,237,211,1,449
ATKINSON,9/25/2020,237,212,1,450
ATKINSON,9/26/2020,237,212,1,450
ATKINSON,9/27/2020,237,212,1,450
ATKINSON,9/28/2020,238,212,1,451
ATKINSON,9/29/2020,238,215,1,454
ATKINSON,9/30/2020,239,217,1,457
ATKINSON,10/1/2020,240,217,1,458
ATKINSON,10/2/2020,240,217,1,458
ATKINSON,10/3/2020,241,217,1,459
ATKINSON,10/4/2020,242,217,1,460
ATKINSON,10/5/2020,243,217,1,461
ATKINSON,10/6/2020,245,221,1,467
ATKINSON,10/7/2020,245,221,1,467
ATKINSON,10/8/2020,246,221,1,468
ATKINSON,10/9/2020,246,222,1,469
ATKINSON,10/10/2020,246,223,1,470
ATKINSON,10/11/2020,246,223,1,470
ATKINSON,10/12/2020,247,224,1,472
ATKINSON,10/13/2020,248,224,1,473
ATKINSON,10/14/2020,248,224,1,473
ATKINSON,10/15/2020,248,224,1,473
ATKINSON,10/16/2020,248,224,1,473
ATKINSON,10/17/2020,248,224,1,473
ATKINSON,10/18/2020,249,224,1,474
ATKINSON,10/19/2020,249,224,1,474
ATKINSON,10/20/2020,249,224,1,474
BACON,1/1/2020,0,0,0,0
BACON,1/2/2020,0,0,0,0
BACON,1/3/2020,0,0,0,0
BACON,1/4/2020,0,0,0,0
BACON,1/5/2020,0,0,0,0
BACON,1/6/2020,0,0,0,0
BACON,1/7/2020,0,0,0,0
BACON,1/8/2020,0,0,0,0
BACON,1/9/2020,0,0,0,0
BACON,1/10/2020,0,0,0,0
BACON,1/11/2020,0,0,0,0
BACON,1/12/2020,0,0,0,0
BACON,1/13/2020,0,0,0,0
BACON,1/14/2020,0,0,0,0
BACON,1/15/2020,0,0,0,0
BACON,1/16/2020,0,0,0,0
BACON,1/17/2020,0,0,0,0
BACON,1/18/2020,0,0,0,0
BACON,1/19/2020,0,0,0,0
BACON,1/20/2020,0,0,0,0
BACON,1/21/2020,0,0,0,0
BACON,1/22/2020,0,0,0,0
BACON,1/23/2020,0,0,0,0
BACON,1/24/2020,0,0,0,0
BACON,1/25/2020,0,0,0,0
BACON,1/26/2020,0,0,0,0
BACON,1/27/2020,0,0,0,0
BACON,1/28/2020,0,0,0,0
BACON,1/29/2020,0,0,0,0
BACON,1/30/2020,0,0,0,0
BACON,1/31/2020,0,0,0,0
BACON,2/1/2020,0,0,0,0
BACON,2/2/2020,0,0,0,0
BACON,2/3/2020,0,0,0,0
BACON,2/4/2020,0,0,0,0
BACON,2/5/2020,0,0,0,0
BACON,2/6/2020,0,0,0,0
BACON,2/7/2020,0,0,0,0
BACON,2/8/2020,0,0,0,0
BACON,2/9/2020,0,0,0,0
BACON,2/10/2020,0,0,0,0
BACON,2/11/2020,0,0,0,0
BACON,2/12/2020,0,0,0,0
BACON,2/13/2020,0,0,0,0
BACON,2/14/2020,0,0,0,0
BACON,2/15/2020,0,0,0,0
BACON,2/16/2020,0,0,0,0
BACON,2/17/2020,0,0,0,0
BACON,2/18/2020,0,0,0,0
BACON,2/19/2020,0,0,0,0
BACON,2/20/2020,0,0,0,0
BACON,2/21/2020,0,0,0,0
BACON,2/22/2020,0,0,0,0
BACON,2/23/2020,0,0,0,0
BACON,2/24/2020,0,0,0,0
BACON,2/25/2020,0,0,0,0
BACON,2/26/2020,0,0,0,0
BACON,2/27/2020,0,0,0,0
BACON,2/28/2020,0,0,0,0
BACON,2/29/2020,0,0,0,0
BACON,3/1/2020,0,0,0,0
BACON,3/2/2020,0,0,0,0
BACON,3/3/2020,1,0,0,1
BACON,3/4/2020,1,0,0,1
BACON,3/5/2020,1,0,0,1
BACON,3/6/2020,1,0,0,1
BACON,3/7/2020,1,0,0,1
BACON,3/8/2020,1,0,0,1
BACON,3/9/2020,1,0,0,1
BACON,3/10/2020,1,0,0,1
BACON,3/11/2020,1,0,0,1
BACON,3/12/2020,1,0,0,1
BACON,3/13/2020,1,0,0,1
BACON,3/14/2020,1,1,0,2
BACON,3/15/2020,1,1,0,2
BACON,3/16/2020,1,1,0,2
BACON,3/17/2020,1,1,0,2
BACON,3/18/2020,1,1,0,2
BACON,3/19/2020,1,1,0,2
BACON,3/20/2020,1,2,0,3
BACON,3/21/2020,1,2,0,3
BACON,3/22/2020,1,2,0,3
BACON,3/23/2020,1,3,0,4
BACON,3/24/2020,1,3,0,4
BACON,3/25/2020,2,4,0,6
BACON,3/26/2020,2,4,0,6
BACON,3/27/2020,3,4,0,7
BACON,3/28/2020,4,4,0,8
BACON,3/29/2020,4,4,0,8
BACON,3/30/2020,4,4,0,8
BACON,3/31/2020,4,4,0,8
BACON,4/1/2020,4,4,0,8
BACON,4/2/2020,6,4,0,10
BACON,4/3/2020,7,4,0,11
BACON,4/4/2020,7,4,0,11
BACON,4/5/2020,7,4,0,11
BACON,4/6/2020,8,4,0,12
BACON,4/7/2020,8,4,0,12
BACON,4/8/2020,8,4,0,12
BACON,4/9/2020,9,5,0,14
BACON,4/10/2020,10,5,0,15
BACON,4/11/2020,10,5,0,15
BACON,4/12/2020,10,5,0,15
BACON,4/13/2020,10,5,0,15
BACON,4/14/2020,11,6,0,17
BACON,4/15/2020,11,6,0,17
BACON,4/16/2020,11,7,0,18
BACON,4/17/2020,11,7,0,18
BACON,4/18/2020,12,7,0,19
BACON,4/19/2020,13,7,0,20
BACON,4/20/2020,13,8,0,21
BACON,4/21/2020,13,8,0,21
BACON,4/22/2020,14,8,0,22
BACON,4/23/2020,15,8,0,23
BACON,4/24/2020,16,8,0,24
BACON,4/25/2020,16,8,0,24
BACON,4/26/2020,17,8,0,25
BACON,4/27/2020,19,9,0,28
BACON,4/28/2020,19,9,0,28
BACON,4/29/2020,22,11,0,33
BACON,4/30/2020,23,12,0,35
BACON,5/1/2020,23,12,0,35
BACON,5/2/2020,23,12,0,35
BACON,5/3/2020,25,13,0,38
BACON,5/4/2020,26,15,0,41
BACON,5/5/2020,30,15,0,45
BACON,5/6/2020,31,17,1,49
BACON,5/7/2020,31,19,1,51
BACON,5/8/2020,31,23,1,55
BACON,5/9/2020,31,25,1,57
BACON,5/10/2020,33,26,1,60
BACON,5/11/2020,34,53,1,88
BACON,5/12/2020,34,56,1,91
BACON,5/13/2020,35,57,1,93
BACON,5/14/2020,36,57,1,94
BACON,5/15/2020,38,58,1,97
BACON,5/16/2020,39,58,1,98
BACON,5/17/2020,41,58,1,100
BACON,5/18/2020,42,59,1,102
BACON,5/19/2020,44,61,1,106
BACON,5/20/2020,46,62,1,109
BACON,5/21/2020,46,64,1,111
BACON,5/22/2020,47,64,1,112
BACON,5/23/2020,49,65,1,115
BACON,5/24/2020,50,68,1,119
BACON,5/25/2020,53,69,1,123
BACON,5/26/2020,55,70,1,126
BACON,5/27/2020,57,71,1,129
BACON,5/28/2020,58,74,1,133
BACON,5/29/2020,59,77,1,137
BACON,5/30/2020,62,77,1,140
BACON,5/31/2020,62,77,1,140
BACON,6/1/2020,64,82,1,147
BACON,6/2/2020,67,86,1,154
BACON,6/3/2020,70,87,1,158
BACON,6/4/2020,72,89,2,163
BACON,6/5/2020,73,92,2,167
BACON,6/6/2020,76,95,2,173
BACON,6/7/2020,77,96,2,175
BACON,6/8/2020,80,99,2,181
BACON,6/9/2020,85,100,2,187
BACON,6/10/2020,85,101,2,188
BACON,6/11/2020,86,101,2,189
BACON,6/12/2020,87,105,2,194
BACON,6/13/2020,87,107,2,196
BACON,6/14/2020,88,108,2,198
BACON,6/15/2020,92,110,2,204
BACON,6/16/2020,95,113,2,210
BACON,6/17/2020,98,114,2,214
BACON,6/18/2020,106,117,2,225
BACON,6/19/2020,111,123,2,236
BACON,6/20/2020,111,124,2,237
BACON,6/21/2020,111,127,2,240
BACON,6/22/2020,120,135,3,258
BACON,6/23/2020,126,144,4,274
BACON,6/24/2020,128,146,4,278
BACON,6/25/2020,132,148,4,284
BACON,6/26/2020,136,152,4,292
BACON,6/27/2020,137,153,4,294
BACON,6/28/2020,138,154,4,296
BACON,6/29/2020,141,157,4,302
BACON,6/30/2020,142,158,4,304
BACON,7/1/2020,143,161,4,308
BACON,7/2/2020,146,167,4,317
BACON,7/3/2020,149,167,4,320
BACON,7/4/2020,150,170,4,324
BACON,7/5/2020,151,170,4,325
BACON,7/6/2020,156,177,4,337
BACON,7/7/2020,157,180,4,341
BACON,7/8/2020,159,181,4,344
BACON,7/9/2020,162,186,4,352
BACON,7/10/2020,168,188,5,361
BACON,7/11/2020,169,189,5,363
BACON,7/12/2020,170,189,5,364
BACON,7/13/2020,174,191,5,370
BACON,7/14/2020,180,194,5,379
BACON,7/15/2020,183,199,5,387
BACON,7/16/2020,189,200,5,394
BACON,7/17/2020,191,204,5,400
BACON,7/18/2020,191,205,6,402
BACON,7/19/2020,191,205,6,402
BACON,7/20/2020,192,205,6,403
BACON,7/21/2020,197,211,7,415
BACON,7/22/2020,201,211,7,419
BACON,7/23/2020,202,214,7,423
BACON,7/24/2020,209,219,7,435
BACON,7/25/2020,212,219,7,438
BACON,7/26/2020,212,219,7,438
BACON,7/27/2020,214,224,7,445
BACON,7/28/2020,216,225,7,448
BACON,7/29/2020,224,229,7,460
BACON,7/30/2020,229,232,7,468
BACON,7/31/2020,232,233,7,472
BACON,8/1/2020,233,234,7,474
BACON,8/2/2020,234,234,7,475
BACON,8/3/2020,237,234,7,478
BACON,8/4/2020,238,236,7,481
BACON,8/5/2020,241,237,7,485
BACON,8/6/2020,243,238,7,488
BACON,8/7/2020,245,239,7,491
BACON,8/8/2020,245,239,7,491
BACON,8/9/2020,245,239,7,491
BACON,8/10/2020,247,240,7,494
BACON,8/11/2020,247,241,7,495
BACON,8/12/2020,247,241,7,495
BACON,8/13/2020,248,243,7,498
BACON,8/14/2020,251,243,7,501
BACON,8/15/2020,253,243,7,503
BACON,8/16/2020,254,243,7,504
BACON,8/17/2020,256,245,7,508
BACON,8/18/2020,256,250,7,513
BACON,8/19/2020,256,251,7,514
BACON,8/20/2020,258,253,7,518
BACON,8/21/2020,261,256,7,524
BACON,8/22/2020,263,260,7,530
BACON,8/23/2020,265,260,7,532
BACON,8/24/2020,267,262,7,536
BACON,8/25/2020,270,265,7,542
BACON,8/26/2020,271,266,7,544
BACON,8/27/2020,273,268,8,549
BACON,8/28/2020,275,269,8,552
BACON,8/29/2020,275,269,8,552
BACON,8/30/2020,276,269,8,553
BACON,8/31/2020,276,272,8,556
BACON,9/1/2020,278,272,8,558
BACON,9/2/2020,281,273,8,562
BACON,9/3/2020,284,274,8,566
BACON,9/4/2020,285,274,8,567
BACON,9/5/2020,287,274,8,569
BACON,9/6/2020,288,274,8,570
APPLING,2/8/2020,0,0,0,0
BACON,9/7/2020,289,274,8,571
WALTON,8/15/2020,831,561,15,1407
WALTON,8/16/2020,835,568,17,1420
WALTON,8/17/2020,844,569,17,1430
WALTON,8/18/2020,857,575,17,1449
WALTON,8/19/2020,864,580,17,1461
WALTON,8/20/2020,871,588,18,1477
WALTON,8/21/2020,885,594,18,1497
WALTON,8/22/2020,901,599,18,1518
WALTON,8/23/2020,904,602,18,1524
WALTON,8/24/2020,913,612,19,1544
WALTON,8/25/2020,921,620,19,1560
WALTON,8/26/2020,933,626,20,1579
WALTON,8/27/2020,944,632,20,1596
WALTON,8/28/2020,958,640,20,1618
WALTON,8/29/2020,966,647,20,1633
WALTON,8/30/2020,973,649,20,1642
WALTON,8/31/2020,982,657,20,1659
WALTON,9/1/2020,994,661,21,1676
WALTON,9/2/2020,1004,668,21,1693
WALTON,9/3/2020,1009,677,21,1707
JEFFERSON,4/30/2020,13,5,0,18
WALTON,9/4/2020,1016,684,21,1721
WALTON,9/5/2020,1019,685,21,1725
WALTON,9/6/2020,1023,688,21,1732
WALTON,9/7/2020,1029,693,21,1743
WALTON,9/8/2020,1035,698,21,1754
WALTON,9/9/2020,1038,701,21,1760
WALTON,9/10/2020,1044,707,21,1772
WALTON,9/11/2020,1048,713,21,1782
WALTON,9/12/2020,1050,717,21,1788
WALTON,9/13/2020,1052,718,21,1791
WALTON,9/14/2020,1055,721,21,1797
WALTON,9/15/2020,1061,723,21,1805
WALTON,9/16/2020,1063,727,21,1811
WALTON,9/17/2020,1070,729,21,1820
WALTON,9/18/2020,1078,733,21,1832
WALTON,9/19/2020,1083,737,22,1842
WALTON,9/20/2020,1087,744,22,1853
WALTON,9/21/2020,1093,749,22,1864
WALTON,9/22/2020,1095,750,22,1867
WALTON,9/23/2020,1103,753,23,1879
WALTON,9/24/2020,1106,755,23,1884
WALTON,9/25/2020,1110,761,23,1894
WALTON,9/26/2020,1111,761,23,1895
WALTON,9/27/2020,1116,765,23,1904
WALTON,9/28/2020,1122,772,23,1917
WALTON,9/29/2020,1129,774,23,1926
WALTON,9/30/2020,1133,777,23,1933
WALTON,10/1/2020,1138,781,23,1942
WALTON,10/2/2020,1140,788,23,1951
WALTON,10/3/2020,1147,797,23,1967
WALTON,10/4/2020,1153,803,23,1979
WALTON,10/5/2020,1156,810,23,1989
WALTON,10/6/2020,1160,818,23,2001
WALTON,10/7/2020,1164,828,23,2015
WALTON,10/8/2020,1171,833,23,2027
WALTON,10/9/2020,1175,835,23,2033
WALTON,10/10/2020,1179,841,23,2043
WALTON,10/11/2020,1180,844,23,2047
WALTON,10/12/2020,1185,848,23,2056
WALTON,10/13/2020,1192,852,23,2067
WALTON,10/14/2020,1195,858,23,2076
WALTON,10/15/2020,1198,861,23,2082
WALTON,10/16/2020,1202,862,23,2087
WALTON,10/17/2020,1204,863,23,2090
WALTON,10/18/2020,1205,864,23,2092
WALTON,10/19/2020,1205,864,23,2092
WALTON,10/20/2020,1205,864,23,2092
ALL GEORGIA,1/1/2020,1,2,2,5
ALL GEORGIA,1/2/2020,2,2,2,6
ALL GEORGIA,1/3/2020,2,2,2,6
ALL GEORGIA,1/4/2020,2,2,2,6
ALL GEORGIA,1/5/2020,2,2,2,6
ALL GEORGIA,1/6/2020,3,2,2,7
ALL GEORGIA,1/7/2020,3,2,2,7
ALL GEORGIA,1/8/2020,5,3,2,10
ALL GEORGIA,1/9/2020,5,3,2,10
ALL GEORGIA,1/10/2020,6,3,2,11
ALL GEORGIA,1/11/2020,6,3,2,11
ALL GEORGIA,1/12/2020,6,4,2,12
ALL GEORGIA,1/13/2020,6,4,2,12
ALL GEORGIA,1/14/2020,6,4,2,12
ALL GEORGIA,1/15/2020,6,5,2,13
ALL GEORGIA,1/16/2020,6,6,2,14
ALL GEORGIA,1/17/2020,6,6,2,14
ALL GEORGIA,1/18/2020,6,6,2,14
ALL GEORGIA,1/19/2020,6,6,2,14
ALL GEORGIA,1/20/2020,8,6,2,16
ALL GEORGIA,1/21/2020,9,7,2,18
ALL GEORGIA,1/22/2020,9,7,2,18
ALL GEORGIA,1/23/2020,9,7,2,18
ALL GEORGIA,1/24/2020,9,7,2,18
ALL GEORGIA,1/25/2020,9,7,2,18
ALL GEORGIA,1/26/2020,9,7,2,18
ALL GEORGIA,1/27/2020,9,7,2,18
ALL GEORGIA,1/28/2020,9,9,2,20
ALL GEORGIA,1/29/2020,9,9,2,20
ALL GEORGIA,1/30/2020,9,9,2,20
ALL GEORGIA,1/31/2020,10,9,2,21
ALL GEORGIA,2/1/2020,14,11,3,28
ALL GEORGIA,2/2/2020,17,12,3,32
ALL GEORGIA,2/3/2020,19,12,3,34
ALL GEORGIA,2/4/2020,19,12,3,34
ALL GEORGIA,2/5/2020,19,12,3,34
ALL GEORGIA,2/6/2020,20,13,3,36
ALL GEORGIA,2/7/2020,21,13,3,37
ALL GEORGIA,2/8/2020,22,13,3,38
ALL GEORGIA,2/9/2020,22,13,3,38
ALL GEORGIA,2/10/2020,27,13,3,43
ALL GEORGIA,2/11/2020,28,13,3,44
ALL GEORGIA,2/12/2020,28,13,3,44
ALL GEORGIA,2/13/2020,29,13,3,45
ALL GEORGIA,2/14/2020,30,17,3,50
ALL GEORGIA,2/15/2020,31,18,3,52
ALL GEORGIA,2/16/2020,31,18,3,52
ALL GEORGIA,2/17/2020,31,20,3,54
ALL GEORGIA,2/18/2020,33,21,3,57
ALL GEORGIA,2/19/2020,36,24,3,63
ALL GEORGIA,2/20/2020,39,27,3,69
ALL GEORGIA,2/21/2020,43,29,3,75
ALL GEORGIA,2/22/2020,45,34,3,82
ALL GEORGIA,2/23/2020,50,38,3,91
ALL GEORGIA,2/24/2020,55,43,3,101
ALL GEORGIA,2/25/2020,61,49,3,113
ALL GEORGIA,2/26/2020,65,58,3,126
ALL GEORGIA,2/27/2020,72,64,3,139
ALL GEORGIA,2/28/2020,82,72,3,157
ALL GEORGIA,2/29/2020,86,83,3,172
ALL GEORGIA,3/1/2020,134,122,3,259
ALL GEORGIA,3/2/2020,159,140,3,302
ALL GEORGIA,3/3/2020,180,162,3,345
ALL GEORGIA,3/4/2020,209,189,3,401
ALL GEORGIA,3/5/2020,237,210,3,450
ALL GEORGIA,3/6/2020,280,234,3,517
ALL GEORGIA,3/7/2020,314,265,3,582
ALL GEORGIA,3/8/2020,352,309,3,664
ALL GEORGIA,3/9/2020,422,372,3,797
ALL GEORGIA,3/10/2020,522,451,3,976
ALL GEORGIA,3/11/2020,609,531,4,1144
ALL GEORGIA,3/12/2020,707,636,4,1347
ALL GEORGIA,3/13/2020,861,759,4,1624
ALL GEORGIA,3/14/2020,996,858,4,1858
ALL GEORGIA,3/15/2020,1159,995,5,2159
ALL GEORGIA,3/16/2020,1381,1201,5,2587
ALL GEORGIA,3/17/2020,1591,1387,5,2983
ALL GEORGIA,3/18/2020,1829,1597,5,3431
ALL GEORGIA,3/19/2020,2054,1786,5,3845
ALL GEORGIA,3/20/2020,2316,2012,5,4333
ALL GEORGIA,3/21/2020,2497,2160,5,4662
ALL GEORGIA,3/22/2020,2682,2327,5,5014
ALL GEORGIA,3/23/2020,3040,2565,7,5612
ALL GEORGIA,3/24/2020,3342,2795,7,6144
ALL GEORGIA,3/25/2020,3645,3054,11,6710
ALL GEORGIA,3/26/2020,3946,3257,12,7215
ALL GEORGIA,3/27/2020,4241,3466,13,7720
ALL GEORGIA,3/28/2020,4468,3672,13,8153
ALL GEORGIA,3/29/2020,4670,3833,13,8516
ALL GEORGIA,3/30/2020,5054,4134,15,9203
ALL GEORGIA,3/31/2020,5376,4348,18,9742
ALL GEORGIA,4/1/2020,5785,4665,20,10470
ALL GEORGIA,4/2/2020,6126,4928,29,11083
ALL GEORGIA,4/3/2020,6497,5212,44,11753
ALL GEORGIA,4/4/2020,6777,5389,51,12217
ALL GEORGIA,4/5/2020,7017,5556,58,12631
ALL GEORGIA,4/6/2020,7528,5933,75,13536
ALL GEORGIA,4/7/2020,7905,6234,79,14218
ALL GEORGIA,4/8/2020,8330,6561,88,14979
ALL GEORGIA,4/9/2020,8775,6892,103,15770
ALL GEORGIA,4/10/2020,9267,7280,115,16662
ALL GEORGIA,4/11/2020,9578,7507,119,17204
ALL GEORGIA,4/12/2020,9804,7698,122,17624
ALL GEORGIA,4/13/2020,10281,8056,136,18473
ALL GEORGIA,4/14/2020,10715,8440,147,19302
ALL GEORGIA,4/15/2020,11154,8781,154,20089
ALL GEORGIA,4/16/2020,11570,9133,172,20875
ALL GEORGIA,4/17/2020,12038,9492,182,21712
ALL GEORGIA,4/18/2020,12324,9693,191,22208
ALL GEORGIA,4/19/2020,12631,9935,198,22764
ALL GEORGIA,4/20/2020,13208,10321,212,23741
ALL GEORGIA,4/21/2020,13693,10694,239,24626
ALL GEORGIA,4/22/2020,14181,11041,263,25485
ALL GEORGIA,4/23/2020,14559,11354,271,26184
ALL GEORGIA,4/24/2020,14991,11697,288,26976
ALL GEORGIA,4/25/2020,15245,11906,296,27447
ALL GEORGIA,4/26/2020,15432,12071,300,27803
ALL GEORGIA,4/27/2020,15946,12468,314,28728
ALL GEORGIA,4/28/2020,16460,12855,324,29639
ALL GEORGIA,4/29/2020,16829,13203,332,30364
ALL GEORGIA,4/30/2020,17178,13509,345,31032
ALL GEORGIA,5/1/2020,17596,13842,355,31793
ALL GEORGIA,5/2/2020,17794,14027,359,32180
ALL GEORGIA,5/3/2020,17954,14168,361,32483
ALL GEORGIA,5/4/2020,18318,14595,369,33282
ALL GEORGIA,5/5/2020,18614,14863,375,33852
ALL GEORGIA,5/6/2020,18901,15132,389,34422
ALL GEORGIA,5/7/2020,19195,15358,406,34959
ALL GEORGIA,5/8/2020,19491,15658,411,35560
ALL GEORGIA,5/9/2020,19672,15816,415,35903
ALL GEORGIA,5/10/2020,19847,16006,420,36273
ALL GEORGIA,5/11/2020,20253,16471,433,37157
ALL GEORGIA,5/12/2020,20589,16800,447,37836
ALL GEORGIA,5/13/2020,21016,17105,468,38589
ALL GEORGIA,5/14/2020,21423,17454,483,39360
ALL GEORGIA,5/15/2020,21878,17855,497,40230
ALL GEORGIA,5/16/2020,22132,18089,503,40724
ALL GEORGIA,5/17/2020,22343,18283,507,41133
ALL GEORGIA,5/18/2020,22749,18669,530,41948
ALL GEORGIA,5/19/2020,23143,19032,535,42710
ALL GEORGIA,5/20/2020,23502,19376,544,43422
ALL GEORGIA,5/21/2020,23823,19717,551,44091
ALL GEORGIA,5/22/2020,24209,20108,555,44872
ALL GEORGIA,5/23/2020,24477,20335,559,45371
ALL GEORGIA,5/24/2020,24667,20520,563,45750
ALL GEORGIA,5/25/2020,24910,20752,563,46225
ALL GEORGIA,5/26/2020,25412,21165,575,47152
ALL GEORGIA,5/27/2020,25879,21520,577,47976
ALL GEORGIA,5/28/2020,26287,21861,585,48733
ALL GEORGIA,5/29/2020,26700,22334,612,49646
ALL GEORGIA,5/30/2020,27003,22613,616,50232
ALL GEORGIA,5/31/2020,27179,22817,617,50613
ALL GEORGIA,6/1/2020,27834,23344,633,51811
ALL GEORGIA,6/2/2020,28357,23752,644,52753
ALL GEORGIA,6/3/2020,28830,24142,653,53625
ALL GEORGIA,6/4/2020,29329,24550,672,54551
ALL GEORGIA,6/5/2020,29847,25043,678,55568
ALL GEORGIA,6/6/2020,30200,25389,688,56277
ALL GEORGIA,6/7/2020,30469,25627,692,56788
ALL GEORGIA,6/8/2020,31123,26241,720,58084
ALL GEORGIA,6/9/2020,31657,26799,748,59204
ALL GEORGIA,6/10/2020,32223,27377,771,60371
ALL GEORGIA,6/11/2020,32830,27932,788,61550
ALL GEORGIA,6/12/2020,33416,28432,809,62657
ALL GEORGIA,6/13/2020,33885,28828,819,63532
ALL GEORGIA,6/14/2020,34306,29182,826,64314
ALL GEORGIA,6/15/2020,35298,30048,837,66183
ALL GEORGIA,6/16/2020,36163,30892,861,67916
ALL GEORGIA,6/17/2020,37087,31726,902,69715
ALL GEORGIA,6/18/2020,37988,32535,940,71463
ALL GEORGIA,6/19/2020,38993,33369,971,73333
ALL GEORGIA,6/20/2020,39881,34145,998,75024
ALL GEORGIA,6/21/2020,40599,34737,1029,76365
ALL GEORGIA,6/22/2020,42160,36222,1076,79458
ALL GEORGIA,6/23/2020,43715,37751,1139,82605
ALL GEORGIA,6/24/2020,45243,39155,1237,85635
ALL GEORGIA,6/25/2020,46795,40619,1350,88764
ALL GEORGIA,6/26/2020,48495,42084,1470,92049
ALL GEORGIA,6/27/2020,49663,43107,1593,94363
ALL GEORGIA,6/28/2020,50773,44001,1681,96455
ALL GEORGIA,6/29/2020,53015,45931,1865,100811
ALL GEORGIA,6/30/2020,55203,47763,2020,104986
ALL GEORGIA,7/1/2020,57558,49730,2185,109473
ALL GEORGIA,7/2/2020,59774,51555,2430,113759
ALL GEORGIA,7/3/2020,61445,52976,2559,116980
ALL GEORGIA,7/4/2020,62605,53866,2600,119071
ALL GEORGIA,7/5/2020,63866,54966,2638,121470
ALL GEORGIA,7/6/2020,66770,57546,2986,127302
ALL GEORGIA,7/7/2020,69446,59871,3278,132595
ALL GEORGIA,7/8/2020,72054,62109,3481,137644
ALL GEORGIA,7/9/2020,74541,64263,3655,142459
ALL GEORGIA,7/10/2020,77003,66365,3773,147141
ALL GEORGIA,7/11/2020,78561,67646,3831,150038
ALL GEORGIA,7/12/2020,79774,68617,3901,152292
ALL GEORGIA,7/13/2020,82612,71058,4093,157763
ALL GEORGIA,7/14/2020,85050,73196,4254,162500
ALL GEORGIA,7/15/2020,87343,75185,4458,166986
ALL GEORGIA,7/16/2020,89550,77212,4619,171381
ALL GEORGIA,7/17/2020,91599,78940,4738,175277
ALL GEORGIA,7/18/2020,93008,80109,4796,177913
ALL GEORGIA,7/19/2020,94050,80903,4852,179805
ALL GEORGIA,7/20/2020,96392,82936,4947,184275
ALL GEORGIA,7/21/2020,98433,84726,5037,188196
ALL GEORGIA,7/22/2020,100321,86373,5135,191829
ALL GEORGIA,7/23/2020,102166,87956,5204,195326
ALL GEORGIA,7/24/2020,104027,89522,5269,198818
ALL GEORGIA,7/25/2020,105246,90588,5295,201129
ALL GEORGIA,7/26/2020,106170,91333,5313,202816
ALL GEORGIA,7/27/2020,108164,93006,5376,206546
ALL GEORGIA,7/28/2020,109980,94619,5451,210050
ALL GEORGIA,7/29/2020,111733,96076,5508,213317
ALL GEORGIA,7/30/2020,113362,97439,5569,216370
ALL GEORGIA,7/31/2020,114944,98716,5643,219303
ALL GEORGIA,8/1/2020,116189,99701,5671,221561
ALL GEORGIA,8/2/2020,117093,100462,5700,223255
ALL GEORGIA,8/3/2020,118795,102118,5737,226650
ALL GEORGIA,8/4/2020,120465,103587,5820,229872
ALL GEORGIA,8/5/2020,122169,105014,5899,233082
ALL GEORGIA,8/6/2020,123556,106222,5974,235752
ALL GEORGIA,8/7/2020,125039,107404,6013,238456
ALL GEORGIA,8/8/2020,125987,108218,6029,240234
ALL GEORGIA,8/9/2020,126803,108861,6045,241709
ALL GEORGIA,8/10/2020,128393,110289,6085,244767
ALL GEORGIA,8/11/2020,129723,111450,6124,247297
ALL GEORGIA,8/12/2020,131040,112672,6147,249859
ALL GEORGIA,8/13/2020,132226,113695,6176,252097
ALL GEORGIA,8/14/2020,133369,114697,6210,254276
ALL GEORGIA,8/15/2020,134220,115429,6230,255879
ALL GEORGIA,8/16/2020,134969,116051,6252,257272
ALL GEORGIA,8/17/2020,136256,117166,6274,259696
ALL GEORGIA,8/18/2020,137383,118177,6317,261877
ALL GEORGIA,8/19/2020,138507,119113,6343,263963
ALL GEORGIA,8/20/2020,139545,120037,6391,265973
ALL GEORGIA,8/21/2020,140707,120992,6418,268117
ALL GEORGIA,8/22/2020,141479,121602,6431,269512
ALL GEORGIA,8/23/2020,142233,122216,6442,270891
ALL GEORGIA,8/24/2020,143550,123369,6487,273406
ALL GEORGIA,8/25/2020,144681,124312,6523,275516
ALL GEORGIA,8/26/2020,145788,125270,6549,277607
ALL GEORGIA,8/27/2020,146807,126120,6568,279495
ALL GEORGIA,8/28/2020,147845,126986,6594,281425
ALL GEORGIA,8/29/2020,148547,127532,6603,282682
ALL GEORGIA,8/30/2020,149186,128141,6614,283941
ALL GEORGIA,8/31/2020,150404,129255,6636,286295
ALL GEORGIA,9/1/2020,151533,130189,6655,288377
ALL GEORGIA,9/2/2020,152570,131026,6672,290268
ALL GEORGIA,9/3/2020,153490,131863,6698,292051
ALL GEORGIA,9/4/2020,154374,132653,6713,293740
ALL GEORGIA,9/5/2020,155005,133117,6723,294845
ALL GEORGIA,9/6/2020,155557,133556,6731,295844
ALL GEORGIA,9/7/2020,156198,134133,6734,297065
ALL GEORGIA,9/8/2020,157209,135016,6761,298986
ALL GEORGIA,9/9/2020,158082,135775,6775,300632
ALL GEORGIA,9/10/2020,158903,136506,6813,302222
ALL GEORGIA,9/11/2020,159692,137178,6836,303706
ALL GEORGIA,9/12/2020,160231,137632,6848,304711
ALL GEORGIA,9/13/2020,160746,138053,6851,305650
ALL GEORGIA,9/14/2020,161505,138818,6871,307194
ALL GEORGIA,9/15/2020,162200,139462,6889,308551
ALL GEORGIA,9/16/2020,162873,140016,6899,309788
ALL GEORGIA,9/17/2020,163418,140546,6910,310874
ALL GEORGIA,9/18/2020,164089,141094,6920,312103
ALL GEORGIA,9/19/2020,164536,141476,6927,312939
ALL GEORGIA,9/20/2020,164971,141805,6935,313711
ALL GEORGIA,9/21/2020,165698,142436,6951,315085
ALL GEORGIA,9/22/2020,166339,142934,6959,316232
ALL GEORGIA,9/23/2020,167010,143455,6973,317438
ALL GEORGIA,9/24/2020,167594,143950,6975,318519
ALL GEORGIA,9/25/2020,168237,144423,6991,319651
ALL GEORGIA,9/26/2020,168689,144786,6995,320470
ALL GEORGIA,9/27/2020,169075,145143,7010,321228
ALL GEORGIA,9/28/2020,169758,145749,7033,322540
ALL GEORGIA,9/29/2020,170364,146254,7047,323665
ALL GEORGIA,9/30/2020,171034,146807,7062,324903
ALL GEORGIA,10/1/2020,171654,147330,7077,326061
ALL GEORGIA,10/2/2020,172289,147874,7089,327252
ALL GEORGIA,10/3/2020,172756,148299,7099,328154
ALL GEORGIA,10/4/2020,173197,148655,7105,328957
ALL GEORGIA,10/5/2020,173935,149367,7118,330420
ALL GEORGIA,10/6/2020,174590,149957,7124,331671
ALL GEORGIA,10/7/2020,175216,150545,7135,332896
ALL GEORGIA,10/8/2020,175898,151068,7146,334112
ALL GEORGIA,10/9/2020,176484,151591,7158,335233
ALL GEORGIA,10/10/2020,176907,151953,7164,336024
ALL GEORGIA,10/11/2020,177230,152250,7169,336649
ALL GEORGIA,10/12/2020,177852,152852,7183,337887
ALL GEORGIA,10/13/2020,178435,153405,7191,339031
ALL GEORGIA,10/14/2020,178932,153848,7201,339981
ALL GEORGIA,10/15/2020,179416,154308,7217,340941
ALL GEORGIA,10/16/2020,179865,154684,7233,341782
ALL GEORGIA,10/17/2020,180083,154903,7240,342226
ALL GEORGIA,10/18/2020,180145,154973,7245,342363
ALL GEORGIA,10/19/2020,180182,155001,7247,342430
ALL GEORGIA,10/20/2020,180185,155002,7251,342438
APPLING,1/1/2020,0,0,0,0
APPLING,1/2/2020,0,0,0,0
APPLING,1/3/2020,0,0,0,0
APPLING,1/4/2020,0,0,0,0
APPLING,1/5/2020,0,0,0,0
APPLING,1/6/2020,0,0,0,0
APPLING,1/7/2020,0,0,0,0
APPLING,1/8/2020,0,0,0,0
APPLING,1/9/2020,0,0,0,0
APPLING,1/10/2020,0,0,0,0
APPLING,1/11/2020,0,0,0,0
APPLING,1/12/2020,0,0,0,0
APPLING,1/13/2020,0,0,0,0
APPLING,1/14/2020,0,0,0,0
APPLING,1/15/2020,0,0,0,0
APPLING,1/16/2020,0,0,0,0
APPLING,1/17/2020,0,0,0,0
APPLING,1/18/2020,0,0,0,0
APPLING,1/19/2020,0,0,0,0
APPLING,1/20/2020,0,0,0,0
APPLING,1/21/2020,0,0,0,0
APPLING,1/22/2020,0,0,0,0
APPLING,1/23/2020,0,0,0,0
APPLING,1/24/2020,0,0,0,0
APPLING,1/25/2020,0,0,0,0
APPLING,1/26/2020,0,0,0,0
APPLING,1/27/2020,0,0,0,0
APPLING,1/28/2020,0,0,0,0
APPLING,1/29/2020,0,0,0,0
APPLING,1/30/2020,0,0,0,0
APPLING,1/31/2020,0,0,0,0
APPLING,2/1/2020,0,0,0,0
APPLING,2/2/2020,0,0,0,0
APPLING,2/3/2020,0,0,0,0
APPLING,2/4/2020,0,0,0,0
APPLING,2/5/2020,0,0,0,0
APPLING,2/6/2020,0,0,0,0
APPLING,2/7/2020,0,0,0,0
BACON,9/8/2020,292,275,8,575
APPLING,2/9/2020,0,0,0,0
APPLING,2/10/2020,0,0,0,0
APPLING,2/11/2020,0,0,0,0
APPLING,2/12/2020,0,0,0,0
JEFFERSON,5/1/2020,13,5,0,18
APPLING,2/13/2020,0,0,0,0
APPLING,2/14/2020,0,0,0,0
APPLING,2/15/2020,0,0,0,0
APPLING,2/16/2020,0,0,0,0
APPLING,2/17/2020,0,0,0,0
APPLING,2/18/2020,0,0,0,0
APPLING,2/19/2020,0,0,0,0
APPLING,2/20/2020,0,0,0,0
APPLING,2/21/2020,0,0,0,0
APPLING,2/22/2020,0,0,0,0
APPLING,2/23/2020,0,0,0,0
APPLING,2/24/2020,0,0,0,0
APPLING,2/25/2020,0,0,0,0
APPLING,2/26/2020,0,0,0,0
APPLING,2/27/2020,0,0,0,0
APPLING,2/28/2020,0,0,0,0
APPLING,2/29/2020,0,0,0,0
APPLING,3/1/2020,0,0,0,0
APPLING,3/2/2020,0,0,0,0
BACON,9/9/2020,293,278,8,579
APPLING,3/3/2020,0,0,0,0
APPLING,3/4/2020,0,0,0,0
APPLING,3/5/2020,0,0,0,0
APPLING,3/6/2020,0,0,0,0
APPLING,3/7/2020,0,0,0,0
APPLING,3/8/2020,0,0,0,0
APPLING,3/9/2020,0,0,0,0
APPLING,3/10/2020,0,0,0,0
APPLING,3/11/2020,0,0,0,0
APPLING,3/12/2020,0,0,0,0
APPLING,3/13/2020,0,0,0,0
APPLING,3/14/2020,0,0,0,0
APPLING,3/15/2020,0,0,0,0
APPLING,3/16/2020,0,0,0,0
APPLING,3/17/2020,0,0,0,0
APPLING,3/18/2020,0,0,0,0
APPLING,3/19/2020,0,0,0,0
APPLING,3/20/2020,0,0,0,0
APPLING,3/21/2020,0,0,0,0
APPLING,3/22/2020,0,0,0,0
APPLING,3/23/2020,2,0,0,2
APPLING,3/24/2020,2,1,0,3
APPLING,3/25/2020,2,1,0,3
APPLING,3/26/2020,2,1,0,3
APPLING,3/27/2020,2,1,0,3
APPLING,3/28/2020,2,1,0,3
APPLING,3/29/2020,2,1,0,3
APPLING,3/30/2020,3,1,0,4
APPLING,3/31/2020,3,3,0,6
APPLING,4/1/2020,3,4,0,7
APPLING,4/2/2020,3,4,0,7
APPLING,4/3/2020,3,4,0,7
APPLING,4/4/2020,3,4,0,7
APPLING,4/5/2020,3,4,0,7
APPLING,4/6/2020,3,5,0,8
APPLING,4/7/2020,3,5,0,8
APPLING,4/8/2020,6,5,0,11
APPLING,4/9/2020,6,6,0,12
APPLING,4/10/2020,7,6,0,13
APPLING,4/11/2020,8,7,0,15
APPLING,4/12/2020,9,9,0,18
APPLING,4/13/2020,11,11,0,22
APPLING,4/14/2020,12,16,0,28
APPLING,4/15/2020,17,17,0,34
APPLING,4/16/2020,19,20,0,39
APPLING,4/17/2020,21,30,0,51
APPLING,4/18/2020,23,31,0,54
APPLING,4/19/2020,23,31,0,54
APPLING,4/20/2020,28,35,0,63
APPLING,4/21/2020,29,35,0,64
APPLING,4/22/2020,29,36,0,65
APPLING,4/23/2020,32,36,0,68
APPLING,4/24/2020,34,36,0,70
APPLING,4/25/2020,35,37,0,72
APPLING,4/26/2020,36,37,0,73
APPLING,4/27/2020,39,38,0,77
APPLING,4/28/2020,42,40,0,82
APPLING,4/29/2020,47,40,0,87
APPLING,4/30/2020,48,41,0,89
APPLING,5/1/2020,49,41,0,90
APPLING,5/2/2020,51,48,0,99
APPLING,5/3/2020,54,49,0,103
APPLING,5/4/2020,55,50,0,105
APPLING,5/5/2020,56,50,0,106
APPLING,5/6/2020,57,51,0,108
APPLING,5/7/2020,59,53,0,112
APPLING,5/8/2020,62,55,0,117
APPLING,5/9/2020,63,56,0,119
APPLING,5/10/2020,63,57,0,120
APPLING,5/11/2020,64,57,0,121
APPLING,5/12/2020,66,59,0,125
APPLING,5/13/2020,66,60,0,126
APPLING,5/14/2020,67,61,0,128
APPLING,5/15/2020,67,64,0,131
APPLING,5/16/2020,68,64,0,132
APPLING,5/17/2020,69,64,0,133
APPLING,5/18/2020,71,65,0,136
APPLING,5/19/2020,72,66,0,138
APPLING,5/20/2020,75,67,0,142
APPLING,5/21/2020,78,68,0,146
APPLING,5/22/2020,79,70,0,149
APPLING,5/23/2020,79,73,0,152
APPLING,5/24/2020,81,76,1,158
APPLING,5/25/2020,83,81,1,165
APPLING,5/26/2020,85,84,2,171
APPLING,5/27/2020,87,84,2,173
APPLING,5/28/2020,89,86,2,177
APPLING,5/29/2020,93,90,2,185
APPLING,5/30/2020,94,92,2,188
APPLING,5/31/2020,94,93,2,189
APPLING,6/1/2020,98,95,4,197
APPLING,6/2/2020,99,98,4,201
APPLING,6/3/2020,101,100,4,205
APPLING,6/4/2020,105,100,4,209
APPLING,6/5/2020,107,101,4,212
APPLING,6/6/2020,107,103,4,214
APPLING,6/7/2020,108,103,4,215
APPLING,6/8/2020,109,104,4,217
APPLING,6/9/2020,109,108,4,221
APPLING,6/10/2020,113,109,4,226
APPLING,6/11/2020,115,111,4,230
APPLING,6/12/2020,115,113,5,233
APPLING,6/13/2020,115,113,5,233
APPLING,6/14/2020,116,113,5,234
APPLING,6/15/2020,118,115,5,238
APPLING,6/16/2020,121,118,5,244
APPLING,6/17/2020,121,118,5,244
APPLING,6/18/2020,125,119,5,249
APPLING,6/19/2020,129,125,5,259
APPLING,6/20/2020,136,125,5,266
APPLING,6/21/2020,136,125,5,266
APPLING,6/22/2020,141,133,5,279
APPLING,6/23/2020,147,135,5,287
APPLING,6/24/2020,155,136,5,296
APPLING,6/25/2020,160,137,5,302
APPLING,6/26/2020,160,140,5,305
APPLING,6/27/2020,162,141,5,308
APPLING,6/28/2020,163,144,5,312
APPLING,6/29/2020,167,147,5,319
APPLING,6/30/2020,176,153,5,334
APPLING,7/1/2020,181,159,5,345
APPLING,7/2/2020,185,165,5,355
APPLING,7/3/2020,190,168,5,363
APPLING,7/4/2020,191,169,5,365
APPLING,7/5/2020,192,169,5,366
APPLING,7/6/2020,206,178,5,389
APPLING,7/7/2020,218,188,5,411
APPLING,7/8/2020,231,199,5,435
APPLING,7/9/2020,243,203,5,451
APPLING,7/10/2020,255,215,5,475
APPLING,7/11/2020,264,221,5,490
APPLING,7/12/2020,266,223,5,494
APPLING,7/13/2020,279,232,5,516
APPLING,7/14/2020,291,237,5,533
APPLING,7/15/2020,301,242,5,548
APPLING,7/16/2020,308,249,5,562
APPLING,7/17/2020,312,251,5,568
APPLING,7/18/2020,314,258,5,577
APPLING,7/19/2020,316,259,5,580
APPLING,7/20/2020,329,267,5,601
APPLING,7/21/2020,336,272,5,613
APPLING,7/22/2020,341,278,5,624
APPLING,7/23/2020,348,283,5,636
APPLING,7/24/2020,353,285,5,643
APPLING,7/25/2020,355,287,5,647
APPLING,7/26/2020,356,290,5,651
APPLING,7/27/2020,363,297,5,665
APPLING,7/28/2020,367,299,5,671
APPLING,7/29/2020,377,305,5,687
APPLING,7/30/2020,385,308,5,698
APPLING,7/31/2020,388,317,5,710
APPLING,8/1/2020,392,319,5,716
APPLING,8/2/2020,394,322,5,721
APPLING,8/3/2020,401,334,5,740
APPLING,8/4/2020,404,337,5,746
APPLING,8/5/2020,416,347,5,768
APPLING,8/6/2020,419,348,5,772
APPLING,8/7/2020,425,354,5,784
APPLING,8/8/2020,427,356,5,788
APPLING,8/9/2020,431,357,5,793
APPLING,8/10/2020,442,367,6,815
APPLING,8/11/2020,449,368,6,823
APPLING,8/12/2020,455,375,6,836
APPLING,8/13/2020,462,379,6,847
APPLING,8/14/2020,465,381,6,852
APPLING,8/15/2020,468,381,7,856
APPLING,8/16/2020,469,382,7,858
APPLING,8/17/2020,475,386,7,868
APPLING,8/18/2020,477,389,7,873
APPLING,8/19/2020,481,394,7,882
APPLING,8/20/2020,486,400,7,893
APPLING,8/21/2020,492,405,7,904
APPLING,8/22/2020,493,407,7,907
APPLING,8/23/2020,494,408,7,909
APPLING,8/24/2020,501,413,7,921
APPLING,8/25/2020,505,416,7,928
APPLING,8/26/2020,512,421,7,940
APPLING,8/27/2020,515,425,7,947
APPLING,8/28/2020,517,428,7,952
APPLING,8/29/2020,520,430,7,957
APPLING,8/30/2020,520,433,7,960
APPLING,8/31/2020,526,438,7,971
APPLING,9/1/2020,529,440,7,976
APPLING,9/2/2020,531,441,7,979
APPLING,9/3/2020,534,443,7,984
APPLING,9/4/2020,539,446,7,992
APPLING,9/5/2020,539,446,7,992
APPLING,9/6/2020,540,446,7,993
APPLING,9/7/2020,541,447,7,995
APPLING,9/8/2020,542,449,7,998
APPLING,9/9/2020,542,451,7,1000
APPLING,9/10/2020,543,455,7,1005
APPLING,9/11/2020,544,457,7,1008
APPLING,9/12/2020,544,457,7,1008
APPLING,9/13/2020,546,458,7,1011
APPLING,9/14/2020,550,463,7,1020
APPLING,9/15/2020,552,463,7,1022
APPLING,9/16/2020,554,465,7,1026
APPLING,9/17/2020,556,467,7,1030
APPLING,9/18/2020,559,467,7,1033
APPLING,9/19/2020,560,467,7,1034
APPLING,9/20/2020,561,469,7,1037
APPLING,9/21/2020,563,470,7,1040
APPLING,9/22/2020,564,471,7,1042
APPLING,9/23/2020,567,473,7,1047
APPLING,9/24/2020,569,477,7,1053
APPLING,9/25/2020,571,479,7,1057
APPLING,9/26/2020,573,481,7,1061
APPLING,9/27/2020,575,481,7,1063
APPLING,9/28/2020,578,483,7,1068
APPLING,9/29/2020,580,485,7,1072
APPLING,9/30/2020,581,487,9,1077
APPLING,10/1/2020,582,489,9,1080
APPLING,10/2/2020,583,493,9,1085
APPLING,10/3/2020,585,495,9,1089
APPLING,10/4/2020,588,496,9,1093
APPLING,10/5/2020,591,498,9,1098
APPLING,10/6/2020,592,498,9,1099
APPLING,10/7/2020,598,500,9,1107
APPLING,10/8/2020,598,504,13,1115
APPLING,10/9/2020,598,506,13,1117
APPLING,10/10/2020,600,506,13,1119
APPLING,10/11/2020,601,506,13,1120
APPLING,10/12/2020,602,507,13,1122
APPLING,10/13/2020,603,509,13,1125
APPLING,10/14/2020,604,511,13,1128
APPLING,10/15/2020,605,512,13,1130
APPLING,10/16/2020,607,512,13,1132
APPLING,10/17/2020,607,512,13,1132
APPLING,10/18/2020,607,513,13,1133
APPLING,10/19/2020,608,513,13,1134
APPLING,10/20/2020,608,513,13,1134
ATKINSON,1/1/2020,0,0,0,0
ATKINSON,1/2/2020,0,0,0,0
ATKINSON,1/3/2020,0,0,0,0
ATKINSON,1/4/2020,0,0,0,0
ATKINSON,1/5/2020,0,0,0,0
ATKINSON,1/6/2020,0,0,0,0
ATKINSON,1/7/2020,0,0,0,0
ATKINSON,1/8/2020,0,0,0,0
ATKINSON,1/9/2020,0,0,0,0
ATKINSON,1/10/2020,0,0,0,0
ATKINSON,1/11/2020,0,0,0,0
ATKINSON,1/12/2020,0,0,0,0
ATKINSON,1/13/2020,0,0,0,0
ATKINSON,1/14/2020,0,0,0,0
ATKINSON,1/15/2020,0,0,0,0
ATKINSON,1/16/2020,0,0,0,0
ATKINSON,1/17/2020,0,0,0,0
ATKINSON,1/18/2020,0,0,0,0
ATKINSON,1/19/2020,0,0,0,0
ATKINSON,1/20/2020,0,0,0,0
ATKINSON,1/21/2020,0,0,0,0
ATKINSON,1/22/2020,0,0,0,0
ATKINSON,1/23/2020,0,0,0,0
ATKINSON,1/24/2020,0,0,0,0
ATKINSON,1/25/2020,0,0,0,0
ATKINSON,1/26/2020,0,0,0,0
ATKINSON,1/27/2020,0,0,0,0
ATKINSON,1/28/2020,0,0,0,0
ATKINSON,1/29/2020,0,0,0,0
ATKINSON,1/30/2020,0,0,0,0
ATKINSON,1/31/2020,0,0,0,0
ATKINSON,2/1/2020,0,0,0,0
ATKINSON,2/2/2020,0,0,0,0
ATKINSON,2/3/2020,0,0,0,0
ATKINSON,2/4/2020,0,0,0,0
ATKINSON,2/5/2020,0,0,0,0
ATKINSON,2/6/2020,0,0,0,0
ATKINSON,2/7/2020,0,0,0,0
ATKINSON,2/8/2020,0,0,0,0
ATKINSON,2/9/2020,0,0,0,0
ATKINSON,2/10/2020,0,0,0,0
ATKINSON,2/11/2020,0,0,0,0
ATKINSON,2/12/2020,0,0,0,0
ATKINSON,2/13/2020,0,0,0,0
ATKINSON,2/14/2020,0,0,0,0
ATKINSON,2/15/2020,0,0,0,0
ATKINSON,2/16/2020,0,0,0,0
ATKINSON,2/17/2020,0,0,0,0
ATKINSON,2/18/2020,0,0,0,0
ATKINSON,2/19/2020,0,0,0,0
ATKINSON,2/20/2020,0,0,0,0
ATKINSON,2/21/2020,0,0,0,0
ATKINSON,2/22/2020,0,0,0,0
ATKINSON,2/23/2020,0,0,0,0
ATKINSON,2/24/2020,0,0,0,0
ATKINSON,2/25/2020,0,0,0,0
ATKINSON,2/26/2020,0,0,0,0
ATKINSON,2/27/2020,0,0,0,0
ATKINSON,2/28/2020,0,0,0,0
ATKINSON,2/29/2020,0,0,0,0
ATKINSON,3/1/2020,0,0,0,0
ATKINSON,3/2/2020,0,0,0,0
ATKINSON,3/3/2020,0,0,0,0
ATKINSON,3/4/2020,0,0,0,0
ATKINSON,3/5/2020,0,0,0,0
ATKINSON,3/6/2020,0,0,0,0
ATKINSON,3/7/2020,0,0,0,0
ATKINSON,3/8/2020,0,0,0,0
ATKINSON,3/9/2020,0,0,0,0
ATKINSON,3/10/2020,0,0,0,0
ATKINSON,3/11/2020,0,0,0,0
ATKINSON,3/12/2020,0,0,0,0
ATKINSON,3/13/2020,0,0,0,0
ATKINSON,3/14/2020,0,0,0,0
ATKINSON,3/15/2020,0,0,0,0
ATKINSON,3/16/2020,0,0,0,0
ATKINSON,3/17/2020,0,0,0,0
ATKINSON,3/18/2020,0,0,0,0
ATKINSON,3/19/2020,0,0,0,0
ATKINSON,3/20/2020,0,0,0,0
ATKINSON,3/21/2020,0,0,0,0
ATKINSON,3/22/2020,0,0,0,0
ATKINSON,3/23/2020,0,0,0,0
ATKINSON,3/24/2020,0,0,0,0
ATKINSON,3/25/2020,0,0,0,0
ATKINSON,3/26/2020,1,0,0,1
ATKINSON,3/27/2020,1,0,0,1
ATKINSON,3/28/2020,1,0,0,1
ATKINSON,3/29/2020,1,0,0,1
ATKINSON,3/30/2020,1,0,0,1
ATKINSON,3/31/2020,1,0,0,1
ATKINSON,4/1/2020,2,1,0,3
ATKINSON,4/2/2020,2,1,0,3
ATKINSON,4/3/2020,3,1,0,4
ATKINSON,4/4/2020,3,1,0,4
ATKINSON,4/5/2020,3,1,0,4
ATKINSON,4/6/2020,3,1,0,4
ATKINSON,4/7/2020,3,1,0,4
ATKINSON,4/8/2020,3,1,0,4
ATKINSON,4/9/2020,3,1,0,4
ATKINSON,4/10/2020,5,1,0,6
ATKINSON,4/11/2020,6,1,0,7
ATKINSON,4/12/2020,6,1,0,7
ATKINSON,4/13/2020,6,1,0,7
ATKINSON,4/14/2020,6,1,0,7
ATKINSON,4/15/2020,6,1,0,7
ATKINSON,4/16/2020,6,1,0,7
ATKINSON,4/17/2020,6,1,0,7
ATKINSON,4/18/2020,7,1,0,8
ATKINSON,4/19/2020,7,1,0,8
ATKINSON,4/20/2020,7,1,0,8
ATKINSON,4/21/2020,8,2,0,10
ATKINSON,4/22/2020,9,2,0,11
ATKINSON,4/23/2020,11,2,0,13
ATKINSON,4/24/2020,13,3,0,16
ATKINSON,4/25/2020,13,4,0,17
ATKINSON,4/26/2020,13,4,0,17
ATKINSON,4/27/2020,14,4,0,18
ATKINSON,4/28/2020,14,4,0,18
ATKINSON,4/29/2020,14,5,0,19
ATKINSON,4/30/2020,14,5,0,19
ATKINSON,5/1/2020,14,6,0,20
ATKINSON,5/2/2020,14,9,0,23
ATKINSON,5/3/2020,14,9,0,23
ATKINSON,5/4/2020,14,9,0,23
ATKINSON,5/5/2020,15,9,0,24
ATKINSON,5/6/2020,16,10,0,26
ATKINSON,5/7/2020,16,11,0,27
ATKINSON,5/8/2020,18,11,0,29
ATKINSON,5/9/2020,18,11,0,29
ATKINSON,5/10/2020,18,11,0,29
ATKINSON,5/11/2020,18,11,0,29
ATKINSON,5/12/2020,19,13,0,32
ATKINSON,5/13/2020,19,14,0,33
ATKINSON,5/14/2020,19,14,0,33
ATKINSON,5/15/2020,21,15,0,36
ATKINSON,5/16/2020,23,15,0,38
ATKINSON,5/17/2020,24,16,0,40
ATKINSON,5/18/2020,24,16,0,40
ATKINSON,5/19/2020,26,18,0,44
ATKINSON,5/20/2020,28,19,0,47
ATKINSON,5/21/2020,28,19,0,47
ATKINSON,5/22/2020,28,19,0,47
ATKINSON,5/23/2020,29,20,0,49
BACON,9/10/2020,294,279,8,581
JEFFERSON,5/2/2020,13,5,0,18
BACON,9/11/2020,296,280,8,584
JEFFERSON,5/3/2020,13,5,0,18
BACON,9/12/2020,298,280,8,586
JEFFERSON,5/4/2020,14,6,0,20
JEFFERSON,5/5/2020,14,6,0,20
JEFFERSON,5/6/2020,14,6,0,20
JEFFERSON,5/7/2020,14,6,0,20
JEFFERSON,5/8/2020,16,6,0,22
JEFFERSON,5/9/2020,16,6,0,22
JEFFERSON,5/10/2020,16,6,0,22
JEFFERSON,5/11/2020,19,7,0,26
JEFFERSON,5/12/2020,19,8,0,27
JEFFERSON,5/13/2020,19,8,0,27
JEFFERSON,5/14/2020,20,9,0,29
JEFFERSON,5/15/2020,21,9,0,30
JEFFERSON,5/16/2020,21,11,0,32
JEFFERSON,5/17/2020,21,11,0,32
JEFFERSON,5/18/2020,22,11,0,33
JEFFERSON,5/19/2020,22,11,0,33
JEFFERSON,5/20/2020,23,12,0,35
JEFFERSON,5/21/2020,24,17,0,41
JEFFERSON,5/22/2020,24,17,0,41
JEFFERSON,5/23/2020,28,17,0,45
JEFFERSON,5/24/2020,28,17,0,45
JEFFERSON,5/25/2020,28,17,0,45
JEFFERSON,5/26/2020,31,18,0,49
JEFFERSON,5/27/2020,31,18,0,49
JEFFERSON,5/28/2020,31,18,0,49
JEFFERSON,5/29/2020,31,19,0,50
JEFFERSON,5/30/2020,31,19,0,50
JEFFERSON,5/31/2020,31,20,0,51
JEFFERSON,6/1/2020,32,20,0,52
JEFFERSON,6/2/2020,33,20,0,53
JEFFERSON,6/3/2020,33,20,0,53
JEFFERSON,6/4/2020,35,20,0,55
JEFFERSON,6/5/2020,36,21,0,57
JEFFERSON,6/6/2020,37,21,0,58
JEFFERSON,6/7/2020,37,21,0,58
JEFFERSON,6/8/2020,38,22,0,60
JEFFERSON,6/9/2020,39,23,0,62
JEFFERSON,6/10/2020,40,24,0,64
JEFFERSON,6/11/2020,40,24,0,64
JEFFERSON,6/12/2020,44,25,0,69
JEFFERSON,6/13/2020,45,25,0,70
JEFFERSON,6/14/2020,46,25,0,71
JEFFERSON,6/15/2020,47,25,0,72
JEFFERSON,6/16/2020,51,26,0,77
JEFFERSON,6/17/2020,55,27,0,82
JEFFERSON,6/18/2020,56,27,0,83
JEFFERSON,6/19/2020,59,28,0,87
JEFFERSON,6/20/2020,60,30,0,90
JEFFERSON,6/21/2020,64,32,0,96
JEFFERSON,6/22/2020,67,35,0,102
JEFFERSON,6/23/2020,75,41,0,116
JEFFERSON,6/24/2020,80,44,0,124
JEFFERSON,6/25/2020,85,54,0,139
JEFFERSON,6/26/2020,87,58,0,145
JEFFERSON,6/27/2020,92,59,0,151
JEFFERSON,6/28/2020,97,61,0,158
JEFFERSON,6/29/2020,100,65,0,165
JEFFERSON,6/30/2020,103,68,1,172
JEFFERSON,7/1/2020,119,74,1,194
JEFFERSON,7/2/2020,127,81,1,209
JEFFERSON,7/3/2020,129,84,1,214
JEFFERSON,7/4/2020,132,85,1,218
JEFFERSON,7/5/2020,138,85,2,225
JEFFERSON,7/6/2020,146,89,2,237
JEFFERSON,7/7/2020,154,93,2,249
JEFFERSON,7/8/2020,161,94,2,257
JEFFERSON,7/9/2020,167,99,3,269
JEFFERSON,7/10/2020,175,106,4,285
JEFFERSON,7/11/2020,178,108,4,290
JEFFERSON,7/12/2020,186,112,4,302
JEFFERSON,7/13/2020,198,120,4,322
JEFFERSON,7/14/2020,205,129,4,338
JEFFERSON,7/15/2020,215,131,4,350
JEFFERSON,7/16/2020,222,138,5,365
JEFFERSON,7/17/2020,225,143,5,373
JEFFERSON,7/18/2020,230,147,5,382
JEFFERSON,7/19/2020,233,148,5,386
JEFFERSON,7/20/2020,239,154,5,398
JEFFERSON,7/21/2020,240,157,5,402
JEFFERSON,7/22/2020,244,161,5,410
JEFFERSON,7/23/2020,254,166,5,425
JEFFERSON,7/24/2020,259,166,5,430
JEFFERSON,7/25/2020,263,171,5,439
JEFFERSON,7/26/2020,266,171,5,442
JEFFERSON,7/27/2020,273,176,5,454
JEFFERSON,7/28/2020,280,185,5,470
JEFFERSON,7/29/2020,289,188,5,482
JEFFERSON,7/30/2020,299,192,5,496
JEFFERSON,7/31/2020,303,198,5,506
JEFFERSON,8/1/2020,307,200,5,512
JEFFERSON,8/2/2020,308,200,5,513
JEFFERSON,8/3/2020,314,204,5,523
JEFFERSON,8/4/2020,318,205,5,528
JEFFERSON,8/5/2020,321,210,5,536
JEFFERSON,8/6/2020,327,212,6,545
JEFFERSON,8/7/2020,327,223,6,556
JEFFERSON,8/8/2020,330,224,6,560
JEFFERSON,8/9/2020,331,224,6,561
JEFFERSON,8/10/2020,334,228,6,568
JEFFERSON,8/11/2020,336,234,6,576
JEFFERSON,8/12/2020,339,237,6,582
JEFFERSON,8/13/2020,345,246,6,597
JEFFERSON,8/14/2020,347,250,6,603
JEFFERSON,8/15/2020,349,251,6,606
JEFFERSON,8/16/2020,351,253,6,610
JEFFERSON,8/17/2020,357,254,6,617
JEFFERSON,8/18/2020,359,254,6,619
JEFFERSON,8/19/2020,360,255,6,621
JEFFERSON,8/20/2020,369,259,6,634
JEFFERSON,8/21/2020,372,261,6,639
JEFFERSON,8/22/2020,372,262,6,640
JEFFERSON,8/23/2020,376,263,6,645
JEFFERSON,8/24/2020,379,265,6,650
JEFFERSON,8/25/2020,384,268,6,658
JEFFERSON,8/26/2020,390,272,6,668
JEFFERSON,8/27/2020,396,278,6,680
JEFFERSON,8/28/2020,401,280,6,687
JEFFERSON,8/29/2020,404,284,6,694
JEFFERSON,8/30/2020,410,287,6,703
JEFFERSON,8/31/2020,417,291,6,714
JEFFERSON,9/1/2020,420,295,6,721
JEFFERSON,9/2/2020,423,298,6,727
JEFFERSON,9/3/2020,425,305,6,736
JEFFERSON,9/4/2020,427,307,6,740
JEFFERSON,9/5/2020,430,308,6,744
JEFFERSON,9/6/2020,432,309,6,747
JEFFERSON,9/7/2020,436,309,6,751
JEFFERSON,9/8/2020,438,309,6,753
JEFFERSON,9/9/2020,440,312,6,758
JEFFERSON,9/10/2020,443,313,6,762
JEFFERSON,9/11/2020,443,314,6,763
JEFFERSON,9/12/2020,445,316,6,767
JEFFERSON,9/13/2020,446,316,6,768
JEFFERSON,9/14/2020,447,318,6,771
JEFFERSON,9/15/2020,449,320,6,775
JEFFERSON,9/16/2020,452,320,6,778
JEFFERSON,9/17/2020,453,321,6,780
JEFFERSON,9/18/2020,457,322,6,785
JEFFERSON,9/19/2020,458,323,6,787
JEFFERSON,9/20/2020,459,324,6,789
JEFFERSON,9/21/2020,461,325,6,792
JEFFERSON,9/22/2020,463,327,6,796
JEFFERSON,9/23/2020,466,329,6,801
JEFFERSON,9/24/2020,468,330,6,804
JEFFERSON,9/25/2020,470,331,6,807
JEFFERSON,9/26/2020,471,332,6,809
JEFFERSON,9/27/2020,472,335,6,813
JEFFERSON,9/28/2020,473,337,6,816
JEFFERSON,9/29/2020,475,337,6,818
JEFFERSON,9/30/2020,475,338,6,819
JEFFERSON,10/1/2020,475,340,6,821
JEFFERSON,10/2/2020,475,341,6,822
JEFFERSON,10/3/2020,476,341,6,823
JEFFERSON,10/4/2020,477,341,6,824
JEFFERSON,10/5/2020,479,341,6,826
JEFFERSON,10/6/2020,480,342,6,828
JEFFERSON,10/7/2020,481,343,6,830
JEFFERSON,10/8/2020,481,343,6,830
JEFFERSON,10/9/2020,481,343,6,830
JEFFERSON,10/10/2020,481,343,6,830
JEFFERSON,10/11/2020,481,344,6,831
JEFFERSON,10/12/2020,482,344,6,832
JEFFERSON,10/13/2020,482,344,6,832
JEFFERSON,10/14/2020,482,345,6,833
JEFFERSON,10/15/2020,483,346,6,835
JEFFERSON,10/16/2020,485,346,6,837
JEFFERSON,10/17/2020,485,346,6,837
JEFFERSON,10/18/2020,485,346,6,837
JEFFERSON,10/19/2020,485,346,6,837
JEFFERSON,10/20/2020,485,346,6,837
WALTON,1/1/2020,0,0,0,0
WALTON,1/2/2020,0,0,0,0
WALTON,1/3/2020,0,0,0,0
WALTON,1/4/2020,0,0,0,0
WALTON,1/5/2020,0,0,0,0
WALTON,1/6/2020,0,0,0,0
WALTON,1/7/2020,0,0,0,0
WALTON,1/8/2020,0,0,0,0
WALTON,1/9/2020,0,0,0,0
WALTON,1/10/2020,0,0,0,0
WALTON,1/11/2020,0,0,0,0
WALTON,1/12/2020,0,0,0,0
WALTON,1/13/2020,0,0,0,0
WALTON,1/14/2020,0,0,0,0
WALTON,1/15/2020,0,0,0,0
WALTON,1/16/2020,0,0,0,0
WALTON,1/17/2020,0,0,0,0
WALTON,1/18/2020,0,0,0,0
WALTON,1/19/2020,0,0,0,0
WALTON,1/20/2020,0,0,0,0
WALTON,1/21/2020,0,0,0,0
WALTON,1/22/2020,0,0,0,0
WALTON,1/23/2020,0,0,0,0
WALTON,1/24/2020,0,0,0,0
WALTON,1/25/2020,0,0,0,0
WALTON,1/26/2020,0,0,0,0
WALTON,1/27/2020,0,0,0,0
WALTON,1/28/2020,0,0,0,0
WALTON,1/29/2020,0,0,0,0
WALTON,1/30/2020,0,0,0,0
WALTON,1/31/2020,0,0,0,0
WALTON,2/1/2020,0,0,0,0
WALTON,2/2/2020,0,0,0,0
WALTON,2/3/2020,0,0,0,0
WALTON,2/4/2020,0,0,0,0
WALTON,2/5/2020,0,0,0,0
WALTON,2/6/2020,0,0,0,0
WALTON,2/7/2020,0,0,0,0
WALTON,2/8/2020,0,0,0,0
WALTON,2/9/2020,0,0,0,0
WALTON,2/10/2020,0,0,0,0
WALTON,2/11/2020,0,0,0,0
WALTON,2/12/2020,0,0,0,0
WALTON,2/13/2020,0,0,0,0
WALTON,2/14/2020,1,0,0,1
WALTON,2/15/2020,1,0,0,1
WALTON,2/16/2020,1,0,0,1
WALTON,2/17/2020,1,0,0,1
WALTON,2/18/2020,1,0,0,1
WALTON,2/19/2020,1,0,0,1
WALTON,2/20/2020,1,0,0,1
WALTON,2/21/2020,2,0,0,2
WALTON,2/22/2020,2,0,0,2
WALTON,2/23/2020,2,0,0,2
WALTON,2/24/2020,2,0,0,2
WALTON,2/25/2020,2,0,0,2
WALTON,2/26/2020,2,0,0,2
WALTON,2/27/2020,2,1,0,3
WALTON,2/28/2020,2,1,0,3
WALTON,2/29/2020,2,1,0,3
WALTON,3/1/2020,2,2,0,4
WALTON,3/2/2020,2,3,0,5
WALTON,3/3/2020,2,3,0,5
WALTON,3/4/2020,2,3,0,5
WALTON,3/5/2020,2,3,0,5
WALTON,3/6/2020,2,3,0,5
WALTON,3/7/2020,2,3,0,5
WALTON,3/8/2020,2,3,0,5
WALTON,3/9/2020,2,3,0,5
WALTON,3/10/2020,2,3,0,5
WALTON,3/11/2020,2,3,0,5
WALTON,3/12/2020,3,3,0,6
WALTON,3/13/2020,3,3,0,6
WALTON,3/14/2020,4,3,0,7
WALTON,3/15/2020,4,4,0,8
WALTON,3/16/2020,6,4,0,10
WALTON,3/17/2020,8,4,0,12
WALTON,3/18/2020,8,4,0,12
WALTON,3/19/2020,9,4,0,13
WALTON,3/20/2020,13,5,0,18
WALTON,3/21/2020,13,6,0,19
WALTON,3/22/2020,14,7,0,21
WALTON,3/23/2020,16,7,0,23
WALTON,3/24/2020,17,7,0,24
WALTON,3/25/2020,17,10,0,27
WALTON,3/26/2020,17,13,0,30
WALTON,3/27/2020,18,13,0,31
WALTON,3/28/2020,18,13,0,31
WALTON,3/29/2020,18,13,0,31
WALTON,3/30/2020,21,14,0,35
WALTON,3/31/2020,23,15,0,38
WALTON,4/1/2020,23,18,0,41
WALTON,4/2/2020,26,19,0,45
WALTON,4/3/2020,27,19,0,46
WALTON,4/4/2020,28,19,0,47
WALTON,4/5/2020,29,20,0,49
WALTON,4/6/2020,29,24,0,53
WALTON,4/7/2020,33,24,0,57
WALTON,4/8/2020,35,26,0,61
WALTON,4/9/2020,38,28,0,66
WALTON,4/10/2020,44,29,0,73
WALTON,4/11/2020,45,31,0,76
WALTON,4/12/2020,46,31,0,77
WALTON,4/13/2020,47,31,0,78
WALTON,4/14/2020,49,32,0,81
WALTON,4/15/2020,51,32,0,83
WALTON,4/16/2020,52,32,0,84
WALTON,4/17/2020,59,36,0,95
WALTON,4/18/2020,60,36,0,96
WALTON,4/19/2020,61,36,0,97
WALTON,4/20/2020,62,39,0,101
WALTON,4/21/2020,64,39,0,103
WALTON,4/22/2020,68,40,0,108
WALTON,4/23/2020,77,41,0,118
WALTON,4/24/2020,83,42,0,125
WALTON,4/25/2020,85,43,0,128
WALTON,4/26/2020,87,43,0,130
WALTON,4/27/2020,90,44,0,134
WALTON,4/28/2020,94,44,0,138
WALTON,4/29/2020,96,44,0,140
WALTON,4/30/2020,97,46,1,144
WALTON,5/1/2020,101,48,1,150
WALTON,5/2/2020,101,48,1,150
WALTON,5/3/2020,101,48,1,150
WALTON,5/4/2020,106,48,1,155
WALTON,5/5/2020,106,48,1,155
WALTON,5/6/2020,108,48,1,157
WALTON,5/7/2020,108,48,1,157
WALTON,5/8/2020,111,48,1,160
WALTON,5/9/2020,117,53,1,171
WALTON,5/10/2020,117,55,1,173
WALTON,5/11/2020,124,58,1,183
WALTON,5/12/2020,127,62,1,190
WALTON,5/13/2020,128,63,1,192
WALTON,5/14/2020,129,64,1,194
WALTON,5/15/2020,136,65,1,202
WALTON,5/16/2020,137,67,1,205
WALTON,5/17/2020,140,70,1,211
WALTON,5/18/2020,151,74,1,226
WALTON,5/19/2020,161,75,1,237
WALTON,5/20/2020,163,78,1,242
WALTON,5/21/2020,166,79,1,246
WALTON,5/22/2020,174,82,1,257
WALTON,5/23/2020,174,82,1,257
WALTON,5/24/2020,175,83,1,259
WALTON,5/25/2020,176,87,1,264
WALTON,5/26/2020,180,91,1,272
WALTON,5/27/2020,186,92,1,279
WALTON,5/28/2020,191,94,1,286
WALTON,5/29/2020,192,97,1,290
WALTON,5/30/2020,195,100,1,296
WALTON,5/31/2020,195,101,1,297
WALTON,6/1/2020,196,103,1,300
WALTON,6/2/2020,202,103,1,306
WALTON,6/3/2020,202,104,1,307
WALTON,6/4/2020,210,105,1,316
WALTON,6/5/2020,212,105,1,318
WALTON,6/6/2020,216,105,1,322
WALTON,6/7/2020,217,106,1,324
WALTON,6/8/2020,224,107,1,332
WALTON,6/9/2020,228,109,1,338
WALTON,6/10/2020,230,111,1,342
WALTON,6/11/2020,232,112,1,345
WALTON,6/12/2020,233,112,1,346
WALTON,6/13/2020,234,113,1,348
WALTON,6/14/2020,234,116,1,351
WALTON,6/15/2020,238,121,1,360
WALTON,6/16/2020,242,124,1,367
WALTON,6/17/2020,244,127,1,372
WALTON,6/18/2020,245,133,1,379
WALTON,6/19/2020,250,139,1,390
WALTON,6/20/2020,259,141,1,401
WALTON,6/21/2020,261,144,1,406
WALTON,6/22/2020,267,147,1,415
WALTON,6/23/2020,271,155,1,427
WALTON,6/24/2020,276,157,2,435
WALTON,6/25/2020,282,160,2,444
WALTON,6/26/2020,293,164,2,459
WALTON,6/27/2020,298,167,3,468
WALTON,6/28/2020,302,173,3,478
WALTON,6/29/2020,316,181,5,502
WALTON,6/30/2020,327,191,6,524
WALTON,7/1/2020,340,199,7,546
WALTON,7/2/2020,348,202,7,557
WALTON,7/3/2020,357,205,9,571
WALTON,7/4/2020,362,210,9,581
WALTON,7/5/2020,369,213,9,591
WALTON,7/6/2020,384,219,9,612
WALTON,7/7/2020,391,233,9,633
WALTON,7/8/2020,403,242,9,654
WALTON,7/9/2020,422,254,9,685
WALTON,7/10/2020,436,260,9,705
WALTON,7/11/2020,445,263,9,717
WALTON,7/12/2020,455,264,9,728
WALTON,7/13/2020,462,275,9,746
WALTON,7/14/2020,472,282,9,763
WALTON,7/15/2020,481,287,9,777
WALTON,7/16/2020,491,298,9,798
WALTON,7/17/2020,510,308,11,829
WALTON,7/18/2020,517,313,11,841
WALTON,7/19/2020,524,318,12,854
WALTON,7/20/2020,541,333,12,886
WALTON,7/21/2020,564,345,12,921
WALTON,7/22/2020,579,359,12,950
WALTON,7/23/2020,591,368,12,971
WALTON,7/24/2020,620,390,12,1022
WALTON,7/25/2020,630,400,12,1042
WALTON,7/26/2020,641,404,12,1057
WALTON,7/27/2020,656,417,12,1085
WALTON,7/28/2020,668,432,12,1112
WALTON,7/29/2020,677,448,12,1137
WALTON,7/30/2020,684,462,13,1159
WALTON,7/31/2020,699,470,13,1182
WALTON,8/1/2020,707,476,13,1196
WALTON,8/2/2020,715,480,14,1209
WALTON,8/3/2020,720,489,14,1223
WALTON,8/4/2020,729,497,14,1240
WALTON,8/5/2020,746,504,14,1264
WALTON,8/6/2020,758,512,15,1285
WALTON,8/7/2020,766,518,15,1299
WALTON,8/8/2020,773,524,15,1312
WALTON,8/9/2020,776,527,15,1318
WALTON,8/10/2020,789,533,15,1337
WALTON,8/11/2020,799,540,15,1354
WALTON,8/12/2020,813,543,15,1371
WALTON,8/13/2020,820,550,15,1385
BACON,9/13/2020,299,281,8,588
BACON,9/14/2020,300,283,8,591
BACON,9/15/2020,301,284,8,593
BACON,9/16/2020,304,284,8,596
BACON,9/17/2020,305,285,8,598
BACON,9/18/2020,307,285,8,600
BACON,9/19/2020,307,285,8,600
BACON,9/20/2020,307,285,8,600
BACON,9/21/2020,309,285,8,602
BACON,9/22/2020,309,285,8,602
BACON,9/23/2020,309,285,8,602
BACON,9/24/2020,311,285,8,604
BACON,9/25/2020,312,285,8,605
BACON,9/26/2020,312,287,8,607
BACON,9/27/2020,313,288,8,609
BACON,9/28/2020,313,288,8,609
BACON,9/29/2020,316,290,8,614
BACON,9/30/2020,316,290,8,614
BACON,10/1/2020,316,292,8,616
BACON,10/2/2020,317,292,8,617
BACON,10/3/2020,317,294,8,619
BACON,10/4/2020,317,294,8,619
BACON,10/5/2020,318,296,8,622
BACON,10/6/2020,319,296,8,623
BACON,10/7/2020,319,298,8,625
BACON,10/8/2020,319,300,8,627
BACON,10/9/2020,319,300,8,627
BACON,10/10/2020,319,301,8,628
BACON,10/11/2020,320,301,8,629
BACON,10/12/2020,322,302,8,632
BACON,10/13/2020,322,302,8,632
BACON,10/14/2020,322,302,8,632
BACON,10/15/2020,322,302,8,632
BACON,10/16/2020,322,302,8,632
BACON,10/17/2020,322,302,8,632
BACON,10/18/2020,322,302,8,632
BACON,10/19/2020,322,302,8,632
BACON,10/20/2020,322,302,8,632
BAKER,1/1/2020,0,0,0,0
BAKER,1/2/2020,0,0,0,0
BAKER,1/3/2020,0,0,0,0
BAKER,1/4/2020,0,0,0,0
BAKER,1/5/2020,0,0,0,0
BAKER,1/6/2020,0,0,0,0
BAKER,1/7/2020,0,0,0,0
BAKER,1/8/2020,0,0,0,0
BAKER,1/9/2020,0,0,0,0
BAKER,1/10/2020,0,0,0,0
BAKER,1/11/2020,0,0,0,0
BAKER,1/12/2020,0,0,0,0
BAKER,1/13/2020,0,0,0,0
BAKER,1/14/2020,0,0,0,0
BAKER,1/15/2020,0,0,0,0
BAKER,1/16/2020,0,0,0,0
BAKER,1/17/2020,0,0,0,0
BAKER,1/18/2020,0,0,0,0
BAKER,1/19/2020,0,0,0,0
BAKER,1/20/2020,0,0,0,0
BAKER,1/21/2020,0,0,0,0
BAKER,1/22/2020,0,0,0,0
BAKER,1/23/2020,0,0,0,0
BAKER,1/24/2020,0,0,0,0
BAKER,1/25/2020,0,0,0,0
BAKER,1/26/2020,0,0,0,0
BAKER,1/27/2020,0,0,0,0
BAKER,1/28/2020,0,0,0,0
BAKER,1/29/2020,0,0,0,0
BAKER,1/30/2020,0,0,0,0
BAKER,1/31/2020,0,0,0,0
BAKER,2/1/2020,0,0,0,0
BAKER,2/2/2020,0,0,0,0
BAKER,2/3/2020,0,0,0,0
BAKER,2/4/2020,0,0,0,0
BAKER,2/5/2020,0,0,0,0
BAKER,2/6/2020,0,0,0,0
BAKER,2/7/2020,0,0,0,0
BAKER,2/8/2020,0,0,0,0
BAKER,2/9/2020,0,0,0,0
BAKER,2/10/2020,0,0,0,0
BAKER,2/11/2020,0,0,0,0
BAKER,2/12/2020,0,0,0,0
BAKER,2/13/2020,0,0,0,0
BAKER,2/14/2020,0,0,0,0
BAKER,2/15/2020,0,0,0,0
BAKER,2/16/2020,0,0,0,0
BAKER,2/17/2020,0,0,0,0
BAKER,2/18/2020,0,0,0,0
BAKER,2/19/2020,0,0,0,0
BAKER,2/20/2020,0,0,0,0
BAKER,2/21/2020,0,0,0,0
BAKER,2/22/2020,0,0,0,0
BAKER,2/23/2020,0,0,0,0
BAKER,2/24/2020,0,0,0,0
BAKER,2/25/2020,0,0,0,0
BAKER,2/26/2020,0,0,0,0
BAKER,2/27/2020,0,0,0,0
BAKER,2/28/2020,0,0,0,0
BAKER,2/29/2020,0,0,0,0
BAKER,3/1/2020,0,0,0,0
BAKER,3/2/2020,0,0,0,0
BAKER,3/3/2020,0,0,0,0
BAKER,3/4/2020,0,0,0,0
BAKER,3/5/2020,0,0,0,0
BAKER,3/6/2020,0,0,0,0
BAKER,3/7/2020,0,0,0,0
BAKER,3/8/2020,0,0,0,0
BAKER,3/9/2020,0,0,0,0
BAKER,3/10/2020,0,0,0,0
BAKER,3/11/2020,0,1,0,1
BAKER,3/12/2020,0,1,0,1
BAKER,3/13/2020,1,1,0,2
BAKER,3/14/2020,1,1,0,2
BAKER,3/15/2020,1,1,0,2
BAKER,3/16/2020,1,2,0,3
BAKER,3/17/2020,1,3,0,4
BAKER,3/18/2020,1,4,0,5
BAKER,3/19/2020,1,4,0,5
BAKER,3/20/2020,1,4,0,5
BAKER,3/21/2020,1,4,0,5
BAKER,3/22/2020,1,4,0,5
BAKER,3/23/2020,1,5,0,6
BAKER,3/24/2020,1,5,0,6
BAKER,3/25/2020,1,5,0,6
BAKER,3/26/2020,2,6,0,8
BAKER,3/27/2020,2,6,0,8
BAKER,3/28/2020,2,6,0,8
BAKER,3/29/2020,2,6,0,8
BAKER,3/30/2020,4,6,0,10
BAKER,3/31/2020,4,6,0,10
BAKER,4/1/2020,5,7,0,12
BAKER,4/2/2020,7,8,0,15
BAKER,4/3/2020,7,9,0,16
BAKER,4/4/2020,8,9,0,17
BAKER,4/5/2020,8,9,0,17
BAKER,4/6/2020,8,9,0,17
BAKER,4/7/2020,8,9,0,17
BAKER,4/8/2020,8,9,0,17
BAKER,4/9/2020,9,10,0,19
BAKER,4/10/2020,11,10,0,21
BAKER,4/11/2020,11,10,0,21
BAKER,4/12/2020,11,10,0,21
BAKER,4/13/2020,11,10,0,21
BAKER,4/14/2020,11,10,0,21
BAKER,4/15/2020,11,10,0,21
BAKER,4/16/2020,11,10,0,21
BAKER,4/17/2020,12,10,0,22
BAKER,4/18/2020,12,10,0,22
BAKER,4/19/2020,12,10,0,22
BAKER,4/20/2020,13,11,0,24
BAKER,4/21/2020,13,11,0,24
BAKER,4/22/2020,14,12,0,26
BAKER,4/23/2020,14,12,0,26
BAKER,4/24/2020,15,12,0,27
BAKER,4/25/2020,15,12,0,27
BAKER,4/26/2020,15,12,0,27
BAKER,4/27/2020,15,12,0,27
BAKER,4/28/2020,15,12,0,27
BAKER,4/29/2020,16,12,0,28
BAKER,4/30/2020,16,12,0,28
BAKER,5/1/2020,17,13,0,30
BAKER,5/2/2020,17,13,0,30
BAKER,5/3/2020,18,14,0,32
BAKER,5/4/2020,19,16,0,35
BAKER,5/5/2020,19,16,0,35
BAKER,5/6/2020,20,16,0,36
BAKER,5/7/2020,20,16,0,36
BAKER,5/8/2020,20,16,0,36
BAKER,5/9/2020,20,16,0,36
BAKER,5/10/2020,20,16,0,36
BAKER,5/11/2020,20,16,0,36
BAKER,5/12/2020,20,16,0,36
BAKER,5/13/2020,20,16,0,36
BAKER,5/14/2020,20,17,0,37
BAKER,5/15/2020,20,17,0,37
BAKER,5/16/2020,20,17,0,37
BAKER,5/17/2020,20,18,0,38
BAKER,5/18/2020,20,18,0,38
BAKER,5/19/2020,20,18,0,38
BAKER,5/20/2020,20,18,0,38
BAKER,5/21/2020,20,18,0,38
BAKER,5/22/2020,20,18,0,38
BAKER,5/23/2020,20,18,0,38
BAKER,5/24/2020,20,18,0,38
BAKER,5/25/2020,20,18,0,38
BAKER,5/26/2020,20,18,0,38
BAKER,5/27/2020,20,18,0,38
BAKER,5/28/2020,20,18,0,38
BAKER,5/29/2020,20,18,0,38
BAKER,5/30/2020,20,18,0,38
BAKER,5/31/2020,20,18,0,38
BAKER,6/1/2020,20,18,0,38
BAKER,6/2/2020,20,18,0,38
BAKER,6/3/2020,20,18,0,38
BAKER,6/4/2020,20,18,0,38
BAKER,6/5/2020,20,18,0,38
BAKER,6/6/2020,20,18,0,38
BAKER,6/7/2020,20,18,0,38
BAKER,6/8/2020,20,18,0,38
BAKER,6/9/2020,20,18,0,38
BAKER,6/10/2020,20,18,0,38
BAKER,6/11/2020,20,18,0,38
BAKER,6/12/2020,20,18,0,38
BAKER,6/13/2020,20,18,0,38
BAKER,6/14/2020,20,18,0,38
BAKER,6/15/2020,21,18,0,39
BAKER,6/16/2020,21,18,0,39
BAKER,6/17/2020,21,18,0,39
BAKER,6/18/2020,21,18,0,39
BAKER,6/19/2020,23,20,0,43
BAKER,6/20/2020,23,22,0,45
BAKER,6/21/2020,23,22,0,45
BAKER,6/22/2020,23,22,0,45
BAKER,6/23/2020,24,22,0,46
BAKER,6/24/2020,24,22,0,46
BAKER,6/25/2020,24,22,0,46
BAKER,6/26/2020,24,22,0,46
BAKER,6/27/2020,24,22,0,46
BAKER,6/28/2020,24,22,0,46
BAKER,6/29/2020,24,22,0,46
BAKER,6/30/2020,24,22,0,46
BAKER,7/1/2020,24,22,0,46
BAKER,7/2/2020,24,23,0,47
BAKER,7/3/2020,24,23,0,47
BAKER,7/4/2020,24,23,0,47
BAKER,7/5/2020,24,23,0,47
BAKER,7/6/2020,24,24,0,48
BAKER,7/7/2020,24,24,0,48
BAKER,7/8/2020,24,25,0,49
BAKER,7/9/2020,24,25,0,49
BAKER,7/10/2020,24,25,0,49
BAKER,7/11/2020,24,25,0,49
BAKER,7/12/2020,24,25,0,49
BAKER,7/13/2020,24,27,0,51
BAKER,7/14/2020,25,27,0,52
BAKER,7/15/2020,26,27,0,53
BAKER,7/16/2020,26,28,0,54
BAKER,7/17/2020,26,28,0,54
BAKER,7/18/2020,26,28,0,54
BAKER,7/19/2020,26,28,0,54
BAKER,7/20/2020,26,28,0,54
BAKER,7/21/2020,28,29,0,57
BAKER,7/22/2020,28,29,0,57
BAKER,7/23/2020,28,31,0,59
BAKER,7/24/2020,28,32,0,60
BAKER,7/25/2020,28,32,0,60
BAKER,7/26/2020,28,33,0,61
BAKER,7/27/2020,28,34,0,62
BAKER,7/28/2020,29,34,0,63
BAKER,7/29/2020,29,34,0,63
BAKER,7/30/2020,29,34,0,63
BAKER,7/31/2020,29,34,0,63
BAKER,8/1/2020,30,34,0,64
BAKER,8/2/2020,30,34,0,64
BAKER,8/3/2020,31,35,0,66
BAKER,8/4/2020,31,35,0,66
BAKER,8/5/2020,31,35,0,66
BAKER,8/6/2020,34,35,0,69
BAKER,8/7/2020,34,35,0,69
BAKER,8/8/2020,34,35,0,69
BAKER,8/9/2020,34,35,0,69
BAKER,8/10/2020,35,35,0,70
BAKER,8/11/2020,36,35,0,71
BAKER,8/12/2020,36,36,0,72
BAKER,8/13/2020,36,36,0,72
BAKER,8/14/2020,36,36,0,72
BAKER,8/15/2020,36,37,0,73
BAKER,8/16/2020,36,37,0,73
BAKER,8/17/2020,36,37,0,73
BAKER,8/18/2020,36,37,0,73
BAKER,8/19/2020,36,37,0,73
BAKER,8/20/2020,37,37,0,74
BAKER,8/21/2020,37,37,0,74
BAKER,8/22/2020,37,37,0,74
BAKER,8/23/2020,37,37,0,74
BAKER,8/24/2020,37,37,0,74
BAKER,8/25/2020,38,37,0,75
BAKER,8/26/2020,38,37,0,75
BAKER,8/27/2020,38,37,0,75
BAKER,8/28/2020,38,37,0,75
BAKER,8/29/2020,38,37,0,75
BAKER,8/30/2020,38,37,0,75
BAKER,8/31/2020,38,37,0,75
BAKER,9/1/2020,38,37,0,75
BAKER,9/2/2020,39,37,0,76
BAKER,9/3/2020,39,37,0,76
BAKER,9/4/2020,39,37,0,76
BAKER,9/5/2020,39,38,0,77
BAKER,9/6/2020,39,38,0,77
BAKER,9/7/2020,39,38,0,77
BAKER,9/8/2020,39,39,0,78
BAKER,9/9/2020,40,39,0,79
BAKER,9/10/2020,40,39,0,79
BAKER,9/11/2020,41,39,0,80
BAKER,9/12/2020,41,39,0,80
BAKER,9/13/2020,41,39,0,80
BAKER,9/14/2020,41,40,0,81
BAKER,9/15/2020,41,40,0,81
BAKER,9/16/2020,41,41,0,82
BAKER,9/17/2020,42,42,0,84
BAKER,9/18/2020,42,42,0,84
BAKER,9/19/2020,42,42,0,84
BAKER,9/20/2020,42,42,0,84
BAKER,9/21/2020,42,43,0,85
BAKER,9/22/2020,42,43,0,85
BAKER,9/23/2020,42,43,0,85
BAKER,9/24/2020,42,44,0,86
BAKER,9/25/2020,42,44,0,86
BAKER,9/26/2020,42,44,0,86
BAKER,9/27/2020,42,44,0,86
BAKER,9/28/2020,42,44,0,86
BAKER,9/29/2020,42,44,0,86
BAKER,9/30/2020,42,44,0,86
BAKER,10/1/2020,42,44,0,86
BAKER,10/2/2020,42,44,0,86
BAKER,10/3/2020,42,44,0,86
BAKER,10/4/2020,42,44,0,86
BAKER,10/5/2020,42,44,0,86
BAKER,10/6/2020,42,44,0,86
BAKER,10/7/2020,42,44,0,86
BAKER,10/8/2020,42,44,0,86
BAKER,10/9/2020,42,44,0,86
BAKER,10/10/2020,42,44,0,86
BAKER,10/11/2020,42,45,0,87
BAKER,10/12/2020,43,45,0,88
BAKER,10/13/2020,43,45,0,88
BAKER,10/14/2020,43,45,0,88
BAKER,10/15/2020,43,45,0,88
BAKER,10/16/2020,43,45,0,88
BAKER,10/17/2020,43,45,0,88
BAKER,10/18/2020,43,45,0,88
BAKER,10/19/2020,43,45,0,88
BAKER,10/20/2020,43,45,0,88
BANKS,1/1/2020,0,0,0,0
BANKS,1/2/2020,0,0,0,0
BANKS,1/3/2020,0,0,0,0
BANKS,1/4/2020,0,0,0,0
BANKS,1/5/2020,0,0,0,0
BANKS,1/6/2020,0,0,0,0
BANKS,1/7/2020,0,0,0,0
BANKS,1/8/2020,0,0,0,0
BANKS,1/9/2020,0,0,0,0
BANKS,1/10/2020,0,0,0,0
BANKS,1/11/2020,0,0,0,0
BANKS,1/12/2020,0,0,0,0
BANKS,1/13/2020,0,0,0,0
BANKS,1/14/2020,0,0,0,0
BANKS,1/15/2020,0,0,0,0
BANKS,1/16/2020,0,0,0,0
BANKS,1/17/2020,0,0,0,0
BANKS,1/18/2020,0,0,0,0
BANKS,1/19/2020,0,0,0,0
BANKS,1/20/2020,0,0,0,0
BANKS,1/21/2020,0,0,0,0
BANKS,1/22/2020,0,0,0,0
BANKS,1/23/2020,0,0,0,0
BANKS,1/24/2020,0,0,0,0
BANKS,1/25/2020,0,0,0,0
BANKS,1/26/2020,0,0,0,0
BANKS,1/27/2020,0,0,0,0
BANKS,1/28/2020,0,0,0,0
BANKS,1/29/2020,0,0,0,0
BANKS,1/30/2020,0,0,0,0
BANKS,1/31/2020,0,0,0,0
BANKS,2/1/2020,0,0,0,0
BANKS,2/2/2020,0,0,0,0
BANKS,2/3/2020,0,0,0,0
BANKS,2/4/2020,0,0,0,0
BANKS,2/5/2020,0,0,0,0
BANKS,2/6/2020,0,0,0,0
BANKS,2/7/2020,0,0,0,0
BANKS,2/8/2020,0,0,0,0
BANKS,2/9/2020,0,0,0,0
BANKS,2/10/2020,1,0,0,1
BANKS,2/11/2020,1,0,0,1
BANKS,2/12/2020,1,0,0,1
BANKS,2/13/2020,1,0,0,1
BANKS,2/14/2020,1,0,0,1
BANKS,2/15/2020,1,0,0,1
BANKS,2/16/2020,1,0,0,1
BANKS,2/17/2020,1,0,0,1
BANKS,2/18/2020,1,0,0,1
BANKS,2/19/2020,1,0,0,1
BANKS,2/20/2020,1,0,0,1
BANKS,2/21/2020,1,0,0,1
BANKS,2/22/2020,1,0,0,1
BANKS,2/23/2020,1,0,0,1
BANKS,2/24/2020,1,0,0,1
BANKS,2/25/2020,1,0,0,1
BANKS,2/26/2020,1,0,0,1
BANKS,2/27/2020,1,0,0,1
BANKS,2/28/2020,1,0,0,1
BANKS,2/29/2020,1,0,0,1
BANKS,3/1/2020,1,0,0,1
BANKS,3/2/2020,1,0,0,1
BLECKLEY,3/27/2020,2,0,0,2
BLECKLEY,3/28/2020,2,0,0,2
BLECKLEY,3/29/2020,2,0,0,2
BLECKLEY,3/30/2020,2,0,0,2
BLECKLEY,3/31/2020,2,0,0,2
BLECKLEY,4/1/2020,3,0,0,3
BLECKLEY,4/2/2020,3,0,0,3
BLECKLEY,4/3/2020,3,0,0,3
BLECKLEY,4/4/2020,3,0,0,3
BLECKLEY,4/5/2020,3,0,0,3
BLECKLEY,4/6/2020,3,1,0,4
BLECKLEY,4/7/2020,3,1,0,4
BLECKLEY,4/8/2020,3,1,0,4
BLECKLEY,4/9/2020,3,1,0,4
BLECKLEY,4/10/2020,3,1,0,4
BLECKLEY,4/11/2020,3,1,0,4
BLECKLEY,4/12/2020,3,1,0,4
BLECKLEY,4/13/2020,4,2,0,6
BLECKLEY,4/14/2020,4,2,0,6
BLECKLEY,4/15/2020,4,2,0,6
BLECKLEY,4/16/2020,4,2,0,6
BLECKLEY,4/17/2020,5,3,0,8
BLECKLEY,4/18/2020,6,4,0,10
BLECKLEY,4/19/2020,6,5,0,11
BLECKLEY,4/20/2020,7,5,0,12
BLECKLEY,4/21/2020,8,5,0,13
BLECKLEY,4/22/2020,8,6,0,14
BLECKLEY,4/23/2020,9,6,0,15
BLECKLEY,4/24/2020,9,6,0,15
BLECKLEY,4/25/2020,12,6,0,18
BLECKLEY,4/26/2020,12,7,0,19
BLECKLEY,4/27/2020,13,9,0,22
BLECKLEY,4/28/2020,13,9,0,22
BLECKLEY,4/29/2020,14,10,0,24
BLECKLEY,4/30/2020,14,12,0,26
BLECKLEY,5/1/2020,15,12,0,27
BLECKLEY,5/2/2020,15,12,0,27
BLECKLEY,5/3/2020,15,12,0,27
BLECKLEY,5/4/2020,15,12,0,27
BLECKLEY,5/5/2020,18,13,0,31
BLECKLEY,5/6/2020,18,13,0,31
BLECKLEY,5/7/2020,18,13,0,31
BLECKLEY,5/8/2020,19,16,0,35
BLECKLEY,5/9/2020,19,16,0,35
BLECKLEY,5/10/2020,19,16,0,35
BLECKLEY,5/11/2020,19,16,0,35
BLECKLEY,5/12/2020,20,16,0,36
BLECKLEY,5/13/2020,22,16,0,38
BLECKLEY,5/14/2020,25,18,0,43
BLECKLEY,5/15/2020,25,18,0,43
BLECKLEY,5/16/2020,26,18,0,44
BLECKLEY,5/17/2020,26,18,0,44
BLECKLEY,5/18/2020,27,18,0,45
BLECKLEY,5/19/2020,28,18,0,46
BLECKLEY,5/20/2020,28,19,0,47
BLECKLEY,5/21/2020,28,19,0,47
BLECKLEY,5/22/2020,29,19,0,48
BLECKLEY,5/23/2020,29,19,0,48
BLECKLEY,5/24/2020,29,19,0,48
BLECKLEY,5/25/2020,29,19,0,48
BLECKLEY,5/26/2020,29,20,0,49
BLECKLEY,5/27/2020,30,20,0,50
BLECKLEY,5/28/2020,30,20,0,50
BLECKLEY,5/29/2020,30,22,0,52
BLECKLEY,5/30/2020,30,22,0,52
BLECKLEY,5/31/2020,30,23,0,53
BLECKLEY,6/1/2020,30,23,0,53
BLECKLEY,6/2/2020,30,23,0,53
BLECKLEY,6/3/2020,31,23,0,54
BLECKLEY,6/4/2020,31,23,0,54
BLECKLEY,6/5/2020,32,24,0,56
BLECKLEY,6/6/2020,32,24,0,56
BLECKLEY,6/7/2020,32,25,0,57
BLECKLEY,6/8/2020,32,25,0,57
BLECKLEY,6/9/2020,32,27,0,59
BLECKLEY,6/10/2020,32,27,0,59
BLECKLEY,6/11/2020,33,27,0,60
BLECKLEY,6/12/2020,33,27,0,60
BLECKLEY,6/13/2020,33,27,0,60
BLECKLEY,6/14/2020,33,27,0,60
BLECKLEY,6/15/2020,33,27,0,60
BLECKLEY,6/16/2020,33,27,0,60
BLECKLEY,6/17/2020,35,28,0,63
BLECKLEY,6/18/2020,35,28,0,63
BLECKLEY,6/19/2020,36,28,0,64
BLECKLEY,6/20/2020,36,28,0,64
BLECKLEY,6/21/2020,37,28,0,65
BLECKLEY,6/22/2020,37,29,0,66
BLECKLEY,6/23/2020,38,29,0,67
BLECKLEY,6/24/2020,41,29,0,70
BLECKLEY,6/25/2020,41,31,0,72
BLECKLEY,6/26/2020,42,33,0,75
BLECKLEY,6/27/2020,43,34,0,77
BLECKLEY,6/28/2020,45,35,0,80
BLECKLEY,6/29/2020,47,35,0,82
BLECKLEY,6/30/2020,48,35,0,83
BLECKLEY,7/1/2020,48,37,0,85
BLECKLEY,7/2/2020,50,38,0,88
BLECKLEY,7/3/2020,50,39,0,89
BLECKLEY,7/4/2020,51,40,0,91
BLECKLEY,7/5/2020,53,41,0,94
BLECKLEY,7/6/2020,53,43,0,96
BLECKLEY,7/7/2020,55,46,0,101
BLECKLEY,7/8/2020,57,46,0,103
BLECKLEY,7/9/2020,57,47,0,104
BLECKLEY,7/10/2020,60,49,0,109
BLECKLEY,7/11/2020,60,49,0,109
BLECKLEY,7/12/2020,60,50,0,110
BLECKLEY,7/13/2020,60,51,0,111
BLECKLEY,7/14/2020,61,52,0,113
BLECKLEY,7/15/2020,63,53,0,116
BLECKLEY,7/16/2020,63,53,0,116
BLECKLEY,7/17/2020,66,53,0,119
BLECKLEY,7/18/2020,66,55,0,121
BLECKLEY,7/19/2020,66,56,0,122
BLECKLEY,7/20/2020,67,59,0,126
BLECKLEY,7/21/2020,68,60,0,128
BLECKLEY,7/22/2020,69,60,0,129
BLECKLEY,7/23/2020,70,60,0,130
BLECKLEY,7/24/2020,71,62,0,133
BLECKLEY,7/25/2020,73,65,0,138
BLECKLEY,7/26/2020,74,68,0,142
BLECKLEY,7/27/2020,75,70,0,145
BLECKLEY,7/28/2020,77,73,0,150
BLECKLEY,7/29/2020,81,78,0,159
BLECKLEY,7/30/2020,83,82,0,165
BLECKLEY,7/31/2020,95,87,0,182
BLECKLEY,8/1/2020,98,89,0,187
BLECKLEY,8/2/2020,100,89,0,189
BLECKLEY,8/3/2020,104,90,0,194
BLECKLEY,8/4/2020,149,96,6,251
BLECKLEY,8/5/2020,162,97,7,266
BLECKLEY,8/6/2020,165,97,7,269
BLECKLEY,8/7/2020,172,98,7,277
BLECKLEY,8/8/2020,173,99,7,279
BLECKLEY,8/9/2020,178,101,7,286
BLECKLEY,8/10/2020,180,101,7,288
BLECKLEY,8/11/2020,184,104,7,295
BLECKLEY,8/12/2020,189,107,7,303
BLECKLEY,8/13/2020,193,110,7,310
BLECKLEY,8/14/2020,195,111,7,313
BLECKLEY,8/15/2020,195,112,7,314
BLECKLEY,8/16/2020,198,115,7,320
BLECKLEY,8/17/2020,203,116,7,326
BLECKLEY,8/18/2020,203,116,7,326
BLECKLEY,8/19/2020,208,117,7,332
BLECKLEY,8/20/2020,211,119,8,338
BLECKLEY,8/21/2020,214,119,8,341
BLECKLEY,8/22/2020,214,119,8,341
BLECKLEY,8/23/2020,214,121,8,343
BLECKLEY,8/24/2020,217,124,8,349
BLECKLEY,8/25/2020,218,125,8,351
BLECKLEY,8/26/2020,223,129,8,360
BLECKLEY,8/27/2020,224,131,8,363
BLECKLEY,8/28/2020,226,132,8,366
BLECKLEY,8/29/2020,227,133,8,368
BLECKLEY,8/30/2020,229,136,8,373
BLECKLEY,8/31/2020,234,139,8,381
BLECKLEY,9/1/2020,238,141,8,387
BLECKLEY,9/2/2020,240,149,8,397
BLECKLEY,9/3/2020,240,150,8,398
BLECKLEY,9/4/2020,241,150,8,399
BLECKLEY,9/5/2020,243,150,8,401
BLECKLEY,9/6/2020,243,151,8,402
BLECKLEY,9/7/2020,245,153,8,406
BLECKLEY,9/8/2020,251,155,8,414
BLECKLEY,9/9/2020,252,157,8,417
BLECKLEY,9/10/2020,254,157,8,419
BLECKLEY,9/11/2020,254,158,8,420
BLECKLEY,9/12/2020,254,161,8,423
BLECKLEY,9/13/2020,254,161,8,423
BLECKLEY,9/14/2020,254,161,8,423
BLECKLEY,9/15/2020,254,161,8,423
BLECKLEY,9/16/2020,255,161,8,424
BLECKLEY,9/17/2020,255,161,8,424
BLECKLEY,9/18/2020,255,161,8,424
BLECKLEY,9/19/2020,255,161,8,424
BLECKLEY,9/20/2020,255,162,8,425
BLECKLEY,9/21/2020,256,163,8,427
BLECKLEY,9/22/2020,256,163,8,427
BLECKLEY,9/23/2020,256,163,8,427
BLECKLEY,9/24/2020,256,163,8,427
BLECKLEY,9/25/2020,258,163,8,429
BLECKLEY,9/26/2020,258,164,8,430
BLECKLEY,9/27/2020,258,165,8,431
BLECKLEY,9/28/2020,262,166,8,436
BLECKLEY,9/29/2020,262,167,8,437
BLECKLEY,9/30/2020,266,168,8,442
BLECKLEY,10/1/2020,267,168,8,443
BLECKLEY,10/2/2020,272,168,8,448
BLECKLEY,10/3/2020,273,169,8,450
BLECKLEY,10/4/2020,273,170,8,451
BLECKLEY,10/5/2020,273,173,8,454
BLECKLEY,10/6/2020,276,174,8,458
BLECKLEY,10/7/2020,280,177,8,465
BLECKLEY,10/8/2020,282,177,9,468
BLECKLEY,10/9/2020,289,184,9,482
BLECKLEY,10/10/2020,290,186,9,485
BLECKLEY,10/11/2020,293,188,9,490
BLECKLEY,10/12/2020,293,188,9,490
BLECKLEY,10/13/2020,293,188,9,490
BLECKLEY,10/14/2020,297,193,9,499
BLECKLEY,10/15/2020,297,193,9,499
BLECKLEY,10/16/2020,297,195,9,501
BLECKLEY,10/17/2020,297,195,9,501
BLECKLEY,10/18/2020,297,195,9,501
BLECKLEY,10/19/2020,297,195,9,501
BLECKLEY,10/20/2020,297,195,9,501
BRANTLEY,1/1/2020,0,0,0,0
BRANTLEY,1/2/2020,0,0,0,0
BRANTLEY,1/3/2020,0,0,0,0
BRANTLEY,1/4/2020,0,0,0,0
BRANTLEY,1/5/2020,0,0,0,0
BRANTLEY,1/6/2020,0,0,0,0
BRANTLEY,1/7/2020,0,0,0,0
BRANTLEY,1/8/2020,0,0,0,0
BRANTLEY,1/9/2020,0,0,0,0
BRANTLEY,1/10/2020,0,0,0,0
BRANTLEY,1/11/2020,0,0,0,0
BRANTLEY,1/12/2020,0,0,0,0
BRANTLEY,1/13/2020,0,0,0,0
BRANTLEY,1/14/2020,0,0,0,0
BRANTLEY,1/15/2020,0,0,0,0
BRANTLEY,1/16/2020,0,0,0,0
BRANTLEY,1/17/2020,0,0,0,0
BRANTLEY,1/18/2020,0,0,0,0
BRANTLEY,1/19/2020,0,0,0,0
BRANTLEY,1/20/2020,0,0,0,0
BRANTLEY,1/21/2020,0,0,0,0
BRANTLEY,1/22/2020,0,0,0,0
BRANTLEY,1/23/2020,0,0,0,0
BRANTLEY,1/24/2020,0,0,0,0
BRANTLEY,1/25/2020,0,0,0,0
BRANTLEY,1/26/2020,0,0,0,0
BRANTLEY,1/27/2020,0,0,0,0
BRANTLEY,1/28/2020,0,0,0,0
BRANTLEY,1/29/2020,0,0,0,0
BRANTLEY,1/30/2020,0,0,0,0
BRANTLEY,1/31/2020,0,0,0,0
BRANTLEY,2/1/2020,0,0,0,0
BRANTLEY,2/2/2020,0,0,0,0
BRANTLEY,2/3/2020,0,0,0,0
BRANTLEY,2/4/2020,0,0,0,0
BRANTLEY,2/5/2020,0,0,0,0
BRANTLEY,2/6/2020,0,0,0,0
BRANTLEY,2/7/2020,0,0,0,0
BRANTLEY,2/8/2020,0,0,0,0
BRANTLEY,2/9/2020,0,0,0,0
BRANTLEY,2/10/2020,0,0,0,0
BRANTLEY,2/11/2020,0,0,0,0
BRANTLEY,2/12/2020,0,0,0,0
BRANTLEY,2/13/2020,0,0,0,0
BRANTLEY,2/14/2020,0,0,0,0
BRANTLEY,2/15/2020,0,0,0,0
BRANTLEY,2/16/2020,0,0,0,0
BRANTLEY,2/17/2020,0,0,0,0
BRANTLEY,2/18/2020,0,0,0,0
BRANTLEY,2/19/2020,0,0,0,0
BRANTLEY,2/20/2020,0,0,0,0
BRANTLEY,2/21/2020,0,0,0,0
BRANTLEY,2/22/2020,0,0,0,0
BRANTLEY,2/23/2020,0,0,0,0
BRANTLEY,2/24/2020,0,0,0,0
BRANTLEY,2/25/2020,0,0,0,0
BRANTLEY,2/26/2020,0,0,0,0
BRANTLEY,2/27/2020,0,0,0,0
BRANTLEY,2/28/2020,0,0,0,0
BRANTLEY,2/29/2020,0,0,0,0
BRANTLEY,3/1/2020,0,0,0,0
BRANTLEY,3/2/2020,0,0,0,0
BRANTLEY,3/3/2020,0,0,0,0
BRANTLEY,3/4/2020,0,0,0,0
BRANTLEY,3/5/2020,0,0,0,0
BRANTLEY,3/6/2020,0,0,0,0
BRANTLEY,3/7/2020,0,0,0,0
BRANTLEY,3/8/2020,0,0,0,0
BRANTLEY,3/9/2020,0,1,0,1
BRANTLEY,3/10/2020,0,1,0,1
BRANTLEY,3/11/2020,0,1,0,1
BRANTLEY,3/12/2020,0,1,0,1
BRANTLEY,3/13/2020,0,1,0,1
BRANTLEY,3/14/2020,0,1,0,1
BRANTLEY,3/15/2020,0,1,0,1
BRANTLEY,3/16/2020,0,1,0,1
BRANTLEY,3/17/2020,0,1,0,1
BRANTLEY,3/18/2020,0,1,0,1
BRANTLEY,3/19/2020,0,1,0,1
BRANTLEY,3/20/2020,0,1,0,1
BRANTLEY,3/21/2020,0,1,0,1
BRANTLEY,3/22/2020,0,1,0,1
BRANTLEY,3/23/2020,0,1,0,1
BRANTLEY,3/24/2020,1,1,0,2
BRANTLEY,3/25/2020,1,1,0,2
BRANTLEY,3/26/2020,1,1,0,2
BRANTLEY,3/27/2020,1,1,0,2
BRANTLEY,3/28/2020,1,1,0,2
BRANTLEY,3/29/2020,1,1,0,2
BRANTLEY,3/30/2020,2,2,0,4
BRANTLEY,3/31/2020,3,2,0,5
BRANTLEY,4/1/2020,4,2,0,6
BRANTLEY,4/2/2020,6,2,0,8
BRANTLEY,4/3/2020,7,2,0,9
BRANTLEY,4/4/2020,7,2,0,9
BRANTLEY,4/5/2020,8,2,0,10
BRANTLEY,4/6/2020,9,2,0,11
BRANTLEY,4/7/2020,11,4,0,15
BRANTLEY,4/8/2020,12,4,0,16
BRANTLEY,4/9/2020,13,4,0,17
BRANTLEY,4/10/2020,13,5,0,18
BRANTLEY,4/11/2020,13,5,0,18
BRANTLEY,4/12/2020,13,5,0,18
BRANTLEY,4/13/2020,14,7,0,21
BRANTLEY,4/14/2020,14,7,0,21
BRANTLEY,4/15/2020,14,7,0,21
BRANTLEY,4/16/2020,16,7,0,23
BRANTLEY,4/17/2020,17,7,0,24
BRANTLEY,4/18/2020,17,7,0,24
BRANTLEY,4/19/2020,18,7,0,25
BRANTLEY,4/20/2020,19,7,0,26
BRANTLEY,4/21/2020,20,7,0,27
BRANTLEY,4/22/2020,20,7,0,27
BRANTLEY,4/23/2020,20,7,0,27
BRANTLEY,4/24/2020,21,7,0,28
BRANTLEY,4/25/2020,21,8,0,29
BRANTLEY,4/26/2020,21,8,0,29
BRANTLEY,4/27/2020,21,8,0,29
BRANTLEY,4/28/2020,21,9,0,30
BRANTLEY,4/29/2020,21,9,0,30
BRANTLEY,4/30/2020,21,9,0,30
BRANTLEY,5/1/2020,21,9,0,30
BRANTLEY,5/2/2020,21,9,0,30
BRANTLEY,5/3/2020,21,9,0,30
BRANTLEY,5/4/2020,22,9,0,31
BRANTLEY,5/5/2020,23,9,0,32
BRANTLEY,5/6/2020,24,9,0,33
BRANTLEY,5/7/2020,24,9,0,33
BRANTLEY,5/8/2020,25,10,0,35
BRANTLEY,5/9/2020,25,10,0,35
BRANTLEY,5/10/2020,26,11,0,37
BRANTLEY,5/11/2020,27,11,0,38
BRANTLEY,5/12/2020,37,13,0,50
BRANTLEY,5/13/2020,38,14,0,52
BRANTLEY,5/14/2020,39,14,0,53
BRANTLEY,5/15/2020,42,15,0,57
BRANTLEY,5/16/2020,42,15,0,57
BRANTLEY,5/17/2020,42,15,0,57
BRANTLEY,7/11/2020,111,68,1,180
BRANTLEY,5/18/2020,42,15,0,57
BRANTLEY,5/19/2020,43,15,0,58
BRANTLEY,5/20/2020,43,16,0,59
BRANTLEY,5/21/2020,43,17,0,60
BRANTLEY,5/22/2020,43,17,0,60
BRANTLEY,5/23/2020,43,18,0,61
BRANTLEY,5/24/2020,43,19,0,62
BRANTLEY,5/25/2020,43,19,0,62
BRANTLEY,5/26/2020,44,19,0,63
BRANTLEY,5/27/2020,44,20,0,64
BRANTLEY,5/28/2020,44,20,0,64
BRANTLEY,5/29/2020,44,20,0,64
BRANTLEY,5/30/2020,45,20,0,65
BRANTLEY,5/31/2020,45,20,0,65
BRANTLEY,6/1/2020,45,20,0,65
BRANTLEY,6/2/2020,46,21,0,67
BRANTLEY,6/3/2020,46,22,0,68
BRANTLEY,6/4/2020,46,22,0,68
BRANTLEY,6/5/2020,46,22,0,68
BRANTLEY,6/6/2020,47,22,0,69
BRANTLEY,6/7/2020,47,22,0,69
BRANTLEY,6/8/2020,49,23,0,72
BRANTLEY,6/9/2020,51,23,0,74
BRANTLEY,6/10/2020,51,23,0,74
BRANTLEY,6/11/2020,52,24,0,76
BRANTLEY,6/12/2020,54,24,0,78
BRANTLEY,6/13/2020,54,24,0,78
BRANTLEY,6/14/2020,54,24,0,78
BRANTLEY,6/15/2020,55,24,0,79
BRANTLEY,6/16/2020,56,24,0,80
BRANTLEY,6/17/2020,58,25,0,83
BRANTLEY,6/18/2020,60,26,0,86
BRANTLEY,6/19/2020,61,27,0,88
BRANTLEY,6/20/2020,64,30,0,94
BRANTLEY,6/21/2020,64,31,0,95
BRANTLEY,6/22/2020,64,31,0,95
BRANTLEY,6/23/2020,65,33,0,98
BRANTLEY,6/24/2020,68,34,0,102
BRANTLEY,6/25/2020,70,35,0,105
BRANTLEY,6/26/2020,74,39,0,113
BRANTLEY,6/27/2020,76,39,0,115
BRANTLEY,6/28/2020,76,39,0,115
BRANTLEY,6/29/2020,78,42,0,120
BRANTLEY,6/30/2020,82,45,0,127
BRANTLEY,7/1/2020,85,47,0,132
BRANTLEY,7/2/2020,91,49,0,140
BRANTLEY,7/3/2020,93,51,0,144
BRANTLEY,7/4/2020,93,53,0,146
BRANTLEY,7/5/2020,93,53,0,146
BRANTLEY,7/6/2020,96,55,0,151
BRANTLEY,7/7/2020,99,59,0,158
BRANTLEY,7/8/2020,102,64,1,167
BRANTLEY,7/9/2020,107,66,1,174
BRANTLEY,7/10/2020,107,66,1,174
BARROW,6/17/2020,268,198,1,467
BARTOW,10/1/2020,1629,1403,51,3083
BARROW,6/18/2020,270,202,1,473
BARROW,6/19/2020,273,206,1,480
BRANTLEY,7/12/2020,114,69,1,184
BARTOW,10/2/2020,1631,1416,51,3098
BARROW,6/20/2020,276,209,1,486
BRANTLEY,7/13/2020,115,75,1,191
BARTOW,10/3/2020,1640,1419,51,3110
BARROW,6/21/2020,281,210,1,492
BARROW,6/22/2020,286,214,1,501
BARROW,6/23/2020,293,216,2,511
BARROW,6/24/2020,301,222,4,527
BARROW,6/25/2020,306,228,5,539
BARROW,6/26/2020,310,233,6,549
BARROW,6/27/2020,315,239,6,560
BARROW,6/28/2020,319,244,7,570
BARROW,6/29/2020,332,250,9,591
BARROW,6/30/2020,337,253,9,599
BARROW,7/1/2020,341,273,9,623
BARROW,7/2/2020,356,279,10,645
BARROW,7/3/2020,363,283,10,656
BARROW,7/4/2020,367,287,10,664
BARROW,7/5/2020,374,292,10,676
BARROW,7/6/2020,389,319,11,719
BARROW,7/7/2020,403,337,11,751
BARROW,7/8/2020,427,354,12,793
BARROW,7/9/2020,445,370,14,829
BARROW,7/10/2020,469,389,14,872
BARROW,7/11/2020,478,395,14,887
BARROW,7/12/2020,494,406,14,914
BARROW,7/13/2020,516,417,14,947
BARROW,7/14/2020,532,432,14,978
BARROW,7/15/2020,543,453,14,1010
BARROW,7/16/2020,556,469,14,1039
BARROW,7/17/2020,574,479,14,1067
BARROW,7/18/2020,590,495,14,1099
BARROW,7/19/2020,598,502,15,1115
BARROW,7/20/2020,619,515,15,1149
BARROW,7/21/2020,635,529,15,1179
BARROW,7/22/2020,649,537,16,1202
BARROW,7/23/2020,666,546,16,1228
BARROW,7/24/2020,682,557,16,1255
BARROW,7/25/2020,689,566,16,1271
BARROW,7/26/2020,701,572,16,1289
BARROW,7/27/2020,720,578,16,1314
BARROW,7/28/2020,731,591,16,1338
BARROW,7/29/2020,744,602,16,1362
BARROW,7/30/2020,754,616,17,1387
BARROW,7/31/2020,770,627,17,1414
BARROW,8/1/2020,780,636,17,1433
BARROW,8/2/2020,787,641,17,1445
BARROW,8/3/2020,804,654,17,1475
BARROW,8/4/2020,814,663,17,1494
BARROW,8/5/2020,830,681,17,1528
BARROW,8/6/2020,839,688,17,1544
BARROW,8/7/2020,852,697,17,1566
BARROW,8/8/2020,852,708,17,1577
BARROW,8/9/2020,862,712,17,1591
BARROW,8/10/2020,876,724,17,1617
BARROW,8/11/2020,883,733,17,1633
BARROW,8/12/2020,896,744,17,1657
BARROW,8/13/2020,909,753,17,1679
BARROW,8/14/2020,920,757,17,1694
BARROW,8/15/2020,929,761,17,1707
BARROW,8/16/2020,937,763,17,1717
BARROW,8/17/2020,942,770,17,1729
BARROW,8/18/2020,948,772,18,1738
BARROW,8/19/2020,961,774,18,1753
BARROW,8/20/2020,969,781,18,1768
BARROW,8/21/2020,982,792,18,1792
BARROW,8/22/2020,990,798,18,1806
BARROW,8/23/2020,995,803,19,1817
BARROW,8/24/2020,1003,814,19,1836
BARROW,8/25/2020,1010,822,19,1851
BARROW,8/26/2020,1016,833,19,1868
BARROW,8/27/2020,1024,846,19,1889
BARROW,8/28/2020,1034,851,19,1904
BARROW,8/29/2020,1037,856,19,1912
BARROW,8/30/2020,1043,862,19,1924
BARROW,8/31/2020,1048,872,19,1939
BARROW,9/1/2020,1063,886,19,1968
BARROW,9/2/2020,1067,894,19,1980
BARROW,9/3/2020,1078,899,19,1996
BARROW,9/4/2020,1086,906,19,2011
BARROW,9/5/2020,1089,911,19,2019
BARROW,9/6/2020,1106,918,19,2043
BARROW,9/7/2020,1113,924,19,2056
BARROW,9/8/2020,1124,932,19,2075
BARROW,9/9/2020,1131,940,19,2090
BARROW,9/10/2020,1141,945,19,2105
BARROW,9/11/2020,1150,949,19,2118
BARROW,9/12/2020,1157,951,19,2127
BARROW,9/13/2020,1159,955,19,2133
BARROW,9/14/2020,1168,960,19,2147
BARROW,9/15/2020,1172,965,19,2156
BARROW,9/16/2020,1177,969,19,2165
BARROW,9/17/2020,1183,975,20,2178
BARROW,9/18/2020,1189,979,20,2188
BARROW,9/19/2020,1195,983,20,2198
BARROW,9/20/2020,1200,989,20,2209
BARROW,9/21/2020,1210,997,20,2227
BARROW,9/22/2020,1218,1001,20,2239
BARROW,9/23/2020,1225,1008,20,2253
BARROW,9/24/2020,1230,1011,20,2261
BARROW,9/25/2020,1240,1016,20,2276
BARROW,9/26/2020,1242,1016,20,2278
BARROW,9/27/2020,1246,1019,21,2286
BARROW,9/28/2020,1257,1026,22,2305
BARROW,9/29/2020,1265,1031,22,2318
BARROW,9/30/2020,1275,1034,22,2331
BARROW,10/1/2020,1281,1038,22,2341
BARROW,10/2/2020,1290,1045,22,2357
BARROW,10/3/2020,1297,1051,22,2370
BARROW,10/4/2020,1302,1058,22,2382
BARROW,10/5/2020,1303,1065,22,2390
BARROW,10/6/2020,1311,1070,22,2403
BARROW,10/7/2020,1317,1075,22,2414
BARROW,10/8/2020,1326,1079,22,2427
BARROW,10/9/2020,1330,1081,22,2433
BARROW,10/10/2020,1333,1089,22,2444
BARROW,10/11/2020,1339,1092,22,2453
BARROW,10/12/2020,1342,1098,22,2462
BARROW,10/13/2020,1347,1099,22,2468
BARROW,10/14/2020,1351,1102,22,2475
BARROW,10/15/2020,1359,1110,22,2491
BARROW,10/16/2020,1367,1115,22,2504
BARROW,10/17/2020,1368,1117,22,2507
BARROW,10/18/2020,1368,1117,22,2507
BARROW,10/19/2020,1368,1117,22,2507
BARROW,10/20/2020,1368,1117,22,2507
BARTOW,1/1/2020,0,0,0,0
BARTOW,1/2/2020,0,0,0,0
BARTOW,1/3/2020,0,0,0,0
BARTOW,1/4/2020,0,0,0,0
BARTOW,1/5/2020,0,0,0,0
BARTOW,1/6/2020,0,0,0,0
BARTOW,1/7/2020,0,0,0,0
BARTOW,1/8/2020,0,1,0,1
BARTOW,1/9/2020,0,1,0,1
BARTOW,1/10/2020,0,1,0,1
BARTOW,1/11/2020,0,1,0,1
BARTOW,1/12/2020,0,1,0,1
BARTOW,1/13/2020,0,1,0,1
BARTOW,1/14/2020,0,1,0,1
BARTOW,1/15/2020,0,1,0,1
BARTOW,1/16/2020,0,1,0,1
BARTOW,1/17/2020,0,1,0,1
BARTOW,1/18/2020,0,1,0,1
BARTOW,1/19/2020,0,1,0,1
BARTOW,1/20/2020,0,1,0,1
BARTOW,1/21/2020,0,1,0,1
BARTOW,1/22/2020,0,1,0,1
BARTOW,1/23/2020,0,1,0,1
BARTOW,1/24/2020,0,1,0,1
BARTOW,1/25/2020,0,1,0,1
BARTOW,1/26/2020,0,1,0,1
BARTOW,1/27/2020,0,1,0,1
BARTOW,1/28/2020,0,1,0,1
BARTOW,1/29/2020,0,1,0,1
BARTOW,1/30/2020,0,1,0,1
BARTOW,1/31/2020,0,1,0,1
BARTOW,2/1/2020,0,1,0,1
BARTOW,2/2/2020,0,1,0,1
BARTOW,2/3/2020,0,1,0,1
BARTOW,2/4/2020,0,1,0,1
BARTOW,2/5/2020,0,1,0,1
BARTOW,2/6/2020,0,1,0,1
BARTOW,2/7/2020,0,1,0,1
BARTOW,2/8/2020,0,1,0,1
BARTOW,2/9/2020,0,1,0,1
BARTOW,2/10/2020,0,1,0,1
BARTOW,2/11/2020,0,1,0,1
BARTOW,2/12/2020,0,1,0,1
BARTOW,2/13/2020,0,1,0,1
BARTOW,2/14/2020,0,1,0,1
BARTOW,2/15/2020,0,1,0,1
BARTOW,2/16/2020,0,1,0,1
BARTOW,2/17/2020,0,1,0,1
BARTOW,2/18/2020,1,1,0,2
BARTOW,2/19/2020,1,1,0,2
BARTOW,2/20/2020,1,1,0,2
BARTOW,2/21/2020,1,1,0,2
BARTOW,2/22/2020,1,1,0,2
BARTOW,2/23/2020,1,1,0,2
BARTOW,2/24/2020,1,1,0,2
BARTOW,2/25/2020,1,1,0,2
BARTOW,2/26/2020,1,1,0,2
BARTOW,2/27/2020,2,1,0,3
BARTOW,2/28/2020,4,1,0,5
BARTOW,2/29/2020,4,3,0,7
BARTOW,3/1/2020,6,6,0,12
BARTOW,3/2/2020,8,9,0,17
BARTOW,3/3/2020,10,11,0,21
BARTOW,3/4/2020,13,12,0,25
BARTOW,3/5/2020,17,16,0,33
BARTOW,3/6/2020,18,18,0,36
BARTOW,3/7/2020,21,20,0,41
BARTOW,3/8/2020,27,27,0,54
BARTOW,3/9/2020,35,29,0,64
BARTOW,3/10/2020,41,36,0,77
BARTOW,3/11/2020,46,40,0,86
BARTOW,3/12/2020,48,43,0,91
BARTOW,3/13/2020,53,48,0,101
BARTOW,3/14/2020,55,55,0,110
BARTOW,3/15/2020,57,61,0,118
BARTOW,3/16/2020,59,68,0,127
BARTOW,3/17/2020,61,70,0,131
BARTOW,3/18/2020,65,72,0,137
BARTOW,3/19/2020,69,77,0,146
BARTOW,3/20/2020,72,79,0,151
BARTOW,3/21/2020,74,82,0,156
BARTOW,3/22/2020,75,86,0,161
BARTOW,3/23/2020,80,89,0,169
BARTOW,3/24/2020,86,90,0,176
BARTOW,3/25/2020,88,93,0,181
BARTOW,3/26/2020,91,96,0,187
BARTOW,3/27/2020,92,98,0,190
BARTOW,3/28/2020,97,102,0,199
BARTOW,3/29/2020,99,103,0,202
BARTOW,3/30/2020,104,107,0,211
BARTOW,3/31/2020,106,107,0,213
BARTOW,4/1/2020,109,109,0,218
BARTOW,4/2/2020,110,109,0,219
BARTOW,4/3/2020,111,110,0,221
BARTOW,4/4/2020,115,110,0,225
BARTOW,4/5/2020,119,110,0,229
BARTOW,4/6/2020,124,113,0,237
BARTOW,4/7/2020,127,117,0,244
BARTOW,4/8/2020,131,118,0,249
BARTOW,4/9/2020,131,118,0,249
BARTOW,4/10/2020,132,121,0,253
BARTOW,4/11/2020,133,121,0,254
BARTOW,4/12/2020,136,121,0,257
BARTOW,4/13/2020,139,124,0,263
BARTOW,4/14/2020,141,125,0,266
BARTOW,4/15/2020,143,127,0,270
BARTOW,4/16/2020,150,129,0,279
BARTOW,4/17/2020,151,130,0,281
BARTOW,4/18/2020,153,132,0,285
BARTOW,4/19/2020,156,133,0,289
BARTOW,4/20/2020,160,136,0,296
BARTOW,4/21/2020,164,138,0,302
BARTOW,4/22/2020,170,143,0,313
BARTOW,4/23/2020,173,144,0,317
BARTOW,4/24/2020,174,146,0,320
BARTOW,4/25/2020,175,147,0,322
BARTOW,4/26/2020,176,149,0,325
BARTOW,4/27/2020,185,154,0,339
BARTOW,4/28/2020,192,156,0,348
BARTOW,4/29/2020,194,157,0,351
BARTOW,4/30/2020,196,158,0,354
BARTOW,5/1/2020,198,161,0,359
BARTOW,5/2/2020,199,161,0,360
BARTOW,5/3/2020,201,164,0,365
BARTOW,5/4/2020,203,165,0,368
BARTOW,5/5/2020,205,165,0,370
BARTOW,5/6/2020,207,166,0,373
BARTOW,5/7/2020,210,169,0,379
BARTOW,5/8/2020,211,170,0,381
BARTOW,5/9/2020,214,173,0,387
BARTOW,5/10/2020,216,174,0,390
BARTOW,5/11/2020,222,178,0,400
BARTOW,5/12/2020,225,180,0,405
BARTOW,5/13/2020,227,180,0,407
BARTOW,5/14/2020,231,180,0,411
BARTOW,5/15/2020,233,185,0,418
BARTOW,5/16/2020,237,187,0,424
BARTOW,5/17/2020,237,189,0,426
BARTOW,5/18/2020,239,194,0,433
BARTOW,5/19/2020,242,199,0,441
BARTOW,5/20/2020,245,200,0,445
BARTOW,5/21/2020,247,201,0,448
BARTOW,5/22/2020,254,204,0,458
BARTOW,5/23/2020,254,207,0,461
BARTOW,5/24/2020,255,208,0,463
BARTOW,5/25/2020,258,209,0,467
BARTOW,5/26/2020,262,213,0,475
BARTOW,5/27/2020,264,222,0,486
BARTOW,5/28/2020,268,223,0,491
BARTOW,5/29/2020,273,226,3,502
BARTOW,5/30/2020,274,228,3,505
BARTOW,5/31/2020,277,229,3,509
BARTOW,6/1/2020,290,232,3,525
BARTOW,6/2/2020,296,237,3,536
BARTOW,6/3/2020,296,238,3,537
BARTOW,6/4/2020,297,246,3,546
BARTOW,6/5/2020,302,250,3,555
BARTOW,6/6/2020,303,254,3,560
BARTOW,6/7/2020,303,256,3,562
BARTOW,6/8/2020,308,259,3,570
BARTOW,6/9/2020,312,264,3,579
BARTOW,6/10/2020,314,266,3,583
BARTOW,6/11/2020,318,270,3,591
BARTOW,6/12/2020,323,275,4,602
BARTOW,6/13/2020,325,277,4,606
BARTOW,6/14/2020,328,280,4,612
BARTOW,6/15/2020,331,286,4,621
BARTOW,6/16/2020,334,294,4,632
BARTOW,6/17/2020,341,298,4,643
BARTOW,6/18/2020,345,301,4,650
BARTOW,6/19/2020,350,307,4,661
BARTOW,6/20/2020,357,309,4,670
BARTOW,6/21/2020,363,312,4,679
BARTOW,6/22/2020,371,321,4,696
BARTOW,6/23/2020,380,328,5,713
BARTOW,6/24/2020,393,336,5,734
BARTOW,6/25/2020,401,345,6,752
BARTOW,6/26/2020,417,361,7,785
BARTOW,6/27/2020,427,367,8,802
BARTOW,6/28/2020,436,374,8,818
BARTOW,6/29/2020,464,393,9,866
BARTOW,6/30/2020,484,400,9,893
BARTOW,7/1/2020,507,417,9,933
BARTOW,7/2/2020,521,431,10,962
BARTOW,7/3/2020,533,442,10,985
BARTOW,7/4/2020,540,444,10,994
BARTOW,7/5/2020,546,450,10,1006
BARTOW,7/6/2020,569,471,11,1051
BARTOW,7/7/2020,597,493,11,1101
BARTOW,7/8/2020,634,524,22,1180
BARTOW,7/9/2020,652,537,23,1212
BARTOW,7/10/2020,665,549,24,1238
BARTOW,7/11/2020,678,561,24,1263
BARTOW,7/12/2020,689,579,24,1292
BARTOW,7/13/2020,707,601,24,1332
BARTOW,7/14/2020,736,616,24,1376
BARTOW,7/15/2020,749,627,24,1400
BARTOW,7/16/2020,765,635,27,1427
BARTOW,7/17/2020,784,648,27,1459
BARTOW,7/18/2020,799,658,28,1485
BARTOW,7/19/2020,806,660,28,1494
BARTOW,7/20/2020,826,680,28,1534
BARTOW,7/21/2020,853,697,28,1578
BARTOW,7/22/2020,865,711,29,1605
BARTOW,7/23/2020,886,733,29,1648
BARTOW,7/24/2020,909,757,29,1695
BARTOW,7/25/2020,921,769,29,1719
BARTOW,7/26/2020,926,775,30,1731
BARTOW,7/27/2020,948,792,33,1773
BARTOW,7/28/2020,965,813,33,1811
BARTOW,7/29/2020,981,830,34,1845
BARTOW,7/30/2020,994,850,35,1879
BARTOW,7/31/2020,1018,864,36,1918
BARTOW,8/1/2020,1027,873,36,1936
BARTOW,8/2/2020,1031,878,36,1945
BARTOW,8/3/2020,1044,892,36,1972
BARTOW,8/4/2020,1055,906,37,1998
BARTOW,8/5/2020,1068,916,38,2022
BARTOW,8/6/2020,1083,926,38,2047
BARTOW,8/7/2020,1099,936,40,2075
BARTOW,8/8/2020,1108,946,40,2094
BARTOW,8/9/2020,1115,949,40,2104
BARTOW,8/10/2020,1130,960,40,2130
BARTOW,8/11/2020,1143,974,41,2158
BARTOW,8/12/2020,1163,988,41,2192
BARTOW,8/13/2020,1178,1004,41,2223
BARTOW,8/14/2020,1196,1015,42,2253
BARTOW,8/15/2020,1209,1025,42,2276
BARTOW,8/16/2020,1218,1031,42,2291
BARTOW,8/17/2020,1242,1041,42,2325
BARTOW,8/18/2020,1258,1056,43,2357
BARTOW,8/19/2020,1275,1072,43,2390
BARTOW,8/20/2020,1285,1079,44,2408
BARTOW,8/21/2020,1293,1091,44,2428
BARTOW,8/22/2020,1301,1098,44,2443
BARTOW,8/23/2020,1306,1106,44,2456
BARTOW,8/24/2020,1321,1124,44,2489
BARTOW,8/25/2020,1331,1132,44,2507
BARTOW,8/26/2020,1335,1143,45,2523
BARTOW,8/27/2020,1349,1151,45,2545
BARTOW,8/28/2020,1354,1160,46,2560
BARTOW,8/29/2020,1361,1163,46,2570
BARTOW,8/30/2020,1366,1167,46,2579
BARTOW,8/31/2020,1389,1186,46,2621
BARTOW,9/1/2020,1398,1189,46,2633
BARTOW,9/2/2020,1412,1197,46,2655
BARTOW,9/3/2020,1418,1206,46,2670
BARTOW,9/4/2020,1428,1215,46,2689
BARTOW,9/5/2020,1439,1219,46,2704
BARTOW,9/6/2020,1444,1223,46,2713
BARTOW,9/7/2020,1450,1229,46,2725
BARTOW,9/8/2020,1463,1243,46,2752
BARTOW,9/9/2020,1471,1256,46,2773
BARTOW,9/10/2020,1478,1263,46,2787
BARTOW,9/11/2020,1486,1274,47,2807
BARTOW,9/12/2020,1489,1280,47,2816
BARTOW,9/13/2020,1492,1288,47,2827
BARTOW,9/14/2020,1500,1296,47,2843
BARTOW,9/15/2020,1512,1301,47,2860
BARTOW,9/16/2020,1517,1306,47,2870
BARTOW,9/17/2020,1520,1317,47,2884
BARTOW,9/18/2020,1532,1326,47,2905
BARTOW,9/19/2020,1538,1331,47,2916
BARTOW,9/20/2020,1541,1334,47,2922
BARTOW,9/21/2020,1550,1340,47,2937
BARTOW,9/22/2020,1560,1344,47,2951
BARTOW,9/23/2020,1568,1348,47,2963
BARTOW,9/24/2020,1580,1353,47,2980
BARTOW,9/25/2020,1581,1359,47,2987
BARTOW,9/26/2020,1586,1363,47,2996
BARTOW,9/27/2020,1591,1370,47,3008
BARTOW,9/28/2020,1600,1379,49,3028
BARTOW,9/29/2020,1607,1390,49,3046
BARTOW,9/30/2020,1614,1397,49,3060
BRANTLEY,7/14/2020,117,78,1,196
BRANTLEY,7/15/2020,119,80,1,200
BRANTLEY,7/16/2020,122,80,1,203
BRANTLEY,7/17/2020,123,80,1,204
BRANTLEY,7/18/2020,127,81,1,209
BRANTLEY,7/19/2020,128,81,1,210
BRANTLEY,7/20/2020,130,82,1,213
BRANTLEY,7/21/2020,132,83,1,216
BRANTLEY,7/22/2020,135,86,1,222
BRANTLEY,7/23/2020,139,91,1,231
BARTOW,10/4/2020,1644,1422,51,3117
BRANTLEY,7/24/2020,142,95,1,238
BRANTLEY,7/25/2020,142,96,1,239
BRANTLEY,7/26/2020,142,96,1,239
BRANTLEY,7/27/2020,143,98,1,242
BRANTLEY,7/28/2020,144,100,1,245
BRANTLEY,7/29/2020,147,100,1,248
BRANTLEY,7/30/2020,150,100,1,251
BRANTLEY,7/31/2020,151,103,1,255
BRANTLEY,8/1/2020,152,104,1,257
BRANTLEY,8/2/2020,153,104,1,258
BRANTLEY,8/3/2020,156,107,1,264
BRANTLEY,8/4/2020,157,109,1,267
BRANTLEY,8/5/2020,158,111,1,270
BRANTLEY,8/6/2020,160,113,1,274
BRANTLEY,8/7/2020,160,115,1,276
BRANTLEY,8/8/2020,160,116,1,277
BRANTLEY,8/9/2020,160,117,1,278
BRANTLEY,8/10/2020,161,118,1,280
BRANTLEY,8/11/2020,167,119,1,287
BRANTLEY,8/12/2020,169,121,1,291
BRANTLEY,8/13/2020,170,121,1,292
BRANTLEY,8/14/2020,174,122,1,297
BRANTLEY,8/15/2020,174,123,1,298
BRANTLEY,8/16/2020,178,123,1,302
BRANTLEY,8/17/2020,180,123,1,304
BRANTLEY,8/18/2020,180,123,1,304
BRANTLEY,8/19/2020,182,123,1,306
BRANTLEY,8/20/2020,184,124,1,309
BRANTLEY,8/21/2020,185,125,1,311
BRANTLEY,8/22/2020,186,126,1,313
BRANTLEY,8/23/2020,187,127,1,315
BRANTLEY,8/24/2020,190,129,1,320
BRANTLEY,8/25/2020,190,129,1,320
BRANTLEY,8/26/2020,193,129,1,323
BRANTLEY,8/27/2020,194,130,1,325
BRANTLEY,8/28/2020,194,132,1,327
BRANTLEY,8/29/2020,194,133,1,328
BRANTLEY,8/30/2020,194,135,1,330
BRANTLEY,8/31/2020,195,137,1,333
BRANTLEY,9/1/2020,196,137,1,334
BRANTLEY,9/2/2020,196,138,1,335
BRANTLEY,9/3/2020,196,138,1,335
BRANTLEY,9/4/2020,197,139,1,337
BRANTLEY,9/5/2020,197,139,1,337
BRANTLEY,9/6/2020,197,140,1,338
BRANTLEY,9/7/2020,197,141,1,339
BRANTLEY,9/8/2020,197,141,1,339
BRANTLEY,9/9/2020,198,141,1,340
BRANTLEY,9/10/2020,199,141,1,341
BRANTLEY,9/11/2020,199,142,1,342
BRANTLEY,9/12/2020,199,143,1,343
BRANTLEY,9/13/2020,201,144,1,346
BRANTLEY,9/14/2020,202,144,1,347
BRANTLEY,9/15/2020,203,144,1,348
BRANTLEY,9/16/2020,203,144,1,348
BRANTLEY,9/17/2020,203,144,1,348
BRANTLEY,9/18/2020,204,144,1,349
BRANTLEY,9/19/2020,204,144,1,349
BRANTLEY,9/20/2020,204,144,1,349
BRANTLEY,9/21/2020,206,144,1,351
BRANTLEY,9/22/2020,206,144,1,351
BRANTLEY,9/23/2020,206,144,1,351
BRANTLEY,9/24/2020,206,145,1,352
BRANTLEY,9/25/2020,207,145,1,353
BRANTLEY,9/26/2020,208,145,1,354
BRANTLEY,9/27/2020,208,146,1,355
BRANTLEY,9/28/2020,210,146,1,357
BRANTLEY,9/29/2020,210,147,1,358
BRANTLEY,9/30/2020,211,147,1,359
BRANTLEY,10/1/2020,212,147,2,361
BRANTLEY,10/2/2020,213,147,2,362
BRANTLEY,10/3/2020,213,149,2,364
BRANTLEY,10/4/2020,214,151,2,367
BRANTLEY,10/5/2020,216,153,2,371
BRANTLEY,10/6/2020,221,156,2,379
BRANTLEY,10/7/2020,224,157,2,383
BRANTLEY,10/8/2020,227,158,2,387
BRANTLEY,10/9/2020,229,158,2,389
BRANTLEY,10/10/2020,230,160,2,392
BRANTLEY,10/11/2020,230,160,2,392
BRANTLEY,10/12/2020,232,160,2,394
BRANTLEY,10/13/2020,233,162,2,397
BRANTLEY,10/14/2020,236,165,2,403
BRANTLEY,10/15/2020,238,167,2,407
BRANTLEY,10/16/2020,240,168,2,410
BRANTLEY,10/17/2020,240,168,2,410
BRANTLEY,10/18/2020,240,168,2,410
BRANTLEY,10/19/2020,240,168,2,410
BRANTLEY,10/20/2020,240,168,2,410
BULLOCH,1/1/2020,0,0,0,0
BULLOCH,1/2/2020,0,0,0,0
BULLOCH,1/3/2020,0,0,0,0
BULLOCH,1/4/2020,0,0,0,0
BULLOCH,1/5/2020,0,0,0,0
BULLOCH,1/6/2020,0,0,0,0
BULLOCH,1/7/2020,0,0,0,0
BULLOCH,1/8/2020,1,0,0,1
BULLOCH,1/9/2020,1,0,0,1
BULLOCH,1/10/2020,1,0,0,1
BULLOCH,1/11/2020,1,0,0,1
BULLOCH,1/12/2020,1,0,0,1
BULLOCH,1/13/2020,1,0,0,1
BULLOCH,1/14/2020,1,0,0,1
BULLOCH,1/15/2020,1,0,0,1
BULLOCH,1/16/2020,1,0,0,1
BULLOCH,1/17/2020,1,0,0,1
BULLOCH,1/18/2020,1,0,0,1
BULLOCH,1/19/2020,1,0,0,1
BULLOCH,1/20/2020,1,0,0,1
BULLOCH,1/21/2020,1,0,0,1
BULLOCH,1/22/2020,1,0,0,1
BULLOCH,1/23/2020,1,0,0,1
BULLOCH,1/24/2020,1,0,0,1
BULLOCH,1/25/2020,1,0,0,1
BULLOCH,1/26/2020,1,0,0,1
BULLOCH,1/27/2020,1,0,0,1
BULLOCH,1/28/2020,1,0,0,1
BULLOCH,1/29/2020,1,0,0,1
BULLOCH,1/30/2020,1,0,0,1
BULLOCH,1/31/2020,1,0,0,1
BULLOCH,2/1/2020,1,0,0,1
BULLOCH,2/2/2020,1,0,0,1
BULLOCH,2/3/2020,1,0,0,1
BULLOCH,2/4/2020,1,0,0,1
BULLOCH,2/5/2020,1,0,0,1
BULLOCH,2/6/2020,1,0,0,1
BULLOCH,2/7/2020,1,0,0,1
BULLOCH,2/8/2020,1,0,0,1
BULLOCH,2/9/2020,1,0,0,1
BULLOCH,2/10/2020,1,0,0,1
BULLOCH,2/11/2020,1,0,0,1
BULLOCH,2/12/2020,1,0,0,1
BULLOCH,2/13/2020,1,0,0,1
BULLOCH,2/14/2020,1,0,0,1
BULLOCH,2/15/2020,1,0,0,1
BULLOCH,2/16/2020,1,0,0,1
BULLOCH,2/17/2020,1,0,0,1
BULLOCH,2/18/2020,1,0,0,1
BULLOCH,2/19/2020,1,0,0,1
BULLOCH,2/20/2020,1,0,0,1
BULLOCH,2/21/2020,1,0,0,1
BULLOCH,2/22/2020,1,0,0,1
BULLOCH,2/23/2020,1,0,0,1
BULLOCH,2/24/2020,1,0,0,1
BULLOCH,2/25/2020,1,0,0,1
BULLOCH,2/26/2020,1,0,0,1
BULLOCH,2/27/2020,1,0,0,1
BULLOCH,2/28/2020,1,0,0,1
BULLOCH,2/29/2020,1,0,0,1
BULLOCH,3/1/2020,2,0,0,2
BULLOCH,3/2/2020,2,0,0,2
BULLOCH,3/3/2020,2,0,0,2
BULLOCH,3/4/2020,3,0,0,3
BULLOCH,3/5/2020,4,0,0,4
BULLOCH,3/6/2020,4,0,0,4
BULLOCH,3/7/2020,4,0,0,4
BULLOCH,3/8/2020,4,0,0,4
BULLOCH,3/9/2020,4,0,0,4
BULLOCH,3/10/2020,4,0,0,4
BULLOCH,3/11/2020,4,0,0,4
BULLOCH,3/12/2020,4,0,0,4
BULLOCH,3/13/2020,4,0,0,4
BULLOCH,3/14/2020,5,0,0,5
BULLOCH,3/15/2020,5,0,0,5
BULLOCH,3/16/2020,5,0,0,5
BULLOCH,3/17/2020,5,0,0,5
BULLOCH,3/18/2020,5,0,0,5
BULLOCH,3/19/2020,5,0,0,5
BULLOCH,3/20/2020,5,0,0,5
BULLOCH,3/21/2020,5,0,0,5
BULLOCH,3/22/2020,5,1,0,6
BULLOCH,3/23/2020,5,2,0,7
BULLOCH,3/24/2020,5,3,0,8
BULLOCH,3/25/2020,7,3,0,10
BULLOCH,3/26/2020,8,3,0,11
BULLOCH,3/27/2020,8,3,0,11
BULLOCH,3/28/2020,8,5,0,13
BULLOCH,3/29/2020,8,6,0,14
BULLOCH,3/30/2020,8,6,0,14
BULLOCH,3/31/2020,10,6,0,16
BULLOCH,4/1/2020,12,6,0,18
BULLOCH,4/2/2020,13,6,0,19
BULLOCH,4/3/2020,14,7,0,21
BULLOCH,4/4/2020,15,7,0,22
BULLOCH,4/5/2020,16,7,0,23
BULLOCH,4/6/2020,17,8,0,25
BULLOCH,4/7/2020,19,9,0,28
BULLOCH,4/8/2020,20,10,0,30
BULLOCH,4/9/2020,21,11,0,32
BULLOCH,4/10/2020,22,11,0,33
BULLOCH,4/11/2020,23,11,0,34
BULLOCH,4/12/2020,24,11,0,35
BULLOCH,4/13/2020,24,13,0,37
BULLOCH,4/14/2020,24,13,0,37
BULLOCH,4/15/2020,24,13,0,37
BULLOCH,4/16/2020,24,15,0,39
BULLOCH,4/17/2020,24,16,0,40
BULLOCH,4/18/2020,25,16,0,41
BULLOCH,4/19/2020,25,16,0,41
BULLOCH,4/20/2020,26,17,0,43
BULLOCH,4/21/2020,27,18,0,45
BULLOCH,4/22/2020,27,18,0,45
BULLOCH,4/23/2020,28,19,0,47
BULLOCH,4/24/2020,30,20,0,50
BULLOCH,4/25/2020,31,20,0,51
BULLOCH,4/26/2020,31,21,0,52
BULLOCH,4/27/2020,32,22,0,54
BULLOCH,4/28/2020,32,22,0,54
BULLOCH,4/29/2020,32,22,0,54
BULLOCH,4/30/2020,33,24,0,57
BULLOCH,5/1/2020,33,24,0,57
BULLOCH,5/2/2020,33,24,0,57
BULLOCH,5/3/2020,33,24,0,57
BULLOCH,5/4/2020,33,24,0,57
BULLOCH,5/5/2020,33,24,0,57
BULLOCH,5/6/2020,33,25,0,58
BULLOCH,5/7/2020,34,25,0,59
BULLOCH,5/8/2020,34,25,0,59
BULLOCH,5/9/2020,34,25,0,59
BULLOCH,5/10/2020,34,25,0,59
BULLOCH,5/11/2020,34,25,0,59
BULLOCH,5/12/2020,35,25,0,60
BULLOCH,5/13/2020,35,26,0,61
BULLOCH,5/14/2020,36,26,0,62
BULLOCH,5/15/2020,37,27,0,64
BULLOCH,5/16/2020,37,27,0,64
BULLOCH,5/17/2020,37,28,0,65
BULLOCH,5/18/2020,37,28,0,65
BULLOCH,5/19/2020,38,28,0,66
BULLOCH,5/20/2020,39,28,0,67
BULLOCH,5/21/2020,40,28,0,68
BULLOCH,5/22/2020,40,28,0,68
BULLOCH,5/23/2020,40,30,0,70
BULLOCH,5/24/2020,41,30,0,71
BULLOCH,5/25/2020,41,32,0,73
BULLOCH,5/26/2020,42,35,0,77
BULLOCH,5/27/2020,49,40,0,89
BULLOCH,5/28/2020,53,40,0,93
BULLOCH,5/29/2020,56,40,0,96
BULLOCH,5/30/2020,56,40,0,96
BULLOCH,5/31/2020,57,40,0,97
BULLOCH,6/1/2020,59,41,0,100
BULLOCH,6/2/2020,63,41,0,104
BULLOCH,6/3/2020,66,42,0,108
BULLOCH,6/4/2020,66,43,0,109
BULLOCH,6/5/2020,68,44,0,112
BULLOCH,6/6/2020,69,45,0,114
BULLOCH,6/7/2020,71,46,0,117
BULLOCH,6/8/2020,72,49,0,121
BULLOCH,6/9/2020,75,50,0,125
BULLOCH,6/10/2020,80,57,0,137
BULLOCH,6/11/2020,84,61,0,145
BULLOCH,6/12/2020,90,70,0,160
BULLOCH,6/13/2020,96,74,0,170
BULLOCH,6/14/2020,102,80,0,182
BULLOCH,6/15/2020,114,88,0,202
BULLOCH,6/16/2020,121,93,0,214
BULLOCH,6/17/2020,140,104,0,244
BULLOCH,6/18/2020,161,114,0,275
BULLOCH,6/19/2020,174,125,0,299
BULLOCH,6/20/2020,184,134,0,318
BULLOCH,6/21/2020,193,140,1,334
BULLOCH,6/22/2020,212,155,1,368
BULLOCH,6/23/2020,235,171,2,408
BULLOCH,6/24/2020,251,178,2,431
BULLOCH,6/25/2020,273,195,2,470
BULLOCH,6/26/2020,284,202,2,488
BULLOCH,6/27/2020,293,210,4,507
BULLOCH,6/28/2020,299,216,4,519
BULLOCH,6/29/2020,325,236,7,568
BULLOCH,6/30/2020,346,248,7,601
BULLOCH,7/1/2020,363,261,8,632
BULLOCH,7/2/2020,376,271,9,656
BULLOCH,7/3/2020,388,281,11,680
BULLOCH,7/4/2020,398,285,11,694
BULLOCH,7/5/2020,405,289,11,705
BULLOCH,7/6/2020,429,306,11,746
BULLOCH,7/7/2020,442,318,11,771
BULLOCH,7/8/2020,461,332,11,804
BULLOCH,7/9/2020,471,341,11,823
BULLOCH,7/10/2020,489,352,12,853
BULLOCH,7/11/2020,498,355,12,865
BULLOCH,7/12/2020,502,359,12,873
BULLOCH,7/13/2020,517,384,12,913
BULLOCH,7/14/2020,532,402,13,947
BULLOCH,7/15/2020,543,410,15,968
BULLOCH,7/16/2020,555,417,16,988
BULLOCH,7/17/2020,561,427,16,1004
BULLOCH,7/18/2020,576,438,16,1030
BULLOCH,7/19/2020,582,440,16,1038
BULLOCH,7/20/2020,603,448,20,1071
BULLOCH,7/21/2020,613,458,23,1094
BULLOCH,7/22/2020,629,469,23,1121
BULLOCH,7/23/2020,638,480,23,1141
BULLOCH,7/24/2020,643,487,24,1154
BULLOCH,7/25/2020,646,492,24,1162
BULLOCH,7/26/2020,650,499,24,1173
BULLOCH,7/27/2020,662,507,24,1193
BULLOCH,7/28/2020,669,512,24,1205
BULLOCH,7/29/2020,681,517,24,1222
BULLOCH,7/30/2020,701,529,24,1254
BULLOCH,7/31/2020,708,535,24,1267
BULLOCH,8/1/2020,715,543,24,1282
BULLOCH,8/2/2020,726,553,25,1304
BULLOCH,8/3/2020,739,560,26,1325
BULLOCH,8/4/2020,755,568,26,1349
BULLOCH,8/5/2020,767,582,28,1377
BULLOCH,8/6/2020,778,589,28,1395
BULLOCH,8/7/2020,785,597,28,1410
BULLOCH,8/8/2020,790,602,28,1420
BULLOCH,8/9/2020,797,607,30,1434
BULLOCH,8/10/2020,807,616,31,1454
BULLOCH,8/11/2020,812,620,31,1463
BULLOCH,8/12/2020,823,627,32,1482
BULLOCH,8/13/2020,828,632,32,1492
BULLOCH,8/14/2020,833,637,32,1502
BULLOCH,8/15/2020,835,645,32,1512
BULLOCH,8/16/2020,843,647,32,1522
BULLOCH,8/17/2020,854,656,33,1543
BULLOCH,8/18/2020,868,664,33,1565
BULLOCH,8/19/2020,888,676,34,1598
BULLOCH,8/20/2020,904,689,34,1627
BULLOCH,8/21/2020,945,704,34,1683
BULLOCH,8/22/2020,986,722,35,1743
BULLOCH,8/23/2020,1048,753,35,1836
BULLOCH,8/24/2020,1125,797,35,1957
BULLOCH,8/25/2020,1202,826,35,2063
BULLOCH,8/26/2020,1263,865,35,2163
BULLOCH,8/27/2020,1296,893,35,2224
BULLOCH,8/28/2020,1337,929,36,2302
BULLOCH,8/29/2020,1361,945,36,2342
BULLOCH,8/30/2020,1378,955,36,2369
BULLOCH,8/31/2020,1404,989,36,2429
BULLOCH,9/1/2020,1429,1010,37,2476
BULLOCH,9/2/2020,1454,1031,37,2522
BULLOCH,9/3/2020,1468,1062,38,2568
BULLOCH,9/4/2020,1484,1081,38,2603
BULLOCH,9/5/2020,1499,1088,39,2626
BULLOCH,9/6/2020,1513,1097,39,2649
BULLOCH,9/7/2020,1522,1106,39,2667
BULLOCH,9/8/2020,1538,1121,39,2698
BULLOCH,9/9/2020,1551,1135,39,2725
BULLOCH,9/10/2020,1563,1150,39,2752
BULLOCH,9/11/2020,1570,1154,39,2763
BULLOCH,9/12/2020,1574,1162,39,2775
BULLOCH,9/13/2020,1602,1164,39,2805
BULLOCH,9/14/2020,1611,1171,39,2821
BULLOCH,9/15/2020,1616,1175,39,2830
BULLOCH,9/16/2020,1622,1179,39,2840
BULLOCH,9/17/2020,1626,1185,39,2850
BULLOCH,9/18/2020,1629,1188,39,2856
BULLOCH,9/19/2020,1633,1192,39,2864
BULLOCH,9/20/2020,1636,1193,39,2868
BULLOCH,9/21/2020,1643,1199,39,2881
BULLOCH,9/22/2020,1643,1201,39,2883
BULLOCH,9/23/2020,1649,1203,39,2891
BULLOCH,9/24/2020,1653,1204,39,2896
BULLOCH,9/25/2020,1657,1210,39,2906
BULLOCH,9/26/2020,1657,1211,39,2907
BULLOCH,9/27/2020,1658,1211,39,2908
BULLOCH,9/28/2020,1663,1214,40,2917
BULLOCH,9/29/2020,1668,1217,41,2926
BULLOCH,9/30/2020,1670,1223,42,2935
BULLOCH,10/1/2020,1670,1225,43,2938
BULLOCH,10/2/2020,1674,1229,43,2946
BULLOCH,10/3/2020,1675,1229,43,2947
BULLOCH,10/4/2020,1676,1231,43,2950
BULLOCH,10/5/2020,1679,1236,43,2958
BULLOCH,10/6/2020,1686,1236,43,2965
BULLOCH,10/7/2020,1691,1241,43,2975
BULLOCH,10/8/2020,1692,1247,43,2982
BULLOCH,10/9/2020,1694,1248,43,2985
BULLOCH,10/10/2020,1696,1249,43,2988
BULLOCH,10/11/2020,1699,1250,43,2992
BULLOCH,10/12/2020,1705,1252,43,3000
BULLOCH,10/13/2020,1709,1257,43,3009
BULLOCH,10/14/2020,1712,1258,43,3013
BULLOCH,10/15/2020,1718,1262,43,3023
BULLOCH,10/16/2020,1720,1263,43,3026
BULLOCH,10/17/2020,1721,1264,43,3028
BULLOCH,10/18/2020,1721,1264,43,3028
BULLOCH,10/19/2020,1721,1264,43,3028
BULLOCH,10/20/2020,1721,1264,43,3028
BUTTS,1/1/2020,0,0,0,0
BUTTS,1/2/2020,0,0,0,0
BUTTS,1/3/2020,0,0,0,0
BUTTS,1/4/2020,0,0,0,0
BARTOW,10/5/2020,1656,1441,51,3148
BARTOW,10/6/2020,1672,1453,51,3176
BARTOW,10/7/2020,1680,1463,52,3195
BARTOW,10/8/2020,1710,1485,52,3247
BARTOW,10/9/2020,1726,1496,52,3274
BARTOW,10/10/2020,1729,1506,52,3287
BARTOW,10/11/2020,1731,1508,52,3291
BARTOW,10/12/2020,1745,1515,52,3312
BARTOW,10/13/2020,1755,1527,52,3334
BARTOW,10/14/2020,1766,1538,52,3356
BARTOW,10/15/2020,1773,1552,52,3377
BARTOW,10/16/2020,1784,1564,52,3400
BARTOW,10/17/2020,1788,1570,52,3410
BARTOW,10/18/2020,1788,1571,52,3411
BARTOW,10/19/2020,1788,1572,52,3412
BARTOW,10/20/2020,1788,1572,52,3412
BEN HILL,1/1/2020,0,0,0,0
BEN HILL,1/2/2020,0,0,0,0
BEN HILL,1/3/2020,0,0,0,0
BEN HILL,1/4/2020,0,0,0,0
BEN HILL,1/5/2020,0,0,0,0
BEN HILL,1/6/2020,0,0,0,0
BEN HILL,1/7/2020,0,0,0,0
BEN HILL,1/8/2020,0,0,0,0
BEN HILL,1/9/2020,0,0,0,0
BEN HILL,1/10/2020,0,0,0,0
BEN HILL,1/11/2020,0,0,0,0
BEN HILL,1/12/2020,0,0,0,0
BEN HILL,1/13/2020,0,0,0,0
BEN HILL,1/14/2020,0,0,0,0
BEN HILL,1/15/2020,0,0,0,0
BEN HILL,1/16/2020,0,0,0,0
BEN HILL,1/17/2020,0,0,0,0
BEN HILL,1/18/2020,0,0,0,0
BEN HILL,1/19/2020,0,0,0,0
BEN HILL,1/20/2020,0,0,0,0
BEN HILL,1/21/2020,0,0,0,0
BEN HILL,1/22/2020,0,0,0,0
BEN HILL,1/23/2020,0,0,0,0
BEN HILL,1/24/2020,0,0,0,0
BEN HILL,1/25/2020,0,0,0,0
BEN HILL,1/26/2020,0,0,0,0
BEN HILL,1/27/2020,0,0,0,0
BEN HILL,1/28/2020,0,0,0,0
BEN HILL,1/29/2020,0,0,0,0
BEN HILL,1/30/2020,0,0,0,0
BEN HILL,1/31/2020,0,0,0,0
BEN HILL,2/1/2020,0,0,0,0
BEN HILL,2/2/2020,0,0,0,0
BEN HILL,2/3/2020,0,0,0,0
BEN HILL,2/4/2020,0,0,0,0
BEN HILL,2/5/2020,0,0,0,0
BEN HILL,2/6/2020,0,0,0,0
BEN HILL,2/7/2020,0,0,0,0
BEN HILL,2/8/2020,0,0,0,0
BEN HILL,2/9/2020,0,0,0,0
BEN HILL,2/10/2020,0,0,0,0
BEN HILL,2/11/2020,0,0,0,0
BEN HILL,2/12/2020,0,0,0,0
BEN HILL,2/13/2020,0,0,0,0
BEN HILL,2/14/2020,0,0,0,0
BEN HILL,2/15/2020,0,0,0,0
BEN HILL,2/16/2020,0,0,0,0
BEN HILL,2/17/2020,0,0,0,0
BEN HILL,2/18/2020,0,0,0,0
BEN HILL,2/19/2020,0,0,0,0
BEN HILL,2/20/2020,0,0,0,0
BEN HILL,2/21/2020,0,0,0,0
BEN HILL,2/22/2020,0,0,0,0
BEN HILL,2/23/2020,0,0,0,0
BEN HILL,2/24/2020,0,0,0,0
BEN HILL,2/25/2020,0,0,0,0
BEN HILL,2/26/2020,0,0,0,0
BEN HILL,2/27/2020,0,0,0,0
BEN HILL,2/28/2020,0,0,0,0
BEN HILL,2/29/2020,0,0,0,0
BEN HILL,3/1/2020,0,0,0,0
BEN HILL,3/2/2020,0,0,0,0
BEN HILL,3/3/2020,0,0,0,0
BEN HILL,3/4/2020,0,0,0,0
BEN HILL,3/5/2020,0,0,0,0
BEN HILL,3/6/2020,0,0,0,0
BEN HILL,3/7/2020,0,0,0,0
BEN HILL,3/8/2020,0,0,0,0
BEN HILL,3/9/2020,0,0,0,0
BEN HILL,3/10/2020,0,0,0,0
BEN HILL,3/11/2020,1,0,0,1
BEN HILL,3/12/2020,1,0,0,1
BEN HILL,3/13/2020,1,0,0,1
BEN HILL,3/14/2020,1,0,0,1
BEN HILL,3/15/2020,1,0,0,1
BEN HILL,3/16/2020,1,0,0,1
BEN HILL,3/17/2020,1,0,0,1
BEN HILL,3/18/2020,2,0,0,2
BEN HILL,3/19/2020,2,1,0,3
BEN HILL,3/20/2020,2,1,0,3
BEN HILL,3/21/2020,2,1,0,3
BEN HILL,3/22/2020,2,1,0,3
BEN HILL,3/23/2020,2,1,0,3
BEN HILL,3/24/2020,2,1,0,3
BEN HILL,3/25/2020,2,1,0,3
BEN HILL,3/26/2020,2,1,0,3
BEN HILL,3/27/2020,2,2,0,4
BEN HILL,3/28/2020,2,2,0,4
BEN HILL,3/29/2020,2,2,0,4
BEN HILL,3/30/2020,2,2,0,4
BEN HILL,3/31/2020,2,2,0,4
BEN HILL,4/1/2020,3,2,0,5
BEN HILL,4/2/2020,4,2,0,6
BEN HILL,4/3/2020,4,2,0,6
BEN HILL,4/4/2020,4,3,0,7
BEN HILL,4/5/2020,4,3,0,7
BEN HILL,4/6/2020,5,3,0,8
BEN HILL,4/7/2020,6,5,0,11
BEN HILL,4/8/2020,6,5,0,11
BEN HILL,4/9/2020,7,5,0,12
BEN HILL,4/10/2020,7,5,0,12
BEN HILL,4/11/2020,7,5,0,12
BEN HILL,4/12/2020,9,5,0,14
BEN HILL,4/13/2020,11,5,0,16
BEN HILL,4/14/2020,11,5,0,16
BEN HILL,4/15/2020,13,5,0,18
BEN HILL,4/16/2020,15,6,0,21
BEN HILL,4/17/2020,15,6,0,21
BEN HILL,4/18/2020,15,6,0,21
BEN HILL,4/19/2020,15,7,0,22
BEN HILL,4/20/2020,16,9,0,25
BEN HILL,4/21/2020,17,10,0,27
BEN HILL,4/22/2020,18,10,0,28
BEN HILL,4/23/2020,22,11,0,33
BEN HILL,4/24/2020,24,11,0,35
BEN HILL,4/25/2020,24,11,0,35
BEN HILL,4/26/2020,25,12,0,37
BEN HILL,4/27/2020,26,13,0,39
BEN HILL,4/28/2020,27,14,0,41
BEN HILL,4/29/2020,28,14,0,42
BEN HILL,4/30/2020,28,15,0,43
BEN HILL,5/1/2020,31,15,0,46
BEN HILL,5/2/2020,31,16,0,47
BEN HILL,5/3/2020,33,16,0,49
BEN HILL,5/4/2020,34,16,0,50
BEN HILL,5/5/2020,34,17,0,51
BEN HILL,5/6/2020,35,17,0,52
BEN HILL,5/7/2020,35,17,0,52
BEN HILL,5/8/2020,36,19,0,55
BEN HILL,5/9/2020,36,19,0,55
BEN HILL,5/10/2020,36,19,0,55
BEN HILL,5/11/2020,36,19,0,55
BEN HILL,5/12/2020,38,19,0,57
BEN HILL,5/13/2020,40,19,0,59
BEN HILL,5/14/2020,41,21,0,62
BEN HILL,5/15/2020,43,22,0,65
BEN HILL,5/16/2020,43,22,0,65
BEN HILL,5/17/2020,45,22,0,67
BEN HILL,5/18/2020,45,23,0,68
BEN HILL,5/19/2020,46,24,0,70
BEN HILL,5/20/2020,47,25,0,72
BEN HILL,5/21/2020,48,25,0,73
BEN HILL,5/22/2020,50,26,0,76
BEN HILL,5/23/2020,51,28,0,79
BEN HILL,5/24/2020,51,28,0,79
BEN HILL,5/25/2020,51,29,0,80
BEN HILL,5/26/2020,54,30,0,84
BEN HILL,5/27/2020,54,30,0,84
BEN HILL,5/28/2020,54,32,0,86
BEN HILL,5/29/2020,56,33,0,89
BEN HILL,5/30/2020,56,33,0,89
BEN HILL,5/31/2020,56,34,0,90
BEN HILL,6/1/2020,60,36,0,96
BEN HILL,6/2/2020,60,37,0,97
BEN HILL,6/3/2020,62,39,0,101
BEN HILL,6/4/2020,63,40,0,103
BEN HILL,6/5/2020,64,40,0,104
BEN HILL,6/6/2020,65,41,0,106
BEN HILL,6/7/2020,65,41,0,106
BEN HILL,6/8/2020,67,41,0,108
BEN HILL,6/9/2020,69,41,0,110
BEN HILL,6/10/2020,70,41,0,111
BEN HILL,6/11/2020,71,43,0,114
BEN HILL,6/12/2020,72,43,0,115
BEN HILL,6/13/2020,72,43,0,115
BEN HILL,6/14/2020,72,44,0,116
BEN HILL,6/15/2020,75,47,0,122
BEN HILL,6/16/2020,77,48,0,125
BEN HILL,6/17/2020,79,50,0,129
BEN HILL,6/18/2020,80,52,0,132
BEN HILL,6/19/2020,83,52,0,135
BEN HILL,6/20/2020,85,54,0,139
BEN HILL,6/21/2020,89,56,0,145
BEN HILL,6/22/2020,97,62,0,159
BEN HILL,6/23/2020,101,65,0,166
BEN HILL,6/24/2020,105,68,0,173
BEN HILL,6/25/2020,107,70,0,177
BEN HILL,6/26/2020,109,71,0,180
BEN HILL,6/27/2020,112,73,0,185
BEN HILL,6/28/2020,112,74,0,186
BEN HILL,6/29/2020,115,76,0,191
BEN HILL,6/30/2020,116,81,0,197
BEN HILL,7/1/2020,116,82,0,198
BEN HILL,7/2/2020,121,82,0,203
BEN HILL,7/3/2020,123,84,0,207
BEN HILL,7/4/2020,124,86,0,210
BEN HILL,7/5/2020,127,87,0,214
BEN HILL,7/6/2020,131,97,0,228
BEN HILL,7/7/2020,135,101,0,236
BEN HILL,7/8/2020,139,103,0,242
BEN HILL,7/9/2020,143,107,0,250
BEN HILL,7/10/2020,143,114,0,257
BEN HILL,7/11/2020,143,115,0,258
BEN HILL,7/12/2020,144,117,0,261
BEN HILL,7/13/2020,147,120,0,267
BEN HILL,7/14/2020,156,120,0,276
BEN HILL,7/15/2020,158,127,0,285
BEN HILL,7/16/2020,162,129,0,291
BEN HILL,7/17/2020,164,131,0,295
BEN HILL,7/18/2020,167,134,0,301
BEN HILL,7/19/2020,168,134,0,302
BEN HILL,7/20/2020,171,136,0,307
BEN HILL,7/21/2020,175,137,0,312
BEN HILL,7/22/2020,180,139,0,319
BEN HILL,7/23/2020,188,143,0,331
BEN HILL,7/24/2020,192,145,0,337
BEN HILL,7/25/2020,194,147,0,341
BEN HILL,7/26/2020,195,150,0,345
BEN HILL,7/27/2020,203,155,0,358
BEN HILL,7/28/2020,214,155,0,369
BEN HILL,7/29/2020,223,159,0,382
BEN HILL,7/30/2020,225,162,0,387
BEN HILL,7/31/2020,230,170,0,400
BEN HILL,8/1/2020,234,173,0,407
BEN HILL,8/2/2020,239,175,0,414
BEN HILL,8/3/2020,247,181,0,428
BEN HILL,8/4/2020,256,181,0,437
BEN HILL,8/5/2020,272,192,0,464
BEN HILL,8/6/2020,278,204,0,482
BEN HILL,8/7/2020,287,206,0,493
BEN HILL,8/8/2020,287,207,0,494
BEN HILL,8/9/2020,290,207,0,497
BEN HILL,8/10/2020,303,215,0,518
BEN HILL,8/11/2020,311,219,1,531
BEN HILL,8/12/2020,323,228,1,552
BEN HILL,8/13/2020,329,232,1,562
BEN HILL,8/14/2020,335,232,1,568
BEN HILL,8/15/2020,339,232,1,572
BEN HILL,8/16/2020,343,234,1,578
BEN HILL,8/17/2020,352,239,1,592
BEN HILL,8/18/2020,355,245,1,601
BEN HILL,8/19/2020,356,246,1,603
BEN HILL,8/20/2020,364,252,1,617
BEN HILL,8/21/2020,368,254,1,623
BEN HILL,8/22/2020,369,255,1,625
BEN HILL,8/23/2020,371,255,1,627
BEN HILL,8/24/2020,376,260,1,637
BEN HILL,8/25/2020,379,265,1,645
BEN HILL,8/26/2020,379,268,1,648
BEN HILL,8/27/2020,382,269,1,652
BEN HILL,8/28/2020,386,269,1,656
BEN HILL,8/29/2020,389,270,1,660
BEN HILL,8/30/2020,389,271,1,661
BEN HILL,8/31/2020,394,274,1,669
BEN HILL,9/1/2020,399,276,1,676
BEN HILL,9/2/2020,402,281,1,684
BEN HILL,9/3/2020,405,283,1,689
BEN HILL,9/4/2020,409,286,1,696
BEN HILL,9/5/2020,409,289,1,699
BEN HILL,9/6/2020,412,289,1,702
BEN HILL,9/7/2020,414,290,1,705
BEN HILL,9/8/2020,417,291,1,709
BEN HILL,9/9/2020,419,295,1,715
BEN HILL,9/10/2020,422,297,1,720
BEN HILL,9/11/2020,427,297,1,725
BEN HILL,9/12/2020,427,299,1,727
BEN HILL,9/13/2020,431,301,1,733
BEN HILL,9/14/2020,434,303,1,738
BEN HILL,9/15/2020,440,305,1,746
BEN HILL,9/16/2020,440,307,1,748
BEN HILL,9/17/2020,441,309,1,751
BEN HILL,9/18/2020,442,310,1,753
BEN HILL,9/19/2020,450,311,1,762
BEN HILL,9/20/2020,451,312,1,764
BEN HILL,9/21/2020,457,317,1,775
BEN HILL,9/22/2020,458,317,1,776
BEN HILL,9/23/2020,460,320,1,781
BEN HILL,9/24/2020,463,323,1,787
BEN HILL,9/25/2020,464,327,1,792
BEN HILL,9/26/2020,467,327,1,795
BEN HILL,9/27/2020,468,328,1,797
BEN HILL,9/28/2020,473,329,1,803
BEN HILL,9/29/2020,476,330,1,807
BEN HILL,9/30/2020,482,330,1,813
BEN HILL,10/1/2020,487,331,1,819
BEN HILL,10/2/2020,490,332,1,823
BEN HILL,10/3/2020,492,332,1,825
BEN HILL,10/4/2020,494,332,1,827
BEN HILL,10/5/2020,496,332,1,829
BEN HILL,10/6/2020,498,332,1,831
BEN HILL,10/7/2020,501,334,1,836
BEN HILL,10/8/2020,501,335,1,837
BEN HILL,10/9/2020,501,335,1,837
BEN HILL,10/10/2020,502,336,1,839
BEN HILL,10/11/2020,503,336,1,840
BEN HILL,10/12/2020,507,336,1,844
BEN HILL,10/13/2020,507,336,1,844
BEN HILL,10/14/2020,508,336,1,845
BEN HILL,10/15/2020,508,336,1,845
BEN HILL,10/16/2020,510,336,1,847
BEN HILL,10/17/2020,510,336,1,847
BEN HILL,10/18/2020,510,336,1,847
BEN HILL,10/19/2020,510,336,1,847
BEN HILL,10/20/2020,510,336,1,847
BLECKLEY,1/1/2020,0,0,0,0
BLECKLEY,1/2/2020,0,0,0,0
BLECKLEY,1/3/2020,0,0,0,0
BLECKLEY,1/4/2020,0,0,0,0
BLECKLEY,1/5/2020,0,0,0,0
BLECKLEY,1/6/2020,0,0,0,0
BLECKLEY,1/7/2020,0,0,0,0
BLECKLEY,1/8/2020,0,0,0,0
BLECKLEY,1/9/2020,0,0,0,0
BLECKLEY,1/10/2020,0,0,0,0
BLECKLEY,1/11/2020,0,0,0,0
BLECKLEY,1/12/2020,0,0,0,0
BLECKLEY,1/13/2020,0,0,0,0
BLECKLEY,1/14/2020,0,0,0,0
BLECKLEY,1/15/2020,0,0,0,0
BLECKLEY,1/16/2020,0,0,0,0
BLECKLEY,1/17/2020,0,0,0,0
BLECKLEY,1/18/2020,0,0,0,0
BLECKLEY,1/19/2020,0,0,0,0
BLECKLEY,1/20/2020,0,0,0,0
BLECKLEY,1/21/2020,0,0,0,0
BLECKLEY,1/22/2020,0,0,0,0
BLECKLEY,1/23/2020,0,0,0,0
BLECKLEY,1/24/2020,0,0,0,0
BLECKLEY,1/25/2020,0,0,0,0
BLECKLEY,1/26/2020,0,0,0,0
BLECKLEY,1/27/2020,0,0,0,0
BLECKLEY,1/28/2020,0,0,0,0
BLECKLEY,1/29/2020,0,0,0,0
BLECKLEY,1/30/2020,0,0,0,0
BLECKLEY,1/31/2020,0,0,0,0
BLECKLEY,2/1/2020,0,0,0,0
BLECKLEY,2/2/2020,0,0,0,0
BLECKLEY,2/3/2020,0,0,0,0
BLECKLEY,2/4/2020,0,0,0,0
BLECKLEY,2/5/2020,0,0,0,0
BLECKLEY,2/6/2020,0,0,0,0
BLECKLEY,2/7/2020,0,0,0,0
BLECKLEY,2/8/2020,0,0,0,0
BLECKLEY,2/9/2020,0,0,0,0
BLECKLEY,2/10/2020,0,0,0,0
BLECKLEY,2/11/2020,0,0,0,0
BLECKLEY,2/12/2020,0,0,0,0
BLECKLEY,2/13/2020,0,0,0,0
BLECKLEY,2/14/2020,0,0,0,0
BLECKLEY,2/15/2020,0,0,0,0
BLECKLEY,2/16/2020,0,0,0,0
BLECKLEY,2/17/2020,0,0,0,0
BLECKLEY,2/18/2020,0,0,0,0
BLECKLEY,2/19/2020,0,0,0,0
BLECKLEY,2/20/2020,0,0,0,0
BLECKLEY,2/21/2020,0,0,0,0
BLECKLEY,2/22/2020,0,0,0,0
BLECKLEY,2/23/2020,0,0,0,0
BLECKLEY,2/24/2020,0,0,0,0
BLECKLEY,2/25/2020,0,0,0,0
BLECKLEY,2/26/2020,0,0,0,0
BLECKLEY,2/27/2020,0,0,0,0
BLECKLEY,2/28/2020,0,0,0,0
BLECKLEY,2/29/2020,0,0,0,0
BLECKLEY,3/1/2020,0,0,0,0
BLECKLEY,3/2/2020,0,0,0,0
BLECKLEY,3/3/2020,0,0,0,0
BLECKLEY,3/4/2020,0,0,0,0
BLECKLEY,3/5/2020,0,0,0,0
BLECKLEY,3/6/2020,0,0,0,0
BLECKLEY,3/7/2020,0,0,0,0
BLECKLEY,3/8/2020,0,0,0,0
BLECKLEY,3/9/2020,0,0,0,0
BLECKLEY,3/10/2020,0,0,0,0
BLECKLEY,3/11/2020,0,0,0,0
BLECKLEY,3/12/2020,0,0,0,0
BLECKLEY,3/13/2020,0,0,0,0
BLECKLEY,3/14/2020,0,0,0,0
BLECKLEY,3/15/2020,0,0,0,0
BLECKLEY,3/16/2020,0,0,0,0
BLECKLEY,3/17/2020,0,0,0,0
BLECKLEY,3/18/2020,0,0,0,0
BLECKLEY,3/19/2020,0,0,0,0
BLECKLEY,3/20/2020,0,0,0,0
BLECKLEY,3/21/2020,0,0,0,0
BLECKLEY,3/22/2020,0,0,0,0
BLECKLEY,3/23/2020,0,0,0,0
BLECKLEY,3/24/2020,0,0,0,0
BLECKLEY,3/25/2020,2,0,0,2
BLECKLEY,3/26/2020,2,0,0,2
BANKS,3/3/2020,1,0,0,1
BANKS,3/4/2020,1,0,0,1
BANKS,3/5/2020,1,0,0,1
BANKS,3/6/2020,2,0,0,2
BANKS,3/7/2020,2,0,0,2
BANKS,3/8/2020,2,0,0,2
BANKS,3/9/2020,2,0,0,2
BANKS,3/10/2020,2,0,0,2
BANKS,3/11/2020,2,0,0,2
BANKS,3/12/2020,2,0,0,2
BANKS,3/13/2020,2,0,0,2
BANKS,3/14/2020,2,0,0,2
BANKS,3/15/2020,2,0,0,2
BANKS,3/16/2020,2,0,0,2
BANKS,3/17/2020,2,0,0,2
BANKS,3/18/2020,3,0,0,3
BANKS,3/19/2020,3,0,0,3
BANKS,3/20/2020,3,0,0,3
BANKS,3/21/2020,3,0,0,3
BANKS,3/22/2020,3,0,0,3
BANKS,3/23/2020,3,0,0,3
BANKS,3/24/2020,3,0,0,3
BANKS,3/25/2020,3,1,0,4
BANKS,3/26/2020,3,1,0,4
BANKS,3/27/2020,3,1,0,4
BANKS,3/28/2020,3,1,0,4
BANKS,3/29/2020,3,1,0,4
BANKS,3/30/2020,3,1,0,4
BANKS,3/31/2020,3,1,0,4
BANKS,4/1/2020,3,1,0,4
BANKS,4/2/2020,4,1,0,5
BANKS,4/3/2020,5,2,0,7
BANKS,4/4/2020,5,2,0,7
BANKS,4/5/2020,5,2,0,7
BANKS,4/6/2020,6,3,0,9
BANKS,4/7/2020,7,3,0,10
BANKS,4/8/2020,8,6,0,14
BANKS,4/9/2020,8,6,0,14
BANKS,4/10/2020,10,6,0,16
BANKS,4/11/2020,10,6,0,16
BANKS,4/12/2020,10,6,0,16
BANKS,4/13/2020,11,7,0,18
BANKS,4/14/2020,11,8,0,19
BANKS,4/15/2020,11,8,0,19
BANKS,4/16/2020,11,8,0,19
BANKS,4/17/2020,11,9,0,20
BANKS,4/18/2020,11,9,0,20
BANKS,4/19/2020,12,9,0,21
BANKS,4/20/2020,13,9,0,22
BANKS,4/21/2020,13,9,0,22
BANKS,4/22/2020,14,9,0,23
BANKS,4/23/2020,15,10,0,25
BANKS,4/24/2020,16,11,0,27
BANKS,4/25/2020,18,11,0,29
BANKS,4/26/2020,18,11,0,29
BANKS,4/27/2020,20,13,0,33
BANKS,4/28/2020,21,13,0,34
BANKS,4/29/2020,21,13,0,34
BANKS,4/30/2020,22,13,0,35
BANKS,5/1/2020,22,13,0,35
BANKS,5/2/2020,22,13,0,35
BANKS,5/3/2020,23,14,0,37
BANKS,5/4/2020,23,15,0,38
BANKS,5/5/2020,23,16,0,39
BANKS,5/6/2020,23,16,0,39
BANKS,5/7/2020,23,16,0,39
BANKS,5/8/2020,24,16,0,40
BANKS,5/9/2020,25,19,0,44
BANKS,5/10/2020,26,20,0,46
BANKS,5/11/2020,26,20,0,46
BANKS,5/12/2020,26,21,0,47
BANKS,5/13/2020,26,23,0,49
BANKS,5/14/2020,26,23,0,49
BANKS,5/15/2020,27,23,0,50
BANKS,5/16/2020,31,29,0,60
BANKS,5/17/2020,31,29,0,60
BANKS,5/18/2020,37,30,0,67
BANKS,5/19/2020,38,30,0,68
BANKS,5/20/2020,39,31,0,70
BANKS,5/21/2020,40,33,0,73
BANKS,5/22/2020,43,36,0,79
BANKS,5/23/2020,44,37,0,81
BANKS,5/24/2020,44,37,0,81
BANKS,5/25/2020,44,37,0,81
BANKS,5/26/2020,44,38,0,82
BANKS,5/27/2020,45,38,0,83
BANKS,5/28/2020,45,38,0,83
BANKS,5/29/2020,46,40,0,86
BANKS,5/30/2020,50,41,0,91
BANKS,5/31/2020,50,42,0,92
BANKS,6/1/2020,53,43,0,96
BANKS,6/2/2020,56,43,0,99
BANKS,6/3/2020,57,43,0,100
BANKS,6/4/2020,57,43,0,100
BANKS,6/5/2020,57,44,0,101
BANKS,6/6/2020,58,45,0,103
BANKS,6/7/2020,58,45,0,103
BANKS,6/8/2020,58,45,0,103
BANKS,6/9/2020,58,46,0,104
BANKS,6/10/2020,58,48,0,106
BANKS,6/11/2020,58,49,0,107
BANKS,6/12/2020,60,49,0,109
BANKS,6/13/2020,60,49,0,109
BANKS,6/14/2020,61,50,0,111
BANKS,6/15/2020,62,50,0,112
BANKS,6/16/2020,65,51,0,116
BANKS,6/17/2020,68,52,0,120
BANKS,6/18/2020,68,52,0,120
BANKS,6/19/2020,71,54,0,125
BANKS,6/20/2020,72,54,0,126
BANKS,6/21/2020,73,56,0,129
BANKS,6/22/2020,75,56,0,131
BANKS,6/23/2020,76,60,0,136
BANKS,6/24/2020,76,60,0,136
BANKS,6/25/2020,78,60,0,138
BANKS,6/26/2020,81,61,0,142
BANKS,6/27/2020,81,61,0,142
BANKS,6/28/2020,81,61,0,142
BANKS,6/29/2020,85,62,1,148
BANKS,6/30/2020,86,63,1,150
BANKS,7/1/2020,88,64,1,153
BANKS,7/2/2020,90,65,1,156
BANKS,7/3/2020,91,65,1,157
BANKS,7/4/2020,93,65,1,159
BANKS,7/5/2020,94,68,2,164
BANKS,7/6/2020,96,73,2,171
BANKS,7/7/2020,99,76,3,178
BANKS,7/8/2020,105,77,3,185
BANKS,7/9/2020,106,79,3,188
BANKS,7/10/2020,109,82,3,194
BANKS,7/11/2020,111,84,4,199
BANKS,7/12/2020,112,85,4,201
BANKS,7/13/2020,115,88,4,207
BANKS,7/14/2020,118,90,4,212
BANKS,7/15/2020,123,92,4,219
BANKS,7/16/2020,125,93,4,222
BANKS,7/17/2020,128,93,4,225
BANKS,7/18/2020,133,95,4,232
BANKS,7/19/2020,133,99,4,236
BANKS,7/20/2020,139,100,4,243
BANKS,7/21/2020,139,103,4,246
BANKS,7/22/2020,140,105,4,249
BANKS,7/23/2020,145,106,4,255
BANKS,7/24/2020,147,108,4,259
BANKS,7/25/2020,149,109,4,262
BANKS,7/26/2020,150,109,4,263
BANKS,7/27/2020,155,116,4,275
BANKS,7/28/2020,162,117,4,283
BANKS,7/29/2020,164,119,4,287
BANKS,7/30/2020,167,122,4,293
BANKS,7/31/2020,167,123,4,294
BANKS,8/1/2020,169,126,4,299
BANKS,8/2/2020,173,127,4,304
BANKS,8/3/2020,178,132,4,314
BANKS,8/4/2020,180,133,4,317
BANKS,8/5/2020,181,134,4,319
BANKS,8/6/2020,183,134,4,321
BANKS,8/7/2020,187,136,4,327
BANKS,8/8/2020,188,137,4,329
BANKS,8/9/2020,188,138,4,330
BANKS,8/10/2020,189,143,4,336
BANKS,8/11/2020,191,145,4,340
BANKS,8/12/2020,194,146,5,345
BANKS,8/13/2020,198,148,5,351
BANKS,8/14/2020,199,148,5,352
BANKS,8/15/2020,200,152,5,357
BANKS,8/16/2020,200,153,5,358
BANKS,8/17/2020,205,157,5,367
BANKS,8/18/2020,206,158,5,369
BANKS,8/19/2020,208,163,5,376
BANKS,8/20/2020,211,164,5,380
BANKS,8/21/2020,214,166,6,386
BANKS,8/22/2020,218,167,6,391
BANKS,8/23/2020,221,169,6,396
BANKS,8/24/2020,222,169,6,397
BANKS,8/25/2020,225,170,6,401
BANKS,8/26/2020,226,172,6,404
BANKS,8/27/2020,227,173,6,406
BANKS,8/28/2020,231,176,6,413
BANKS,8/29/2020,235,178,6,419
BANKS,8/30/2020,236,178,6,420
BANKS,8/31/2020,239,179,6,424
BANKS,9/1/2020,241,180,6,427
BANKS,9/2/2020,243,182,6,431
BANKS,9/3/2020,247,184,6,437
BANKS,9/4/2020,251,184,6,441
BANKS,9/5/2020,254,184,6,444
BANKS,9/6/2020,255,187,6,448
BANKS,9/7/2020,257,188,6,451
BANKS,9/8/2020,260,188,6,454
BANKS,9/9/2020,263,191,6,460
BANKS,9/10/2020,264,191,6,461
BANKS,9/11/2020,265,194,6,465
BANKS,9/12/2020,267,197,6,470
BANKS,9/13/2020,267,200,6,473
BANKS,9/14/2020,269,201,6,476
BANKS,9/15/2020,272,202,6,480
BANKS,9/16/2020,274,202,6,482
BANKS,9/17/2020,274,205,6,485
BANKS,9/18/2020,275,205,6,486
BANKS,9/19/2020,275,206,6,487
BANKS,9/20/2020,275,207,6,488
BANKS,9/21/2020,277,207,6,490
BANKS,9/22/2020,278,207,6,491
BANKS,9/23/2020,282,209,6,497
BANKS,9/24/2020,282,211,6,499
BANKS,9/25/2020,283,213,6,502
BANKS,9/26/2020,284,214,6,504
BANKS,9/27/2020,285,214,6,505
BANKS,9/28/2020,287,215,6,508
BANKS,9/29/2020,287,215,6,508
BANKS,9/30/2020,288,216,6,510
BANKS,10/1/2020,289,218,6,513
BANKS,10/2/2020,292,218,6,516
BANKS,10/3/2020,293,218,6,517
BANKS,10/4/2020,294,220,6,520
BANKS,10/5/2020,295,224,6,525
BANKS,10/6/2020,298,224,6,528
BANKS,10/7/2020,299,224,6,529
BANKS,10/8/2020,300,227,6,533
BANKS,10/9/2020,300,228,6,534
BANKS,10/10/2020,300,228,6,534
BANKS,10/11/2020,301,228,6,535
BANKS,10/12/2020,301,229,6,536
BANKS,10/13/2020,301,229,6,536
BANKS,10/14/2020,304,231,6,541
BANKS,10/15/2020,305,232,6,543
BANKS,10/16/2020,306,232,6,544
BANKS,10/17/2020,306,232,6,544
BANKS,10/18/2020,306,232,6,544
BANKS,10/19/2020,306,232,6,544
BANKS,10/20/2020,306,232,6,544
BARROW,1/1/2020,0,1,1,2
BARROW,1/2/2020,0,1,1,2
BARROW,1/3/2020,0,1,1,2
BARROW,1/4/2020,0,1,1,2
BARROW,1/5/2020,0,1,1,2
BARROW,1/6/2020,0,1,1,2
BARROW,1/7/2020,0,1,1,2
BARROW,1/8/2020,0,1,1,2
BARROW,1/9/2020,0,1,1,2
BARROW,1/10/2020,0,1,1,2
BARROW,1/11/2020,0,1,1,2
BARROW,1/12/2020,0,1,1,2
BARROW,1/13/2020,0,1,1,2
BARROW,1/14/2020,0,1,1,2
BARROW,1/15/2020,0,1,1,2
BARROW,1/16/2020,0,1,1,2
BARROW,1/17/2020,0,1,1,2
BARROW,1/18/2020,0,1,1,2
BARROW,1/19/2020,0,1,1,2
BARROW,1/20/2020,0,1,1,2
BARROW,1/21/2020,0,1,1,2
BARROW,1/22/2020,0,1,1,2
BARROW,1/23/2020,0,1,1,2
BARROW,1/24/2020,0,1,1,2
BARROW,1/25/2020,0,1,1,2
BARROW,1/26/2020,0,1,1,2
BARROW,1/27/2020,0,1,1,2
BARROW,1/28/2020,0,1,1,2
BARROW,1/29/2020,0,1,1,2
BARROW,1/30/2020,0,1,1,2
BARROW,1/31/2020,0,1,1,2
BARROW,2/1/2020,0,1,1,2
BARROW,2/2/2020,0,1,1,2
BARROW,2/3/2020,0,1,1,2
BARROW,2/4/2020,0,1,1,2
BARROW,2/5/2020,0,1,1,2
BARROW,2/6/2020,0,1,1,2
BARROW,2/7/2020,0,1,1,2
BARROW,2/8/2020,0,1,1,2
BARROW,2/9/2020,0,1,1,2
BARROW,2/10/2020,0,1,1,2
BARROW,2/11/2020,0,1,1,2
BARROW,2/12/2020,0,1,1,2
BARROW,2/13/2020,0,1,1,2
BARROW,2/14/2020,0,1,1,2
BARROW,2/15/2020,0,1,1,2
BARROW,2/16/2020,0,1,1,2
BARROW,2/17/2020,0,1,1,2
BARROW,2/18/2020,0,1,1,2
BARROW,2/19/2020,0,1,1,2
BARROW,2/20/2020,0,1,1,2
BARROW,2/21/2020,0,1,1,2
BARROW,2/22/2020,0,1,1,2
BARROW,2/23/2020,0,1,1,2
BARROW,2/24/2020,0,1,1,2
BARROW,2/25/2020,0,1,1,2
BARROW,2/26/2020,0,1,1,2
BARROW,2/27/2020,0,1,1,2
BARROW,2/28/2020,0,1,1,2
BARROW,2/29/2020,0,1,1,2
BARROW,3/1/2020,0,2,1,3
BARROW,3/2/2020,0,2,1,3
BARROW,3/3/2020,0,2,1,3
BARROW,3/4/2020,0,2,1,3
BARROW,3/5/2020,0,2,1,3
BARROW,3/6/2020,0,2,1,3
BARROW,3/7/2020,1,2,1,4
BARROW,3/8/2020,1,2,1,4
BARROW,3/9/2020,1,3,1,5
BARROW,3/10/2020,1,3,1,5
BARROW,3/11/2020,2,3,1,6
BARROW,3/12/2020,2,3,1,6
BARROW,3/13/2020,3,4,1,8
BARROW,3/14/2020,3,4,1,8
BARROW,3/15/2020,4,6,1,11
BARROW,3/16/2020,6,8,1,15
BARROW,3/17/2020,8,8,1,17
BARROW,3/18/2020,9,8,1,18
BARROW,3/19/2020,10,8,1,19
BARROW,3/20/2020,10,9,1,20
BARROW,3/21/2020,10,9,1,20
BARROW,3/22/2020,10,11,1,22
BARROW,3/23/2020,13,13,1,27
BARROW,3/24/2020,14,14,1,29
BARROW,3/25/2020,14,15,1,30
BARROW,3/26/2020,14,17,1,32
BARROW,3/27/2020,19,17,1,37
BARROW,3/28/2020,21,19,1,41
BARROW,3/29/2020,21,21,1,43
BARROW,3/30/2020,22,23,1,46
BARROW,3/31/2020,24,25,1,50
BARROW,4/1/2020,30,26,1,57
BARROW,4/2/2020,34,26,1,61
BARROW,4/3/2020,36,26,1,63
BARROW,4/4/2020,39,28,1,68
BARROW,4/5/2020,40,28,1,69
BARROW,4/6/2020,42,30,1,73
BARROW,4/7/2020,49,33,1,83
BARROW,4/8/2020,57,39,1,97
BARROW,4/9/2020,65,40,1,106
BARROW,4/10/2020,66,43,1,110
BARROW,4/11/2020,68,44,1,113
BARROW,4/12/2020,70,45,1,116
BARROW,4/13/2020,72,46,1,119
BARROW,4/14/2020,75,47,1,123
BARROW,4/15/2020,76,49,1,126
BARROW,4/16/2020,78,50,1,129
BARROW,4/17/2020,80,52,1,133
BARROW,4/18/2020,82,53,1,136
BARROW,4/19/2020,83,55,1,139
BARROW,4/20/2020,86,56,1,143
BARROW,4/21/2020,90,57,1,148
BARROW,4/22/2020,94,57,1,152
BARROW,4/23/2020,103,60,1,164
BARROW,4/24/2020,110,61,1,172
BARROW,4/25/2020,112,61,1,174
BARROW,4/26/2020,114,65,1,180
BARROW,4/27/2020,117,66,1,184
BARROW,4/28/2020,124,69,1,194
BARROW,4/29/2020,129,72,1,202
BARROW,4/30/2020,134,74,1,209
BARROW,5/1/2020,140,78,1,219
BARROW,5/2/2020,144,82,1,227
BARROW,5/3/2020,145,82,1,228
BARROW,5/4/2020,161,92,1,254
BARROW,5/5/2020,163,93,1,257
BARROW,5/6/2020,167,94,1,262
BARROW,5/7/2020,171,95,1,267
BARROW,5/8/2020,172,96,1,269
BARROW,5/9/2020,173,98,1,272
BARROW,5/10/2020,175,100,1,276
BARROW,5/11/2020,180,103,1,284
BARROW,5/12/2020,182,105,1,288
BARROW,5/13/2020,182,109,1,292
BARROW,5/14/2020,184,113,1,298
BARROW,5/15/2020,186,118,1,305
BARROW,5/16/2020,187,119,1,307
BARROW,5/17/2020,190,120,1,311
BARROW,5/18/2020,195,123,1,319
BARROW,5/19/2020,199,127,1,327
BARROW,5/20/2020,201,127,1,329
BARROW,5/21/2020,202,129,1,332
BARROW,5/22/2020,206,130,1,337
BARROW,5/23/2020,209,130,1,340
BARROW,5/24/2020,212,133,1,346
BARROW,5/25/2020,214,135,1,350
BARROW,5/26/2020,220,137,1,358
BARROW,5/27/2020,223,137,1,361
BARROW,5/28/2020,226,138,1,365
BARROW,5/29/2020,226,140,1,367
BARROW,5/30/2020,227,140,1,368
BARROW,5/31/2020,228,142,1,371
BARROW,6/1/2020,229,144,1,374
BARROW,6/2/2020,229,145,1,375
BARROW,6/3/2020,232,147,1,380
BARROW,6/4/2020,235,152,1,388
BARROW,6/5/2020,237,154,1,392
BARROW,6/6/2020,237,156,1,394
BARROW,6/7/2020,239,160,1,400
BARROW,6/8/2020,241,164,1,406
BARROW,6/9/2020,244,164,1,409
BARROW,6/10/2020,247,167,1,415
BARROW,6/11/2020,249,172,1,422
BARROW,6/12/2020,254,174,1,429
BARROW,6/13/2020,256,180,1,437
BARROW,6/14/2020,259,183,1,443
BARROW,6/15/2020,260,187,1,448
BARROW,6/16/2020,264,191,1,456
CATOOSA,8/4/2020,377,317,24,718
CATOOSA,8/5/2020,381,322,25,728
CATOOSA,8/6/2020,389,327,27,743
CATOOSA,8/7/2020,396,339,28,763
CATOOSA,8/8/2020,401,343,28,772
CATOOSA,8/9/2020,405,347,28,780
CATOOSA,8/10/2020,408,351,29,788
CATOOSA,8/11/2020,417,354,30,801
CATOOSA,8/12/2020,422,359,30,811
CATOOSA,8/13/2020,426,366,30,822
CATOOSA,8/14/2020,428,367,30,825
CATOOSA,8/15/2020,431,372,30,833
CATOOSA,8/16/2020,433,377,32,842
CATOOSA,8/17/2020,438,381,33,852
CATOOSA,8/18/2020,441,384,33,858
CATOOSA,8/19/2020,451,392,33,876
CATOOSA,8/20/2020,454,397,33,884
CATOOSA,8/21/2020,464,401,33,898
CATOOSA,8/22/2020,467,403,33,903
CATOOSA,8/23/2020,472,409,33,914
CATOOSA,8/24/2020,478,416,33,927
CATOOSA,8/25/2020,486,423,33,942
CATOOSA,8/26/2020,493,429,33,955
CATOOSA,8/27/2020,493,432,34,959
CATOOSA,8/28/2020,496,433,34,963
CATOOSA,8/29/2020,506,437,34,977
CATOOSA,8/30/2020,506,442,34,982
CATOOSA,8/31/2020,512,447,34,993
CATOOSA,9/1/2020,517,454,34,1005
CATOOSA,9/2/2020,521,462,34,1017
CATOOSA,9/3/2020,526,469,34,1029
CATOOSA,9/4/2020,531,472,34,1037
CATOOSA,9/5/2020,538,476,34,1048
CATOOSA,9/6/2020,544,479,34,1057
CATOOSA,9/7/2020,545,480,34,1059
CATOOSA,9/8/2020,549,485,34,1068
CATOOSA,9/9/2020,556,491,34,1081
CATOOSA,9/10/2020,566,498,34,1098
CATOOSA,9/11/2020,572,502,34,1108
CATOOSA,9/12/2020,575,508,34,1117
CATOOSA,9/13/2020,578,509,34,1121
CATOOSA,9/14/2020,583,512,34,1129
CATOOSA,9/15/2020,589,518,34,1141
CATOOSA,9/16/2020,593,521,36,1150
CATOOSA,9/17/2020,597,528,36,1161
CATOOSA,9/18/2020,606,532,38,1176
CATOOSA,9/19/2020,611,533,38,1182
CATOOSA,9/20/2020,616,534,38,1188
CATOOSA,9/21/2020,622,539,38,1199
CATOOSA,9/22/2020,631,546,38,1215
CATOOSA,9/23/2020,635,548,38,1221
CATOOSA,9/24/2020,639,551,38,1228
CATOOSA,9/25/2020,641,554,38,1233
CATOOSA,9/26/2020,642,555,38,1235
CATOOSA,9/27/2020,644,559,38,1241
CATOOSA,9/28/2020,650,568,38,1256
CATOOSA,9/29/2020,654,573,38,1265
CATOOSA,9/30/2020,656,574,38,1268
CATOOSA,10/1/2020,657,579,40,1276
CATOOSA,10/2/2020,660,579,40,1279
CATOOSA,10/3/2020,665,581,40,1286
CATOOSA,10/4/2020,666,584,40,1290
CATOOSA,10/5/2020,670,592,40,1302
CATOOSA,10/6/2020,676,594,40,1310
CATOOSA,10/7/2020,678,597,40,1315
CATOOSA,10/8/2020,684,598,40,1322
CATOOSA,10/9/2020,686,601,40,1327
CATOOSA,10/10/2020,687,602,40,1329
CATOOSA,10/11/2020,690,604,40,1334
CATOOSA,10/12/2020,691,607,40,1338
CATOOSA,10/13/2020,695,607,40,1342
CATOOSA,10/14/2020,697,611,40,1348
CATOOSA,10/15/2020,697,612,40,1349
CATOOSA,10/16/2020,697,613,40,1350
CATOOSA,10/17/2020,697,613,40,1350
CATOOSA,10/18/2020,697,613,40,1350
CATOOSA,10/19/2020,697,613,40,1350
CATOOSA,10/20/2020,697,613,40,1350
CHARLTON,1/1/2020,0,0,0,0
CHARLTON,1/2/2020,0,0,0,0
CHARLTON,1/3/2020,0,0,0,0
CHARLTON,1/4/2020,0,0,0,0
CHARLTON,1/5/2020,0,0,0,0
CHARLTON,1/6/2020,0,0,0,0
CHARLTON,1/7/2020,0,0,0,0
CHARLTON,1/8/2020,0,0,0,0
CHARLTON,1/9/2020,0,0,0,0
CHARLTON,1/10/2020,0,0,0,0
CHARLTON,1/11/2020,0,0,0,0
CHARLTON,1/12/2020,0,0,0,0
CHARLTON,1/13/2020,0,0,0,0
CHARLTON,1/14/2020,0,0,0,0
CHARLTON,1/15/2020,0,0,0,0
CHARLTON,1/16/2020,0,0,0,0
CHARLTON,1/17/2020,0,0,0,0
CHARLTON,1/18/2020,0,0,0,0
CHARLTON,1/19/2020,0,0,0,0
CHARLTON,1/20/2020,0,0,0,0
CHARLTON,1/21/2020,0,0,0,0
CHARLTON,1/22/2020,0,0,0,0
CHARLTON,1/23/2020,0,0,0,0
CHARLTON,1/24/2020,0,0,0,0
CHARLTON,1/25/2020,0,0,0,0
CHARLTON,1/26/2020,0,0,0,0
CHARLTON,1/27/2020,0,0,0,0
CHARLTON,1/28/2020,0,0,0,0
CHARLTON,1/29/2020,0,0,0,0
CHARLTON,1/30/2020,0,0,0,0
CHARLTON,1/31/2020,0,0,0,0
CHARLTON,2/1/2020,0,0,0,0
CHARLTON,2/2/2020,0,0,0,0
CHARLTON,2/3/2020,0,0,0,0
CHARLTON,2/4/2020,0,0,0,0
CHARLTON,2/5/2020,0,0,0,0
CHARLTON,2/6/2020,0,0,0,0
CHARLTON,2/7/2020,0,0,0,0
CHARLTON,2/8/2020,0,0,0,0
CHARLTON,2/9/2020,0,0,0,0
CHARLTON,2/10/2020,0,0,0,0
CHARLTON,2/11/2020,0,0,0,0
CHARLTON,2/12/2020,0,0,0,0
CHARLTON,2/13/2020,0,0,0,0
CHARLTON,2/14/2020,0,0,0,0
CHARLTON,2/15/2020,0,0,0,0
CHARLTON,2/16/2020,0,0,0,0
CHARLTON,2/17/2020,0,0,0,0
CHARLTON,2/18/2020,0,0,0,0
CHARLTON,2/19/2020,0,0,0,0
CHARLTON,2/20/2020,0,0,0,0
CHARLTON,2/21/2020,0,0,0,0
CHARLTON,2/22/2020,0,0,0,0
CHARLTON,2/23/2020,0,0,0,0
CHARLTON,2/24/2020,0,0,0,0
CHARLTON,2/25/2020,0,0,0,0
CHARLTON,2/26/2020,0,0,0,0
CHARLTON,2/27/2020,1,0,0,1
CHARLTON,2/28/2020,1,0,0,1
CHARLTON,2/29/2020,1,0,0,1
CHARLTON,3/1/2020,1,0,0,1
CHARLTON,3/2/2020,1,0,0,1
CHARLTON,3/3/2020,1,0,0,1
CHARLTON,3/4/2020,1,0,0,1
CHARLTON,3/5/2020,1,0,0,1
CHARLTON,3/6/2020,1,0,0,1
CHARLTON,3/7/2020,1,0,0,1
CHARLTON,3/8/2020,1,0,0,1
CHARLTON,3/9/2020,1,0,0,1
CHARLTON,3/10/2020,1,0,0,1
CHARLTON,3/11/2020,1,0,0,1
CHARLTON,3/12/2020,1,0,0,1
CHARLTON,3/13/2020,1,0,0,1
CHARLTON,3/14/2020,1,0,0,1
CHARLTON,3/15/2020,1,0,0,1
CHARLTON,3/16/2020,1,0,0,1
CHARLTON,3/17/2020,1,0,0,1
CHARLTON,3/18/2020,2,0,0,2
CHARLTON,3/19/2020,2,0,0,2
CHARLTON,3/20/2020,2,0,0,2
CHARLTON,3/21/2020,2,0,0,2
CHARLTON,3/22/2020,2,0,0,2
CHARLTON,3/23/2020,3,0,0,3
CHARLTON,3/24/2020,3,0,0,3
CHARLTON,3/25/2020,4,0,0,4
CHARLTON,3/26/2020,4,0,0,4
CHARLTON,3/27/2020,4,0,0,4
CHARLTON,3/28/2020,4,0,0,4
CHARLTON,3/29/2020,4,0,0,4
CHARLTON,3/30/2020,4,0,0,4
CHARLTON,3/31/2020,4,1,0,5
CHARLTON,4/1/2020,4,1,0,5
CHARLTON,4/2/2020,4,1,0,5
CHARLTON,4/3/2020,4,1,0,5
CHARLTON,4/4/2020,4,1,0,5
CHARLTON,4/5/2020,4,1,0,5
CHARLTON,4/6/2020,4,1,0,5
CHARLTON,4/7/2020,4,1,0,5
CHARLTON,4/8/2020,4,1,0,5
CHARLTON,4/9/2020,4,1,0,5
CHARLTON,4/10/2020,4,2,0,6
CHARLTON,4/11/2020,4,2,0,6
CHARLTON,4/12/2020,4,2,0,6
CHARLTON,4/13/2020,4,3,0,7
CHARLTON,4/14/2020,4,3,0,7
CHARLTON,4/15/2020,4,3,0,7
CHARLTON,4/16/2020,5,3,0,8
CHARLTON,4/17/2020,5,3,0,8
CHARLTON,4/18/2020,5,3,0,8
CHARLTON,4/19/2020,5,3,0,8
CHARLTON,4/20/2020,5,3,0,8
CHARLTON,4/21/2020,5,3,0,8
CHARLTON,4/22/2020,5,3,0,8
CHARLTON,4/23/2020,5,3,0,8
CHARLTON,4/24/2020,5,3,0,8
CHARLTON,4/25/2020,5,3,0,8
CHARLTON,4/26/2020,5,3,0,8
CHARLTON,4/27/2020,5,3,0,8
CHARLTON,4/28/2020,5,4,0,9
CHARLTON,4/29/2020,7,5,0,12
CHARLTON,4/30/2020,7,5,0,12
CHARLTON,5/1/2020,7,5,0,12
CHARLTON,5/2/2020,7,5,0,12
CHARLTON,5/3/2020,7,5,0,12
CHARLTON,5/4/2020,7,6,0,13
CHARLTON,5/5/2020,8,7,0,15
CHARLTON,5/6/2020,9,8,0,17
CHARLTON,5/7/2020,9,8,0,17
CHARLTON,5/8/2020,9,8,0,17
CHARLTON,5/9/2020,10,9,0,19
CHARLTON,5/10/2020,10,9,0,19
CHARLTON,5/11/2020,15,14,0,29
CHARLTON,5/12/2020,15,14,0,29
CHARLTON,5/13/2020,15,14,0,29
CHARLTON,5/14/2020,15,14,0,29
CHARLTON,5/15/2020,15,14,0,29
CHARLTON,5/16/2020,15,14,0,29
CHARLTON,5/17/2020,15,15,0,30
CHARLTON,5/18/2020,16,15,0,31
CHARLTON,5/19/2020,16,15,0,31
CHARLTON,5/20/2020,19,15,0,34
CHARLTON,5/21/2020,19,15,0,34
CHARLTON,5/22/2020,19,15,0,34
CHARLTON,5/23/2020,19,15,0,34
CHARLTON,5/24/2020,19,15,0,34
CHARLTON,5/25/2020,19,15,0,34
CHARLTON,5/26/2020,19,15,0,34
CHARLTON,5/27/2020,19,15,0,34
CHARLTON,5/28/2020,19,15,0,34
CHARLTON,5/29/2020,19,16,0,35
CHARLTON,5/30/2020,19,16,0,35
CHARLTON,5/31/2020,19,16,0,35
CHARLTON,6/1/2020,20,16,0,36
CHARLTON,6/2/2020,20,16,0,36
CHARLTON,6/3/2020,20,16,0,36
CHARLTON,6/4/2020,20,16,0,36
CHARLTON,6/5/2020,20,16,0,36
CHARLTON,6/6/2020,21,16,0,37
CHARLTON,6/7/2020,21,16,0,37
CHARLTON,6/8/2020,21,16,0,37
CHARLTON,6/9/2020,22,16,0,38
CHARLTON,6/10/2020,22,16,0,38
CHARLTON,6/11/2020,22,16,0,38
CHARLTON,6/12/2020,22,16,0,38
CHARLTON,6/13/2020,23,16,0,39
CHARLTON,6/14/2020,24,18,1,43
CHARLTON,6/15/2020,24,18,1,43
CHARLTON,6/16/2020,24,18,1,43
CHARLTON,6/17/2020,26,18,1,45
CHARLTON,6/18/2020,26,21,1,48
CHARLTON,6/19/2020,26,22,1,49
CHARLTON,6/20/2020,26,23,1,50
CHARLTON,6/21/2020,28,23,1,52
CHARLTON,6/22/2020,29,24,1,54
CHARLTON,6/23/2020,29,25,1,55
CHARLTON,6/24/2020,30,26,1,57
CHARLTON,6/25/2020,31,28,2,61
CHARLTON,6/26/2020,33,31,2,66
CHARLTON,6/27/2020,35,32,2,69
CHARLTON,6/28/2020,38,34,2,74
CHARLTON,6/29/2020,40,34,2,76
CHARLTON,6/30/2020,49,35,2,86
CHARLTON,7/1/2020,51,37,2,90
CHARLTON,7/2/2020,56,39,2,97
CHARLTON,7/3/2020,62,41,2,105
CHARLTON,7/4/2020,64,42,2,108
CHARLTON,7/5/2020,67,44,2,113
CHARLTON,7/6/2020,70,49,2,121
CHARLTON,7/7/2020,72,51,2,125
CHARLTON,7/8/2020,78,59,3,140
CHARLTON,7/9/2020,85,64,3,152
CHARLTON,7/10/2020,92,75,3,170
CHARLTON,7/11/2020,97,78,3,178
CHARLTON,7/12/2020,97,82,3,182
CHARLTON,7/13/2020,102,89,3,194
CHARLTON,7/14/2020,109,104,3,216
CHARLTON,7/15/2020,112,119,3,234
CHARLTON,7/16/2020,117,123,3,243
CHARLTON,7/17/2020,122,129,3,254
CHARLTON,7/18/2020,122,137,3,262
CHARLTON,7/19/2020,124,139,3,266
CHARLTON,7/20/2020,125,178,3,306
CHARLTON,7/21/2020,128,187,3,318
CHARLTON,7/22/2020,133,197,3,333
CHARLTON,7/23/2020,135,219,3,357
CHARLTON,7/24/2020,136,222,3,361
CHARLTON,7/25/2020,137,228,3,368
CHARLTON,7/26/2020,138,229,3,370
CHARLTON,7/27/2020,141,240,3,384
CHARLTON,7/28/2020,145,246,3,394
CHARLTON,7/29/2020,148,250,3,401
CHARLTON,7/30/2020,149,255,3,407
CHARLTON,7/31/2020,150,256,3,409
CHARLTON,8/1/2020,152,256,3,411
CHARLTON,8/2/2020,152,260,3,415
CHARLTON,8/3/2020,153,264,3,420
CHARLTON,8/4/2020,153,269,3,425
CHARLTON,8/5/2020,155,272,3,430
CHARLTON,8/6/2020,155,285,3,443
CHARLTON,8/7/2020,155,287,3,445
CHARLTON,8/8/2020,156,289,3,448
CHARLTON,8/9/2020,156,291,3,450
CHARLTON,8/10/2020,157,295,3,455
CHARLTON,8/11/2020,158,301,3,462
CHARLTON,8/12/2020,158,332,3,493
CHARLTON,8/13/2020,158,339,3,500
CHARLTON,8/14/2020,159,348,3,510
CHARLTON,8/15/2020,159,349,3,511
CHARLTON,8/16/2020,159,351,3,513
CHARLTON,8/17/2020,160,353,3,516
CHARLTON,8/18/2020,161,366,3,530
CHARLTON,8/19/2020,163,373,3,539
CHARLTON,8/20/2020,163,379,4,546
CHARLTON,8/21/2020,163,381,4,548
CHARLTON,8/22/2020,165,382,4,551
CHARLTON,8/23/2020,168,383,4,555
CHARLTON,8/24/2020,169,383,4,556
CHARLTON,8/25/2020,170,384,4,558
CHARLTON,8/26/2020,174,388,4,566
CHARLTON,8/27/2020,181,390,4,575
CHARLTON,8/28/2020,181,391,4,576
CHARLTON,8/29/2020,183,391,4,578
CHARLTON,8/30/2020,186,393,4,583
CHARLTON,8/31/2020,189,393,4,586
CHARLTON,9/1/2020,191,393,4,588
CHARLTON,9/2/2020,192,394,4,590
CHARLTON,9/3/2020,193,395,4,592
CHARLTON,9/4/2020,193,395,4,592
CHARLTON,9/5/2020,194,395,4,593
CHARLTON,9/6/2020,194,396,5,595
CHARLTON,9/7/2020,194,398,5,597
CHARLTON,9/8/2020,194,399,5,598
CHARLTON,9/9/2020,197,399,5,601
CHARLTON,9/10/2020,201,399,5,605
CHARLTON,9/11/2020,201,401,5,607
CHARLTON,9/12/2020,202,403,5,610
CHARLTON,9/13/2020,202,404,5,611
CHARLTON,9/14/2020,203,404,5,612
CHARLTON,9/15/2020,204,405,5,614
CHARLTON,9/16/2020,207,405,5,617
CHARLTON,9/17/2020,208,405,5,618
CHARLTON,9/18/2020,209,405,5,619
CHARLTON,9/19/2020,212,406,5,623
CHARLTON,9/20/2020,212,408,5,625
CHARLTON,9/21/2020,214,408,5,627
CHARLTON,9/22/2020,214,409,5,628
CHARLTON,9/23/2020,216,410,5,631
CHARLTON,9/24/2020,218,410,5,633
CHARLTON,9/25/2020,218,411,5,634
CHARLTON,9/26/2020,218,411,5,634
CHARLTON,9/27/2020,218,411,5,634
CHARLTON,9/28/2020,218,413,5,636
CHARLTON,9/29/2020,218,413,5,636
CHARLTON,9/30/2020,219,413,5,637
CHARLTON,10/1/2020,219,414,5,638
CHARLTON,10/2/2020,219,414,5,638
CHARLTON,10/3/2020,219,414,5,638
CHARLTON,10/4/2020,219,414,5,638
CHARLTON,10/5/2020,219,414,5,638
CHARLTON,10/6/2020,219,416,5,640
CHARLTON,10/7/2020,219,416,5,640
CHARLTON,10/8/2020,219,416,5,640
CHARLTON,10/9/2020,220,416,5,641
CHARLTON,10/10/2020,220,416,5,641
CHARLTON,10/11/2020,220,416,5,641
CHARLTON,10/12/2020,220,417,5,642
CHARLTON,10/13/2020,220,417,5,642
CHARLTON,10/14/2020,220,417,5,642
CHARLTON,10/15/2020,221,417,5,643
CHARLTON,10/16/2020,221,417,5,643
CHARLTON,10/17/2020,221,417,5,643
CHARLTON,10/18/2020,221,417,5,643
CHARLTON,10/19/2020,221,417,5,643
CHARLTON,10/20/2020,221,417,5,643
CHATHAM,1/1/2020,0,0,0,0
CHATHAM,1/2/2020,0,0,0,0
CHATHAM,1/3/2020,0,0,0,0
CHATHAM,1/4/2020,0,0,0,0
CHATHAM,1/5/2020,0,0,0,0
CHATHAM,1/6/2020,0,0,0,0
CHATHAM,1/7/2020,0,0,0,0
CHATHAM,1/8/2020,0,0,0,0
CHATHAM,1/9/2020,0,0,0,0
CHATHAM,1/10/2020,0,0,0,0
CHATHAM,1/11/2020,0,0,0,0
CHATHAM,1/12/2020,0,0,0,0
CHATHAM,1/13/2020,0,0,0,0
CHATHAM,1/14/2020,0,0,0,0
CHATHAM,1/15/2020,0,0,0,0
CHATHAM,1/16/2020,0,1,0,1
CHATHAM,1/17/2020,0,1,0,1
CHATHAM,1/18/2020,0,1,0,1
CHATHAM,1/19/2020,0,1,0,1
CHATHAM,1/20/2020,0,1,0,1
CHATHAM,1/21/2020,0,1,0,1
CHATHAM,1/22/2020,0,1,0,1
CHATHAM,1/23/2020,0,1,0,1
CHATHAM,1/24/2020,0,1,0,1
CHATHAM,1/25/2020,0,1,0,1
CHATHAM,1/26/2020,0,1,0,1
CHATHAM,1/27/2020,0,1,0,1
CHATHAM,1/28/2020,0,1,0,1
CANDLER,4/20/2020,6,3,0,9
CHATHAM,1/29/2020,0,1,0,1
CHATTAHOOCHEE,5/14/2020,6,12,0,18
BUTTS,1/5/2020,0,0,0,0
CHATHAM,1/30/2020,0,1,0,1
CHATTAHOOCHEE,5/15/2020,6,12,0,18
BUTTS,1/6/2020,0,0,0,0
CHATHAM,1/31/2020,0,1,0,1
CHATTAHOOCHEE,5/16/2020,6,12,0,18
BUTTS,1/7/2020,0,0,0,0
BUTTS,1/8/2020,0,0,0,0
BUTTS,1/9/2020,0,0,0,0
BUTTS,1/10/2020,0,0,0,0
BUTTS,1/11/2020,0,0,0,0
BUTTS,1/12/2020,0,0,0,0
BUTTS,1/13/2020,0,0,0,0
BUTTS,1/14/2020,0,0,0,0
BUTTS,1/15/2020,0,0,0,0
BUTTS,1/16/2020,0,0,0,0
BUTTS,1/17/2020,0,0,0,0
BUTTS,1/18/2020,0,0,0,0
BUTTS,1/19/2020,0,0,0,0
BUTTS,1/20/2020,0,0,0,0
BUTTS,1/21/2020,0,0,0,0
BUTTS,1/22/2020,0,0,0,0
BUTTS,1/23/2020,0,0,0,0
BUTTS,1/24/2020,0,0,0,0
BUTTS,1/25/2020,0,0,0,0
BUTTS,1/26/2020,0,0,0,0
BUTTS,1/27/2020,0,0,0,0
BUTTS,1/28/2020,0,0,0,0
BUTTS,1/29/2020,0,0,0,0
BUTTS,1/30/2020,0,0,0,0
BUTTS,1/31/2020,0,0,0,0
BUTTS,2/1/2020,0,0,0,0
BUTTS,2/2/2020,0,0,0,0
BUTTS,2/3/2020,0,0,0,0
BUTTS,2/4/2020,0,0,0,0
BUTTS,2/5/2020,0,0,0,0
BUTTS,2/6/2020,0,0,0,0
BUTTS,2/7/2020,0,0,0,0
BUTTS,2/8/2020,0,0,0,0
BUTTS,2/9/2020,0,0,0,0
BUTTS,2/10/2020,0,0,0,0
BUTTS,2/11/2020,0,0,0,0
BUTTS,2/12/2020,0,0,0,0
BUTTS,2/13/2020,0,0,0,0
CANDLER,4/21/2020,6,3,0,9
BUTTS,2/14/2020,0,0,0,0
BUTTS,2/15/2020,0,0,0,0
BUTTS,2/16/2020,0,0,0,0
BUTTS,2/17/2020,0,0,0,0
BUTTS,2/18/2020,0,0,0,0
BUTTS,2/19/2020,0,0,0,0
BUTTS,2/20/2020,0,0,0,0
BUTTS,2/21/2020,0,0,0,0
BUTTS,2/22/2020,0,0,0,0
BUTTS,2/23/2020,0,0,0,0
BUTTS,2/24/2020,0,0,0,0
BUTTS,2/25/2020,0,0,0,0
BUTTS,2/26/2020,0,0,0,0
BUTTS,2/27/2020,0,0,0,0
BUTTS,2/28/2020,0,0,0,0
BUTTS,2/29/2020,0,0,0,0
BUTTS,3/1/2020,0,0,0,0
BUTTS,3/2/2020,0,0,0,0
BUTTS,3/3/2020,0,0,0,0
BUTTS,3/4/2020,0,0,0,0
BUTTS,3/5/2020,0,0,0,0
BUTTS,3/6/2020,0,0,0,0
BUTTS,3/7/2020,0,0,0,0
BUTTS,3/8/2020,0,0,0,0
BUTTS,3/9/2020,0,0,0,0
BUTTS,3/10/2020,2,0,0,2
BUTTS,3/11/2020,2,0,0,2
BUTTS,3/12/2020,2,0,0,2
BUTTS,3/13/2020,3,0,0,3
BUTTS,3/14/2020,3,0,0,3
BUTTS,3/15/2020,4,1,0,5
BUTTS,3/16/2020,4,1,0,5
BUTTS,3/17/2020,4,2,0,6
BUTTS,3/18/2020,4,2,0,6
BUTTS,3/19/2020,5,2,0,7
BUTTS,3/20/2020,5,2,0,7
BUTTS,3/21/2020,5,2,0,7
BUTTS,3/22/2020,6,2,0,8
BUTTS,3/23/2020,7,2,0,9
BUTTS,3/24/2020,7,3,0,10
BUTTS,3/25/2020,9,4,0,13
BUTTS,3/26/2020,11,5,0,16
BUTTS,3/27/2020,11,5,0,16
BUTTS,3/28/2020,11,5,0,16
BUTTS,3/29/2020,11,5,0,16
BUTTS,3/30/2020,14,5,0,19
BUTTS,3/31/2020,14,7,0,21
BUTTS,4/1/2020,17,8,0,25
BUTTS,4/2/2020,17,9,0,26
BUTTS,4/3/2020,18,10,0,28
BUTTS,4/4/2020,18,11,0,29
BUTTS,4/5/2020,18,11,0,29
BUTTS,4/6/2020,19,11,0,30
BUTTS,4/7/2020,20,13,0,33
BUTTS,4/8/2020,22,13,0,35
BUTTS,4/9/2020,25,13,0,38
BUTTS,4/10/2020,26,14,0,40
BUTTS,4/11/2020,27,14,0,41
BUTTS,4/12/2020,27,15,0,42
BUTTS,4/13/2020,31,17,0,48
BUTTS,4/14/2020,39,25,0,64
BUTTS,4/15/2020,40,26,0,66
BUTTS,4/16/2020,48,28,0,76
BUTTS,4/17/2020,52,30,0,82
BUTTS,4/18/2020,54,32,0,86
BUTTS,4/19/2020,55,34,0,89
BUTTS,4/20/2020,84,46,1,131
BUTTS,4/21/2020,89,48,1,138
BUTTS,4/22/2020,90,49,1,140
BUTTS,4/23/2020,90,52,1,143
BUTTS,4/24/2020,92,52,1,145
BUTTS,4/25/2020,92,52,1,145
BUTTS,4/26/2020,92,52,1,145
BUTTS,4/27/2020,95,56,1,152
BUTTS,4/28/2020,103,60,2,165
BUTTS,4/29/2020,107,64,3,174
BUTTS,4/30/2020,107,68,3,178
BUTTS,5/1/2020,109,75,3,187
BUTTS,5/2/2020,110,75,3,188
BUTTS,5/3/2020,112,76,3,191
BUTTS,5/4/2020,113,77,3,193
BUTTS,5/5/2020,114,83,3,200
BUTTS,5/6/2020,116,87,3,206
BUTTS,5/7/2020,119,89,3,211
BUTTS,5/8/2020,119,91,3,213
BUTTS,5/9/2020,119,91,3,213
BUTTS,5/10/2020,120,91,3,214
BUTTS,5/11/2020,122,91,3,216
BUTTS,5/12/2020,122,94,3,219
BUTTS,5/13/2020,122,97,3,222
BUTTS,5/14/2020,122,97,3,222
BUTTS,5/15/2020,122,97,3,222
BUTTS,5/16/2020,122,97,3,222
BUTTS,5/17/2020,122,98,3,223
BUTTS,5/18/2020,124,101,3,228
BUTTS,5/19/2020,124,102,3,229
BUTTS,5/20/2020,125,105,3,233
BUTTS,5/21/2020,126,105,3,234
BUTTS,5/22/2020,126,106,4,236
BUTTS,5/23/2020,126,106,4,236
BUTTS,5/24/2020,127,107,4,238
BUTTS,5/25/2020,127,107,4,238
BUTTS,5/26/2020,127,109,4,240
BUTTS,5/27/2020,127,110,4,241
BUTTS,5/28/2020,127,112,4,243
BUTTS,5/29/2020,128,113,4,245
BUTTS,5/30/2020,128,114,4,246
BUTTS,5/31/2020,128,114,4,246
BUTTS,6/1/2020,128,116,4,248
BUTTS,6/2/2020,129,117,4,250
BUTTS,6/3/2020,130,118,4,252
BUTTS,6/4/2020,130,119,5,254
BUTTS,6/5/2020,130,119,5,254
BUTTS,6/6/2020,131,119,5,255
BUTTS,6/7/2020,132,119,5,256
BUTTS,6/8/2020,133,119,5,257
BUTTS,6/9/2020,134,120,5,259
BUTTS,6/10/2020,134,121,5,260
BUTTS,6/11/2020,134,122,5,261
BUTTS,6/12/2020,135,122,5,262
BUTTS,6/13/2020,136,122,5,263
BUTTS,6/14/2020,137,122,5,264
BUTTS,6/15/2020,138,123,5,266
BUTTS,6/16/2020,140,125,5,270
BUTTS,6/17/2020,141,130,5,276
BUTTS,6/18/2020,143,131,6,280
BUTTS,6/19/2020,143,132,6,281
BUTTS,6/20/2020,144,132,7,283
BUTTS,6/21/2020,144,132,7,283
BUTTS,6/22/2020,145,133,8,286
BUTTS,6/23/2020,145,136,8,289
BUTTS,6/24/2020,146,139,9,294
BUTTS,6/25/2020,149,142,9,300
BUTTS,6/26/2020,151,147,9,307
BUTTS,6/27/2020,152,149,9,310
BUTTS,6/28/2020,154,149,9,312
BUTTS,6/29/2020,157,157,11,325
BUTTS,6/30/2020,158,160,11,329
BUTTS,7/1/2020,160,163,11,334
BUTTS,7/2/2020,162,167,12,341
BUTTS,7/3/2020,163,169,14,346
BUTTS,7/4/2020,164,173,15,352
BUTTS,7/5/2020,169,174,15,358
BUTTS,7/6/2020,171,181,17,369
BUTTS,7/7/2020,172,181,17,370
BUTTS,7/8/2020,178,184,17,379
BUTTS,7/9/2020,180,186,17,383
BUTTS,7/10/2020,183,188,17,388
BUTTS,7/11/2020,188,191,17,396
BUTTS,7/12/2020,190,193,17,400
BUTTS,7/13/2020,195,194,18,407
BUTTS,7/14/2020,196,196,18,410
BUTTS,7/15/2020,200,198,21,419
BUTTS,7/16/2020,202,204,21,427
BUTTS,7/17/2020,202,208,22,432
BUTTS,7/18/2020,203,214,23,440
BUTTS,7/19/2020,204,215,23,442
BUTTS,7/20/2020,207,215,23,445
BUTTS,7/21/2020,210,218,23,451
BUTTS,7/22/2020,210,223,24,457
BUTTS,7/23/2020,211,225,24,460
BUTTS,7/24/2020,214,228,25,467
BUTTS,7/25/2020,217,232,26,475
BUTTS,7/26/2020,218,233,26,477
BUTTS,7/27/2020,221,238,28,487
BUTTS,7/28/2020,225,241,29,495
BUTTS,7/29/2020,225,242,29,496
BUTTS,7/30/2020,227,244,29,500
BUTTS,7/31/2020,228,247,29,504
BUTTS,8/1/2020,229,248,29,506
BUTTS,8/2/2020,230,249,29,508
BUTTS,8/3/2020,234,251,29,514
BUTTS,8/4/2020,237,252,30,519
BUTTS,8/5/2020,239,254,30,523
BUTTS,8/6/2020,241,256,31,528
BUTTS,8/7/2020,242,258,31,531
BUTTS,8/8/2020,243,261,31,535
BUTTS,8/9/2020,246,261,31,538
BUTTS,8/10/2020,246,263,31,540
BUTTS,8/11/2020,248,263,31,542
BUTTS,8/12/2020,252,263,31,546
BUTTS,8/13/2020,253,264,31,548
BUTTS,8/14/2020,254,264,31,549
BUTTS,8/15/2020,256,265,32,553
BUTTS,8/16/2020,256,266,32,554
BUTTS,8/17/2020,259,267,34,560
BUTTS,8/18/2020,260,269,34,563
BUTTS,8/19/2020,260,271,36,567
BUTTS,8/20/2020,263,272,37,572
BUTTS,8/21/2020,269,272,37,578
BUTTS,8/22/2020,270,272,37,579
BUTTS,8/23/2020,270,273,37,580
BUTTS,8/24/2020,272,274,37,583
BUTTS,8/25/2020,273,277,37,587
BUTTS,8/26/2020,274,278,37,589
BUTTS,8/27/2020,276,279,37,592
BUTTS,8/28/2020,278,279,37,594
BUTTS,8/29/2020,278,280,37,595
BUTTS,8/30/2020,279,280,37,596
BUTTS,8/31/2020,282,281,37,600
BUTTS,9/1/2020,284,283,37,604
BUTTS,9/2/2020,287,284,37,608
BUTTS,9/3/2020,290,288,38,616
BUTTS,9/4/2020,292,293,38,623
BUTTS,9/5/2020,294,293,38,625
BUTTS,9/6/2020,295,295,38,628
BUTTS,9/7/2020,297,296,38,631
BUTTS,9/8/2020,299,297,38,634
BUTTS,9/9/2020,299,298,38,635
BUTTS,9/10/2020,300,301,40,641
BUTTS,9/11/2020,301,301,40,642
BUTTS,9/12/2020,303,302,40,645
BUTTS,9/13/2020,303,303,40,646
BUTTS,9/14/2020,306,305,40,651
BUTTS,9/15/2020,308,306,40,654
BUTTS,9/16/2020,308,309,40,657
BUTTS,9/17/2020,308,310,40,658
BUTTS,9/18/2020,308,310,40,658
BUTTS,9/19/2020,308,312,40,660
BUTTS,9/20/2020,309,312,41,662
BUTTS,9/21/2020,309,313,41,663
BUTTS,9/22/2020,309,317,41,667
BUTTS,9/23/2020,315,321,41,677
BUTTS,9/24/2020,315,324,41,680
BUTTS,9/25/2020,317,326,41,684
BUTTS,9/26/2020,318,328,41,687
BUTTS,9/27/2020,318,331,42,691
BUTTS,9/28/2020,320,333,42,695
BUTTS,9/29/2020,322,336,42,700
BUTTS,9/30/2020,322,337,42,701
BUTTS,10/1/2020,323,338,42,703
BUTTS,10/2/2020,323,340,42,705
BUTTS,10/3/2020,323,340,42,705
BUTTS,10/4/2020,325,340,42,707
BUTTS,10/5/2020,326,342,42,710
BUTTS,10/6/2020,329,343,42,714
BUTTS,10/7/2020,329,343,42,714
BUTTS,10/8/2020,329,345,42,716
BUTTS,10/9/2020,331,345,42,718
BUTTS,10/10/2020,334,345,42,721
BUTTS,10/11/2020,335,345,42,722
BUTTS,10/12/2020,335,345,42,722
BUTTS,10/13/2020,335,346,42,723
BUTTS,10/14/2020,335,346,42,723
BUTTS,10/15/2020,335,346,42,723
BUTTS,10/16/2020,337,346,42,725
BUTTS,10/17/2020,337,346,42,725
BUTTS,10/18/2020,337,346,42,725
BUTTS,10/19/2020,337,346,42,725
BUTTS,10/20/2020,337,346,42,725
CANDLER,1/1/2020,0,0,0,0
CANDLER,1/2/2020,0,0,0,0
CANDLER,1/3/2020,0,0,0,0
CANDLER,1/4/2020,0,0,0,0
CANDLER,1/5/2020,0,0,0,0
CANDLER,1/6/2020,0,0,0,0
CANDLER,1/7/2020,0,0,0,0
CANDLER,1/8/2020,0,0,0,0
CANDLER,1/9/2020,0,0,0,0
CANDLER,1/10/2020,0,0,0,0
CANDLER,1/11/2020,0,0,0,0
CANDLER,1/12/2020,0,0,0,0
CANDLER,1/13/2020,0,0,0,0
CANDLER,1/14/2020,0,0,0,0
CANDLER,1/15/2020,0,0,0,0
CANDLER,1/16/2020,0,0,0,0
CANDLER,1/17/2020,0,0,0,0
CANDLER,1/18/2020,0,0,0,0
CANDLER,1/19/2020,0,0,0,0
CANDLER,1/20/2020,0,0,0,0
CANDLER,1/21/2020,0,0,0,0
CANDLER,1/22/2020,0,0,0,0
CANDLER,1/23/2020,0,0,0,0
CANDLER,1/24/2020,0,0,0,0
CANDLER,1/25/2020,0,0,0,0
CANDLER,1/26/2020,0,0,0,0
CANDLER,1/27/2020,0,0,0,0
CANDLER,1/28/2020,0,0,0,0
CANDLER,1/29/2020,0,0,0,0
CANDLER,1/30/2020,0,0,0,0
CANDLER,1/31/2020,0,0,0,0
CANDLER,2/1/2020,0,0,0,0
CANDLER,2/2/2020,0,0,0,0
CANDLER,2/3/2020,0,0,0,0
CANDLER,2/4/2020,0,0,0,0
CANDLER,2/5/2020,0,0,0,0
CANDLER,2/6/2020,0,0,0,0
CANDLER,2/7/2020,0,0,0,0
CANDLER,2/8/2020,0,0,0,0
CANDLER,2/9/2020,0,0,0,0
CANDLER,2/10/2020,0,0,0,0
CANDLER,2/11/2020,0,0,0,0
CANDLER,2/12/2020,0,0,0,0
CANDLER,2/13/2020,0,0,0,0
CANDLER,2/14/2020,0,0,0,0
CANDLER,2/15/2020,0,0,0,0
CANDLER,2/16/2020,0,0,0,0
CANDLER,2/17/2020,0,0,0,0
CANDLER,2/18/2020,0,0,0,0
CANDLER,2/19/2020,0,0,0,0
CANDLER,2/20/2020,0,0,0,0
CANDLER,2/21/2020,0,0,0,0
CANDLER,2/22/2020,0,0,0,0
CANDLER,2/23/2020,0,0,0,0
CANDLER,2/24/2020,0,0,0,0
CANDLER,2/25/2020,0,0,0,0
CANDLER,2/26/2020,0,0,0,0
CANDLER,2/27/2020,0,0,0,0
CANDLER,2/28/2020,0,0,0,0
CANDLER,2/29/2020,0,0,0,0
CANDLER,3/1/2020,0,0,0,0
CANDLER,3/2/2020,0,0,0,0
CANDLER,3/3/2020,0,0,0,0
CANDLER,3/4/2020,0,0,0,0
CANDLER,3/5/2020,0,0,0,0
CANDLER,3/6/2020,0,0,0,0
CANDLER,3/7/2020,0,0,0,0
CANDLER,3/8/2020,0,0,0,0
CANDLER,3/9/2020,0,0,0,0
CANDLER,3/10/2020,0,0,0,0
CANDLER,3/11/2020,0,0,0,0
CANDLER,3/12/2020,0,0,0,0
CANDLER,3/13/2020,0,0,0,0
CANDLER,3/14/2020,0,0,0,0
CANDLER,3/15/2020,1,0,0,1
CANDLER,3/16/2020,2,0,0,2
CANDLER,3/17/2020,2,0,0,2
CANDLER,3/18/2020,2,0,0,2
CANDLER,3/19/2020,2,0,0,2
CANDLER,3/20/2020,3,0,0,3
CANDLER,3/21/2020,3,0,0,3
CANDLER,3/22/2020,3,1,0,4
CANDLER,3/23/2020,3,1,0,4
CANDLER,3/24/2020,3,1,0,4
CANDLER,3/25/2020,3,1,0,4
CANDLER,3/26/2020,3,1,0,4
CANDLER,3/27/2020,3,1,0,4
CANDLER,3/28/2020,3,1,0,4
CANDLER,3/29/2020,3,1,0,4
CANDLER,3/30/2020,3,2,0,5
CANDLER,3/31/2020,4,2,0,6
CANDLER,4/1/2020,5,2,0,7
CANDLER,4/2/2020,5,2,0,7
CANDLER,4/3/2020,5,2,0,7
CANDLER,4/4/2020,5,2,0,7
CANDLER,4/5/2020,5,2,0,7
CANDLER,4/6/2020,5,2,0,7
CANDLER,4/7/2020,5,2,0,7
CANDLER,4/8/2020,5,3,0,8
CANDLER,4/9/2020,5,3,0,8
CANDLER,4/10/2020,6,3,0,9
CANDLER,4/11/2020,6,3,0,9
CANDLER,4/12/2020,6,3,0,9
CANDLER,4/13/2020,6,3,0,9
CANDLER,4/14/2020,6,3,0,9
CANDLER,4/15/2020,6,3,0,9
CANDLER,4/16/2020,6,3,0,9
CANDLER,4/17/2020,6,3,0,9
CANDLER,4/18/2020,6,3,0,9
CANDLER,4/19/2020,6,3,0,9
CHATHAM,2/1/2020,0,1,0,1
CHATHAM,2/2/2020,0,1,0,1
CHATHAM,2/3/2020,0,1,0,1
CHATHAM,2/4/2020,0,1,0,1
CHATHAM,2/5/2020,0,1,0,1
CHATHAM,2/6/2020,0,1,0,1
CHATHAM,2/7/2020,0,1,0,1
CHATHAM,2/8/2020,0,1,0,1
CHATHAM,2/9/2020,0,1,0,1
CHATHAM,2/10/2020,0,1,0,1
CHATHAM,2/11/2020,0,1,0,1
CHATHAM,2/12/2020,0,1,0,1
CHATHAM,2/13/2020,0,1,0,1
CHATHAM,2/14/2020,0,1,0,1
CHATHAM,2/15/2020,0,1,0,1
CHATHAM,2/16/2020,0,1,0,1
CHATHAM,2/17/2020,0,1,0,1
CHATHAM,2/18/2020,0,1,0,1
CHATHAM,2/19/2020,0,1,0,1
CHATHAM,2/20/2020,0,2,0,2
CANDLER,4/22/2020,6,3,0,9
CHATHAM,2/21/2020,0,2,0,2
CHATTAHOOCHEE,5/17/2020,7,12,0,19
CHATHAM,2/22/2020,0,2,0,2
CHATHAM,2/23/2020,0,2,0,2
CHATHAM,2/24/2020,0,2,0,2
CHATHAM,2/25/2020,1,2,0,3
CHATHAM,2/26/2020,1,2,0,3
CHATHAM,2/27/2020,1,2,0,3
CHATHAM,2/28/2020,1,2,0,3
CHATHAM,2/29/2020,1,2,0,3
CHATHAM,3/1/2020,1,2,0,3
CHATHAM,3/2/2020,1,2,0,3
CHATHAM,3/3/2020,1,2,0,3
CHATHAM,3/4/2020,1,2,0,3
CHATHAM,3/5/2020,1,2,0,3
CHATHAM,3/6/2020,1,3,0,4
CHATHAM,3/7/2020,1,3,0,4
CHATHAM,3/8/2020,2,4,0,6
CHATHAM,3/9/2020,3,5,0,8
CHATHAM,3/10/2020,3,5,0,8
CHATHAM,3/11/2020,5,6,0,11
CHATHAM,3/12/2020,5,6,0,11
CHATHAM,3/13/2020,7,7,0,14
CHATHAM,3/14/2020,9,9,0,18
CHATHAM,3/15/2020,10,9,0,19
CHATHAM,3/16/2020,11,16,0,27
CHATHAM,3/17/2020,13,19,0,32
CHATHAM,3/18/2020,20,23,0,43
CHATHAM,3/19/2020,24,27,0,51
CHATHAM,3/20/2020,30,30,0,60
CHATHAM,3/21/2020,34,34,0,68
CHATHAM,3/22/2020,36,36,0,72
CHATHAM,3/23/2020,39,38,0,77
CHATHAM,3/24/2020,42,43,0,85
CHATHAM,3/25/2020,48,45,0,93
CHATHAM,3/26/2020,50,45,0,95
CHATHAM,3/27/2020,52,47,0,99
CHATHAM,3/28/2020,56,48,0,104
CHATHAM,3/29/2020,59,50,0,109
CHATHAM,3/30/2020,67,54,0,121
CHATHAM,3/31/2020,70,57,0,127
CHATHAM,4/1/2020,75,58,0,133
CHATHAM,4/2/2020,77,63,0,140
CHATHAM,4/3/2020,80,68,0,148
CHATHAM,4/4/2020,82,70,0,152
CHATHAM,4/5/2020,84,71,0,155
CHATHAM,4/6/2020,87,75,0,162
CHATHAM,4/7/2020,90,76,0,166
CHATHAM,4/8/2020,93,77,0,170
CHATHAM,4/9/2020,97,77,0,174
CHATHAM,4/10/2020,98,80,0,178
CHATHAM,4/11/2020,99,83,0,182
CHATHAM,4/12/2020,102,85,0,187
CHATHAM,4/13/2020,103,91,0,194
CHATHAM,4/14/2020,107,93,0,200
CHATHAM,4/15/2020,109,94,0,203
CHATHAM,4/16/2020,111,96,0,207
CHATHAM,4/17/2020,117,98,1,216
CHATHAM,4/18/2020,120,103,1,224
CHATHAM,4/19/2020,120,103,1,224
CHATHAM,4/20/2020,125,108,1,234
CHATHAM,4/21/2020,133,112,1,246
CHATHAM,4/22/2020,137,113,1,251
CHATHAM,4/23/2020,139,114,1,254
CHATHAM,4/24/2020,140,120,1,261
CHATHAM,4/25/2020,141,120,1,262
CHATHAM,4/26/2020,142,121,1,264
CHATHAM,4/27/2020,145,126,1,272
CHATHAM,4/28/2020,151,129,1,281
CHATHAM,4/29/2020,159,130,1,290
CHATHAM,4/30/2020,167,138,1,306
CHATHAM,5/1/2020,173,141,1,315
CHATHAM,5/2/2020,174,144,1,319
CHATHAM,5/3/2020,177,147,1,325
CHATHAM,5/4/2020,181,152,1,334
CHATHAM,5/5/2020,187,157,1,345
CHATHAM,5/6/2020,190,161,1,352
CHATHAM,5/7/2020,195,163,1,359
CHATHAM,5/8/2020,199,172,1,372
CHATHAM,5/9/2020,207,173,1,381
CHATHAM,5/10/2020,208,173,1,382
CHATHAM,5/11/2020,213,179,1,393
CHATHAM,5/12/2020,217,183,1,401
CHATHAM,5/13/2020,223,187,1,411
CHATHAM,5/14/2020,227,194,1,422
CHATHAM,5/15/2020,232,201,1,434
CHATHAM,5/16/2020,239,210,1,450
CHATHAM,5/17/2020,244,215,1,460
CHATHAM,5/18/2020,251,217,1,469
CHATHAM,5/19/2020,251,219,1,471
CHATHAM,5/20/2020,253,226,1,480
CHATHAM,5/21/2020,253,232,1,486
CHATHAM,5/22/2020,264,238,1,503
CHATHAM,5/23/2020,269,239,1,509
CHATHAM,5/24/2020,271,242,1,514
CHATHAM,5/25/2020,276,248,1,525
CHATHAM,5/26/2020,280,250,1,531
CHATHAM,5/27/2020,285,256,1,542
CHATHAM,5/28/2020,293,265,1,559
CHATHAM,5/29/2020,304,275,1,580
CHATHAM,5/30/2020,310,275,1,586
CHATHAM,5/31/2020,312,277,1,590
CHATHAM,6/1/2020,315,279,1,595
CHATHAM,6/2/2020,317,282,1,600
CHATHAM,6/3/2020,323,286,1,610
CHATHAM,6/4/2020,326,291,1,618
CHATHAM,6/5/2020,328,296,1,625
CHATHAM,6/6/2020,336,305,1,642
CHATHAM,6/7/2020,338,307,1,646
CHATHAM,6/8/2020,353,318,1,672
CHATHAM,6/9/2020,361,327,1,689
CHATHAM,6/10/2020,375,341,1,717
CHATHAM,6/11/2020,398,354,1,753
CHATHAM,6/12/2020,407,369,1,777
CHATHAM,6/13/2020,417,376,1,794
CHATHAM,6/14/2020,428,382,1,811
CHATHAM,6/15/2020,466,404,1,871
CHATHAM,6/16/2020,502,432,1,935
CHATHAM,6/17/2020,533,461,3,997
CHATHAM,6/18/2020,561,484,3,1048
CHATHAM,6/19/2020,604,507,4,1115
CHATHAM,6/20/2020,632,527,4,1163
CHATHAM,6/21/2020,663,550,4,1217
CHATHAM,6/22/2020,718,603,6,1327
CHATHAM,6/23/2020,769,649,7,1425
CHATHAM,6/24/2020,826,691,7,1524
CHATHAM,6/25/2020,870,744,7,1621
CHATHAM,6/26/2020,940,791,7,1738
CHATHAM,6/27/2020,986,812,9,1807
CHATHAM,6/28/2020,1009,832,11,1852
CHATHAM,6/29/2020,1082,913,12,2007
CHATHAM,6/30/2020,1163,981,12,2156
CHATHAM,7/1/2020,1245,1036,15,2296
CHATHAM,7/2/2020,1314,1101,24,2439
CHATHAM,7/3/2020,1364,1149,26,2539
CHATHAM,7/4/2020,1389,1176,26,2591
CHATHAM,7/5/2020,1430,1213,29,2672
CHATHAM,7/6/2020,1525,1312,37,2874
CHATHAM,7/7/2020,1618,1380,42,3040
CHATHAM,7/8/2020,1717,1453,46,3216
CHATHAM,7/9/2020,1802,1527,51,3380
CHATHAM,7/10/2020,1888,1577,57,3522
CHATHAM,7/11/2020,1946,1613,59,3618
CHATHAM,7/12/2020,1982,1631,60,3673
CHATHAM,7/13/2020,2072,1715,69,3856
CHATHAM,7/14/2020,2164,1797,71,4032
CHATHAM,7/15/2020,2258,1853,77,4188
CHATHAM,7/16/2020,2347,1903,80,4330
CHATHAM,7/17/2020,2417,1957,81,4455
CHATHAM,7/18/2020,2479,1986,82,4547
CHATHAM,7/19/2020,2517,2019,84,4620
CHATHAM,7/20/2020,2601,2071,88,4760
CHATHAM,7/21/2020,2654,2104,92,4850
CHATHAM,7/22/2020,2710,2148,93,4951
CHATHAM,7/23/2020,2763,2169,99,5031
CHATHAM,7/24/2020,2827,2203,101,5131
CHATHAM,7/25/2020,2866,2228,102,5196
CHATHAM,7/26/2020,2894,2244,105,5243
CHATHAM,7/27/2020,2963,2307,106,5376
CHATHAM,7/28/2020,3012,2345,108,5465
CHATHAM,7/29/2020,3062,2390,108,5560
CHATHAM,7/30/2020,3107,2420,109,5636
CHATHAM,7/31/2020,3150,2446,114,5710
CHATHAM,8/1/2020,3195,2475,115,5785
CHATHAM,8/2/2020,3219,2498,115,5832
CHATHAM,8/3/2020,3245,2536,116,5897
CHATHAM,8/4/2020,3312,2595,121,6028
CHATHAM,8/5/2020,3361,2626,122,6109
CHATHAM,8/6/2020,3394,2650,128,6172
CHATHAM,8/7/2020,3428,2690,129,6247
CHATHAM,8/8/2020,3453,2716,132,6301
CHATHAM,8/9/2020,3470,2727,133,6330
CHATHAM,8/10/2020,3522,2764,135,6421
CHATHAM,8/11/2020,3558,2799,136,6493
CHATHAM,8/12/2020,3602,2833,138,6573
CHATHAM,8/13/2020,3624,2861,138,6623
CHATHAM,8/14/2020,3661,2894,138,6693
CHATHAM,8/15/2020,3688,2912,140,6740
CHATHAM,8/16/2020,3706,2928,141,6775
CHATHAM,8/17/2020,3742,2961,141,6844
CHATHAM,8/18/2020,3780,2980,142,6902
CHATHAM,8/19/2020,3809,2995,142,6946
CHATHAM,8/20/2020,3832,3021,144,6997
CHATHAM,8/21/2020,3865,3043,151,7059
CHATHAM,8/22/2020,3892,3054,151,7097
CHATHAM,8/23/2020,3912,3068,151,7131
CHATHAM,8/24/2020,3954,3103,152,7209
CHATHAM,8/25/2020,3989,3130,152,7271
CHATHAM,8/26/2020,4019,3160,152,7331
CHATHAM,8/27/2020,4042,3184,152,7378
CHATHAM,8/28/2020,4072,3210,153,7435
CHATHAM,8/29/2020,4092,3225,153,7470
CHATHAM,8/30/2020,4107,3242,153,7502
CHATHAM,8/31/2020,4132,3282,153,7567
CHATHAM,9/1/2020,4168,3310,153,7631
CHATHAM,9/2/2020,4199,3330,153,7682
CHATHAM,9/3/2020,4232,3352,154,7738
CHATHAM,9/4/2020,4260,3367,155,7782
CHATHAM,9/5/2020,4280,3377,155,7812
CHATHAM,9/6/2020,4304,3387,155,7846
CHATHAM,9/7/2020,4335,3400,155,7890
CHATHAM,9/8/2020,4363,3431,155,7949
CHATHAM,9/9/2020,4382,3444,155,7981
CHATHAM,9/10/2020,4410,3461,155,8026
CHATHAM,9/11/2020,4444,3482,155,8081
CHATHAM,9/12/2020,4468,3492,155,8115
CHATHAM,9/13/2020,4490,3505,155,8150
CHATHAM,9/14/2020,4522,3530,155,8207
CHATHAM,9/15/2020,4550,3545,156,8251
CHATHAM,9/16/2020,4567,3562,157,8286
CHATHAM,9/17/2020,4594,3581,157,8332
CHATHAM,9/18/2020,4615,3601,157,8373
CHATHAM,9/19/2020,4627,3611,157,8395
CHATHAM,9/20/2020,4636,3621,157,8414
CHATHAM,9/21/2020,4654,3636,157,8447
CHATHAM,9/22/2020,4676,3653,157,8486
CHATHAM,9/23/2020,4698,3672,157,8527
CHATHAM,9/24/2020,4716,3688,157,8561
CHATHAM,9/25/2020,4740,3696,157,8593
CHATHAM,9/26/2020,4752,3705,157,8614
CHATHAM,9/27/2020,4769,3722,157,8648
CHATHAM,9/28/2020,4785,3742,157,8684
CHATHAM,9/29/2020,4803,3759,157,8719
CHATHAM,9/30/2020,4819,3775,158,8752
CHATHAM,10/1/2020,4827,3788,158,8773
CHATHAM,10/2/2020,4842,3798,158,8798
CHATHAM,10/3/2020,4860,3808,158,8826
CHATHAM,10/4/2020,4868,3816,158,8842
CHATHAM,10/5/2020,4886,3836,158,8880
CHATHAM,10/6/2020,4898,3848,158,8904
CHATHAM,10/7/2020,4908,3857,158,8923
CHATHAM,10/8/2020,4922,3869,158,8949
CHATHAM,10/9/2020,4934,3884,158,8976
CHATHAM,10/10/2020,4953,3890,158,9001
CHATHAM,10/11/2020,4958,3900,158,9016
CHATHAM,10/12/2020,4977,3912,158,9047
CHATHAM,10/13/2020,4996,3923,158,9077
CHATHAM,10/14/2020,5009,3929,159,9097
CHATHAM,10/15/2020,5025,3941,159,9125
CHATHAM,10/16/2020,5039,3950,159,9148
CHATHAM,10/17/2020,5049,3955,159,9163
CHATHAM,10/18/2020,5051,3961,159,9171
CHATHAM,10/19/2020,5054,3962,159,9175
CHATHAM,10/20/2020,5054,3962,159,9175
CHATTAHOOCHEE,1/1/2020,0,0,0,0
CHATTAHOOCHEE,1/2/2020,0,0,0,0
CHATTAHOOCHEE,1/3/2020,0,0,0,0
CHATTAHOOCHEE,1/4/2020,0,0,0,0
CHATTAHOOCHEE,1/5/2020,0,0,0,0
CHATTAHOOCHEE,1/6/2020,0,0,0,0
CHATTAHOOCHEE,1/7/2020,0,0,0,0
CHATTAHOOCHEE,1/8/2020,0,0,0,0
CHATTAHOOCHEE,1/9/2020,0,0,0,0
CHATTAHOOCHEE,1/10/2020,0,0,0,0
CHATTAHOOCHEE,1/11/2020,0,0,0,0
CHATTAHOOCHEE,1/12/2020,0,0,0,0
CHATTAHOOCHEE,1/13/2020,0,0,0,0
CHATTAHOOCHEE,1/14/2020,0,0,0,0
CHATTAHOOCHEE,1/15/2020,0,0,0,0
CHATTAHOOCHEE,1/16/2020,0,0,0,0
CHATTAHOOCHEE,1/17/2020,0,0,0,0
CHATTAHOOCHEE,1/18/2020,0,0,0,0
CHATTAHOOCHEE,1/19/2020,0,0,0,0
CHATTAHOOCHEE,1/20/2020,0,0,0,0
CHATTAHOOCHEE,1/21/2020,0,0,0,0
CHATTAHOOCHEE,1/22/2020,0,0,0,0
CHATTAHOOCHEE,1/23/2020,0,0,0,0
CHATTAHOOCHEE,1/24/2020,0,0,0,0
CHATTAHOOCHEE,1/25/2020,0,0,0,0
CHATTAHOOCHEE,1/26/2020,0,0,0,0
CHATTAHOOCHEE,1/27/2020,0,0,0,0
CHATTAHOOCHEE,1/28/2020,0,0,0,0
CHATTAHOOCHEE,1/29/2020,0,0,0,0
CHATTAHOOCHEE,1/30/2020,0,0,0,0
CHATTAHOOCHEE,1/31/2020,0,0,0,0
CHATTAHOOCHEE,2/1/2020,0,0,0,0
CHATTAHOOCHEE,2/2/2020,0,0,0,0
CHATTAHOOCHEE,2/3/2020,0,0,0,0
CHATTAHOOCHEE,2/4/2020,0,0,0,0
CHATTAHOOCHEE,2/5/2020,0,0,0,0
CHATTAHOOCHEE,2/6/2020,0,0,0,0
CHATTAHOOCHEE,2/7/2020,0,0,0,0
CHATTAHOOCHEE,2/8/2020,0,0,0,0
CHATTAHOOCHEE,2/9/2020,0,0,0,0
CHATTAHOOCHEE,2/10/2020,0,0,0,0
CHATTAHOOCHEE,2/11/2020,0,0,0,0
CHATTAHOOCHEE,2/12/2020,0,0,0,0
CHATTAHOOCHEE,2/13/2020,0,0,0,0
CHATTAHOOCHEE,2/14/2020,0,0,0,0
CHATTAHOOCHEE,2/15/2020,0,0,0,0
CHATTAHOOCHEE,2/16/2020,0,0,0,0
CHATTAHOOCHEE,2/17/2020,0,0,0,0
CHATTAHOOCHEE,2/18/2020,0,0,0,0
CHATTAHOOCHEE,2/19/2020,0,0,0,0
CHATTAHOOCHEE,2/20/2020,0,0,0,0
CHATTAHOOCHEE,2/21/2020,0,0,0,0
CHATTAHOOCHEE,2/22/2020,0,0,0,0
CHATTAHOOCHEE,2/23/2020,0,0,0,0
CHATTAHOOCHEE,2/24/2020,0,0,0,0
CHATTAHOOCHEE,2/25/2020,0,0,0,0
CHATTAHOOCHEE,2/26/2020,0,0,0,0
CHATTAHOOCHEE,2/27/2020,0,0,0,0
CHATTAHOOCHEE,2/28/2020,0,0,0,0
CHATTAHOOCHEE,2/29/2020,0,0,0,0
CHATTAHOOCHEE,3/1/2020,0,0,0,0
CHATTAHOOCHEE,3/2/2020,0,0,0,0
CHATTAHOOCHEE,3/3/2020,0,0,0,0
CHATTAHOOCHEE,3/4/2020,0,0,0,0
CHATTAHOOCHEE,3/5/2020,0,0,0,0
CHATTAHOOCHEE,3/6/2020,0,0,0,0
CHATTAHOOCHEE,3/7/2020,0,0,0,0
CHATTAHOOCHEE,3/8/2020,0,0,0,0
CHATTAHOOCHEE,3/9/2020,0,0,0,0
CHATTAHOOCHEE,3/10/2020,0,0,0,0
CHATTAHOOCHEE,3/11/2020,0,0,0,0
CHATTAHOOCHEE,3/12/2020,0,0,0,0
CHATTAHOOCHEE,3/13/2020,0,0,0,0
CHATTAHOOCHEE,3/14/2020,0,1,0,1
CHATTAHOOCHEE,3/15/2020,0,1,0,1
CHATTAHOOCHEE,3/16/2020,1,1,0,2
CHATTAHOOCHEE,3/17/2020,1,1,0,2
CHATTAHOOCHEE,3/18/2020,1,1,0,2
CHATTAHOOCHEE,3/19/2020,1,1,0,2
CHATTAHOOCHEE,3/20/2020,1,1,0,2
CHATTAHOOCHEE,3/21/2020,1,1,0,2
CHATTAHOOCHEE,3/22/2020,1,1,0,2
CHATTAHOOCHEE,3/23/2020,1,1,0,2
CHATTAHOOCHEE,3/24/2020,1,1,0,2
CHATTAHOOCHEE,3/25/2020,1,1,0,2
CHATTAHOOCHEE,3/26/2020,1,1,0,2
CHATTAHOOCHEE,3/27/2020,1,1,0,2
CHATTAHOOCHEE,3/28/2020,1,1,0,2
CHATTAHOOCHEE,3/29/2020,1,1,0,2
CHATTAHOOCHEE,3/30/2020,1,1,0,2
CHATTAHOOCHEE,3/31/2020,1,1,0,2
CHATTAHOOCHEE,4/1/2020,1,1,0,2
CHATTAHOOCHEE,4/2/2020,1,1,0,2
CHATTAHOOCHEE,4/3/2020,1,1,0,2
CHATTAHOOCHEE,4/4/2020,1,1,0,2
CHATTAHOOCHEE,4/5/2020,1,1,0,2
CHATTAHOOCHEE,4/6/2020,1,2,0,3
CHATTAHOOCHEE,4/7/2020,1,2,0,3
CHATTAHOOCHEE,4/8/2020,1,2,0,3
CHATTAHOOCHEE,4/9/2020,1,2,0,3
CHATTAHOOCHEE,4/10/2020,1,2,0,3
CHATTAHOOCHEE,4/11/2020,1,2,0,3
CHATTAHOOCHEE,4/12/2020,1,2,0,3
CHATTAHOOCHEE,4/13/2020,2,2,0,4
CHATTAHOOCHEE,4/14/2020,2,2,0,4
CHATTAHOOCHEE,4/15/2020,3,2,0,5
CHATTAHOOCHEE,4/16/2020,3,2,0,5
CHATTAHOOCHEE,4/17/2020,4,2,0,6
CHATTAHOOCHEE,4/18/2020,4,2,0,6
CHATTAHOOCHEE,4/19/2020,4,2,0,6
CHATTAHOOCHEE,4/20/2020,4,2,0,6
CHATTAHOOCHEE,4/21/2020,4,3,0,7
CHATTAHOOCHEE,4/22/2020,4,3,0,7
CHATTAHOOCHEE,4/23/2020,4,3,0,7
CHATTAHOOCHEE,4/24/2020,4,3,0,7
CHATTAHOOCHEE,4/25/2020,4,3,0,7
CHATTAHOOCHEE,4/26/2020,4,3,0,7
CHATTAHOOCHEE,4/27/2020,4,3,0,7
CHATTAHOOCHEE,4/28/2020,4,4,0,8
CHATTAHOOCHEE,4/29/2020,4,6,0,10
CHATTAHOOCHEE,4/30/2020,4,6,0,10
CHATTAHOOCHEE,5/1/2020,4,6,0,10
CHATTAHOOCHEE,5/2/2020,4,6,0,10
CHATTAHOOCHEE,5/3/2020,4,6,0,10
CHATTAHOOCHEE,5/4/2020,4,6,0,10
CHATTAHOOCHEE,5/5/2020,4,8,0,12
CHATTAHOOCHEE,5/6/2020,4,8,0,12
CHATTAHOOCHEE,5/7/2020,5,10,0,15
CHATTAHOOCHEE,5/8/2020,5,10,0,15
CHATTAHOOCHEE,5/9/2020,5,10,0,15
CHATTAHOOCHEE,5/10/2020,5,10,0,15
CHATTAHOOCHEE,5/11/2020,5,10,0,15
CHATTAHOOCHEE,5/12/2020,5,10,0,15
CHATTAHOOCHEE,5/13/2020,6,10,0,16
CHATTAHOOCHEE,5/18/2020,8,12,0,20
CHATTAHOOCHEE,5/19/2020,8,12,0,20
CHATTAHOOCHEE,5/20/2020,8,15,0,23
CHATTAHOOCHEE,5/21/2020,8,18,0,26
CHATTAHOOCHEE,5/22/2020,8,21,0,29
CHATTAHOOCHEE,5/23/2020,9,23,0,32
CHATTAHOOCHEE,5/24/2020,9,23,0,32
CHATTAHOOCHEE,5/25/2020,9,31,0,40
CHATTAHOOCHEE,5/26/2020,10,37,0,47
CHATTAHOOCHEE,5/27/2020,10,44,0,54
CHATTAHOOCHEE,5/28/2020,11,50,0,61
CHATTAHOOCHEE,5/29/2020,12,146,0,158
CHATTAHOOCHEE,5/30/2020,12,159,0,171
CHATTAHOOCHEE,5/31/2020,13,169,0,182
CHATTAHOOCHEE,6/1/2020,15,175,0,190
CHATTAHOOCHEE,6/2/2020,15,180,0,195
CHATTAHOOCHEE,6/3/2020,15,185,0,200
CHATTAHOOCHEE,6/4/2020,15,190,0,205
CHATTAHOOCHEE,6/5/2020,15,196,0,211
CHATTAHOOCHEE,6/6/2020,15,200,0,215
CHATTAHOOCHEE,6/7/2020,15,205,0,220
CHATTAHOOCHEE,6/8/2020,15,240,0,255
CHATTAHOOCHEE,6/9/2020,16,256,0,272
CHATTAHOOCHEE,6/10/2020,16,268,0,284
CHATTAHOOCHEE,6/11/2020,16,298,0,314
CHATTAHOOCHEE,6/12/2020,16,310,0,326
CHATTAHOOCHEE,6/13/2020,18,313,0,331
CHATTAHOOCHEE,6/14/2020,18,314,0,332
CHATTAHOOCHEE,6/15/2020,19,325,0,344
CHATTAHOOCHEE,6/16/2020,19,329,0,348
CHATTAHOOCHEE,6/17/2020,19,333,0,352
CHATTAHOOCHEE,6/18/2020,20,340,0,360
CHATTAHOOCHEE,6/19/2020,20,346,0,366
CHATTAHOOCHEE,6/20/2020,21,349,0,370
CHATTAHOOCHEE,6/21/2020,21,350,0,371
CHATTAHOOCHEE,6/22/2020,22,375,0,397
CHATTAHOOCHEE,6/23/2020,24,386,0,410
CHATTAHOOCHEE,6/24/2020,26,395,0,421
CHATTAHOOCHEE,6/25/2020,26,401,0,427
CHATTAHOOCHEE,6/26/2020,27,407,0,434
CHATTAHOOCHEE,6/27/2020,27,412,0,439
CHATTAHOOCHEE,6/28/2020,28,416,0,444
CHATTAHOOCHEE,6/29/2020,28,420,0,448
CHATTAHOOCHEE,6/30/2020,29,434,0,463
CHATTAHOOCHEE,7/1/2020,30,446,0,476
CHATTAHOOCHEE,7/2/2020,32,455,0,487
CHATTAHOOCHEE,7/3/2020,33,460,0,493
CHATTAHOOCHEE,7/4/2020,34,463,0,497
CHATTAHOOCHEE,7/5/2020,34,467,0,501
CHATTAHOOCHEE,7/6/2020,34,472,1,507
CHATTAHOOCHEE,7/7/2020,37,485,1,523
CHATTAHOOCHEE,7/8/2020,39,510,1,550
CHATTAHOOCHEE,7/9/2020,41,525,1,567
CHATTAHOOCHEE,7/10/2020,43,553,1,597
CHATTAHOOCHEE,7/11/2020,45,562,1,608
CHATTAHOOCHEE,7/12/2020,47,565,1,613
CHATTAHOOCHEE,7/13/2020,49,598,1,648
CHATTAHOOCHEE,7/14/2020,50,609,1,660
CHATTAHOOCHEE,7/15/2020,51,618,1,670
CHATTAHOOCHEE,7/16/2020,51,628,2,681
CHATTAHOOCHEE,7/17/2020,54,635,2,691
CHATTAHOOCHEE,7/18/2020,55,641,2,698
CHATTAHOOCHEE,7/19/2020,55,641,2,698
CHATTAHOOCHEE,7/20/2020,56,655,2,713
CHATTAHOOCHEE,7/21/2020,58,735,2,795
CHATTAHOOCHEE,7/22/2020,60,772,2,834
CHATTAHOOCHEE,7/23/2020,61,798,2,861
CHATTAHOOCHEE,7/24/2020,63,813,2,878
CHATTAHOOCHEE,7/25/2020,64,820,2,886
CHATTAHOOCHEE,7/26/2020,65,830,2,897
CHATTAHOOCHEE,7/27/2020,66,851,3,920
CHATTAHOOCHEE,7/28/2020,66,883,3,952
CHATTAHOOCHEE,7/29/2020,68,911,3,982
CHATTAHOOCHEE,7/30/2020,69,927,3,999
CHATTAHOOCHEE,7/31/2020,70,934,4,1008
CHATTAHOOCHEE,8/1/2020,70,945,4,1019
CHATTAHOOCHEE,8/2/2020,72,957,4,1033
CHATTAHOOCHEE,8/3/2020,72,1002,4,1078
CHATTAHOOCHEE,8/4/2020,73,1017,5,1095
CHATTAHOOCHEE,8/5/2020,74,1023,5,1102
CHATTAHOOCHEE,8/6/2020,75,1032,5,1112
CHATTAHOOCHEE,8/7/2020,75,1042,5,1122
CHATTAHOOCHEE,8/8/2020,75,1063,5,1143
CHATTAHOOCHEE,8/9/2020,75,1074,5,1154
CHATTAHOOCHEE,8/10/2020,75,1112,5,1192
CHATTAHOOCHEE,8/11/2020,76,1132,5,1213
CHATTAHOOCHEE,8/12/2020,77,1181,5,1263
CHATTAHOOCHEE,8/13/2020,77,1210,5,1292
CHATTAHOOCHEE,8/14/2020,77,1248,5,1330
CHATTAHOOCHEE,8/15/2020,78,1263,5,1346
CHATTAHOOCHEE,8/16/2020,80,1288,5,1373
CHATTAHOOCHEE,8/17/2020,81,1332,5,1418
CHATTAHOOCHEE,8/18/2020,81,1344,5,1430
CHATTAHOOCHEE,8/19/2020,82,1358,5,1445
CHATTAHOOCHEE,8/20/2020,84,1359,5,1448
CHATTAHOOCHEE,8/21/2020,84,1364,5,1453
CHATTAHOOCHEE,8/22/2020,84,1371,5,1460
CHATTAHOOCHEE,8/23/2020,84,1373,5,1462
CHATTAHOOCHEE,8/24/2020,84,1394,5,1483
CHATTAHOOCHEE,8/25/2020,84,1404,5,1493
CHATTAHOOCHEE,8/26/2020,84,1412,5,1501
CHATTAHOOCHEE,8/27/2020,86,1421,5,1512
CHATTAHOOCHEE,8/28/2020,86,1423,5,1514
CHATTAHOOCHEE,8/29/2020,88,1425,5,1518
CHATTAHOOCHEE,8/30/2020,88,1429,5,1522
CHATTAHOOCHEE,8/31/2020,90,1459,5,1554
CHATTAHOOCHEE,9/1/2020,91,1466,5,1562
CHATTAHOOCHEE,9/2/2020,92,1476,5,1573
CHATTAHOOCHEE,9/3/2020,93,1490,6,1589
CHATTAHOOCHEE,9/4/2020,93,1490,6,1589
CHATTAHOOCHEE,9/5/2020,93,1490,6,1589
CHATTAHOOCHEE,9/6/2020,94,1490,6,1590
CHATTAHOOCHEE,9/7/2020,95,1491,6,1592
CHATTAHOOCHEE,9/8/2020,95,1493,6,1594
CHATTAHOOCHEE,9/9/2020,95,1500,6,1601
CHATTAHOOCHEE,9/10/2020,95,1516,6,1617
CHATTAHOOCHEE,9/11/2020,95,1517,6,1618
CHATTAHOOCHEE,9/12/2020,95,1517,6,1618
CHATTAHOOCHEE,9/13/2020,95,1518,6,1619
CANDLER,4/23/2020,6,3,0,9
CHATTAHOOCHEE,9/14/2020,95,1525,6,1626
CHATTAHOOCHEE,9/15/2020,95,1527,6,1628
CHATTAHOOCHEE,9/16/2020,95,1532,6,1633
CHATTAHOOCHEE,9/17/2020,95,1533,6,1634
CHATTAHOOCHEE,9/18/2020,95,1534,6,1635
CHATTAHOOCHEE,9/19/2020,95,1535,6,1636
CHATTAHOOCHEE,9/20/2020,95,1536,6,1637
CHATTAHOOCHEE,9/21/2020,95,1538,6,1639
CHATTAHOOCHEE,9/22/2020,96,1538,6,1640
CHATTAHOOCHEE,9/23/2020,96,1539,6,1641
CHATTAHOOCHEE,9/24/2020,96,1539,6,1641
CHATTAHOOCHEE,9/25/2020,96,1539,6,1641
CHATTAHOOCHEE,9/26/2020,96,1540,6,1642
CHATTAHOOCHEE,9/27/2020,96,1540,6,1642
CHATTAHOOCHEE,9/28/2020,96,1540,6,1642
CHATTAHOOCHEE,9/29/2020,99,1570,6,1675
CHATTAHOOCHEE,9/30/2020,103,1579,6,1688
CHATTAHOOCHEE,10/1/2020,103,1581,6,1690
CHATTAHOOCHEE,10/2/2020,103,1588,6,1697
CHATTAHOOCHEE,10/3/2020,104,1590,6,1700
CHATTAHOOCHEE,10/4/2020,104,1590,6,1700
CHATTAHOOCHEE,10/5/2020,104,1590,6,1700
CHATTAHOOCHEE,10/6/2020,104,1596,6,1706
CHATTAHOOCHEE,10/7/2020,104,1598,6,1708
CHATTAHOOCHEE,10/8/2020,104,1600,6,1710
CHATTAHOOCHEE,10/9/2020,105,1601,6,1712
CHATTAHOOCHEE,10/10/2020,105,1602,6,1713
CHATTAHOOCHEE,10/11/2020,105,1605,6,1716
CHATTAHOOCHEE,10/12/2020,105,1606,6,1717
CHATTAHOOCHEE,10/13/2020,105,1615,6,1726
CHATTAHOOCHEE,10/14/2020,105,1616,6,1727
CHATTAHOOCHEE,10/15/2020,105,1617,6,1728
CHATTAHOOCHEE,10/16/2020,105,1617,6,1728
CHATTAHOOCHEE,10/17/2020,105,1617,6,1728
CHATTAHOOCHEE,10/18/2020,105,1617,6,1728
CHATTAHOOCHEE,10/19/2020,105,1617,6,1728
CHATTAHOOCHEE,10/20/2020,105,1617,6,1728
CHATTOOGA,1/1/2020,0,0,0,0
CHATTOOGA,1/2/2020,0,0,0,0
CHATTOOGA,1/3/2020,0,0,0,0
CHATTOOGA,1/4/2020,0,0,0,0
CHATTOOGA,1/5/2020,0,0,0,0
CHATTOOGA,1/6/2020,0,0,0,0
CHATTOOGA,1/7/2020,0,0,0,0
CHATTOOGA,1/8/2020,0,0,0,0
CHATTOOGA,1/9/2020,0,0,0,0
CHATTOOGA,1/10/2020,0,0,0,0
CHATTOOGA,1/11/2020,0,0,0,0
CHATTOOGA,1/12/2020,0,0,0,0
CHATTOOGA,1/13/2020,0,0,0,0
CHATTOOGA,1/14/2020,0,0,0,0
CHATTOOGA,1/15/2020,0,0,0,0
CHATTOOGA,1/16/2020,0,0,0,0
CHATTOOGA,1/17/2020,0,0,0,0
CHATTOOGA,1/18/2020,0,0,0,0
CHATTOOGA,1/19/2020,0,0,0,0
CHATTOOGA,1/20/2020,0,0,0,0
CHATTOOGA,1/21/2020,0,0,0,0
CHATTOOGA,1/22/2020,0,0,0,0
CHATTOOGA,1/23/2020,0,0,0,0
CHATTOOGA,1/24/2020,0,0,0,0
CHATTOOGA,1/25/2020,0,0,0,0
CHATTOOGA,1/26/2020,0,0,0,0
CHATTOOGA,1/27/2020,0,0,0,0
CHATTOOGA,1/28/2020,0,0,0,0
CHATTOOGA,1/29/2020,0,0,0,0
CHATTOOGA,1/30/2020,0,0,0,0
CHATTOOGA,1/31/2020,0,0,0,0
CHATTOOGA,2/1/2020,0,0,0,0
CHATTOOGA,2/2/2020,0,0,0,0
CHATTOOGA,2/3/2020,0,0,0,0
CHATTOOGA,2/4/2020,0,0,0,0
CHATTOOGA,2/5/2020,0,0,0,0
CHATTOOGA,2/6/2020,0,0,0,0
CHATTOOGA,2/7/2020,0,0,0,0
CHATTOOGA,2/8/2020,0,0,0,0
CHATTOOGA,2/9/2020,0,0,0,0
CHATTOOGA,2/10/2020,0,0,0,0
CHATTOOGA,2/11/2020,0,0,0,0
CHATTOOGA,2/12/2020,0,0,0,0
CHATTOOGA,2/13/2020,0,0,0,0
CHATTOOGA,2/14/2020,0,0,0,0
CHATTOOGA,2/15/2020,0,0,0,0
CHATTOOGA,2/16/2020,0,0,0,0
CHATTOOGA,2/17/2020,0,0,0,0
CHATTOOGA,2/18/2020,0,0,0,0
CHATTOOGA,2/19/2020,0,0,0,0
CHATTOOGA,2/20/2020,0,0,0,0
CHATTOOGA,2/21/2020,0,0,0,0
CHATTOOGA,2/22/2020,0,0,0,0
CHATTOOGA,2/23/2020,0,0,0,0
CHATTOOGA,2/24/2020,0,0,0,0
CHATTOOGA,2/25/2020,0,0,0,0
CHATTOOGA,2/26/2020,0,0,0,0
CHATTOOGA,2/27/2020,0,0,0,0
CHATTOOGA,2/28/2020,0,0,0,0
CHATTOOGA,2/29/2020,0,0,0,0
CHATTOOGA,3/1/2020,0,0,0,0
CHATTOOGA,3/2/2020,0,0,0,0
CHATTOOGA,3/3/2020,0,0,0,0
CHATTOOGA,3/4/2020,0,0,0,0
CHATTOOGA,3/5/2020,0,0,0,0
CHATTOOGA,3/6/2020,0,0,0,0
CHATTOOGA,3/7/2020,0,0,0,0
CHATTOOGA,3/8/2020,0,0,0,0
CHATTOOGA,3/9/2020,0,0,0,0
CHATTOOGA,3/10/2020,0,0,0,0
CHATTOOGA,3/11/2020,0,0,0,0
CHATTOOGA,3/12/2020,0,0,0,0
CHATTOOGA,3/13/2020,0,0,0,0
CHATTOOGA,3/14/2020,0,0,0,0
CHATTOOGA,3/15/2020,0,0,0,0
CHATTOOGA,3/16/2020,0,0,0,0
CHATTOOGA,3/17/2020,1,0,0,1
CHATTOOGA,3/18/2020,1,0,0,1
CHATTOOGA,3/19/2020,1,0,0,1
CHATTOOGA,3/20/2020,3,0,0,3
CHATTOOGA,3/21/2020,3,0,0,3
CHATTOOGA,3/22/2020,3,0,0,3
CHATTOOGA,3/23/2020,3,0,0,3
CHATTOOGA,3/24/2020,3,0,0,3
CHATTOOGA,3/25/2020,3,1,0,4
CHATTOOGA,3/26/2020,3,1,0,4
CHATTOOGA,3/27/2020,3,1,0,4
CHATTOOGA,3/28/2020,3,1,0,4
CHATTOOGA,3/29/2020,3,1,0,4
CHATTOOGA,3/30/2020,3,2,0,5
CHATTOOGA,3/31/2020,3,2,0,5
CHATTOOGA,4/1/2020,4,2,0,6
CHATTOOGA,4/2/2020,5,2,0,7
CHATTOOGA,4/3/2020,6,2,0,8
CHATTOOGA,4/4/2020,6,2,0,8
CHATTOOGA,4/5/2020,6,3,0,9
CHATTOOGA,4/6/2020,6,3,0,9
CHATTOOGA,4/7/2020,6,3,0,9
CHATTOOGA,4/8/2020,6,3,0,9
CHATTOOGA,4/9/2020,6,3,0,9
CHATTOOGA,4/10/2020,7,3,0,10
CHATTOOGA,4/11/2020,7,3,0,10
CHATTOOGA,4/12/2020,7,3,0,10
CHATTOOGA,4/13/2020,7,3,0,10
CHATTOOGA,4/14/2020,7,3,0,10
CHATTOOGA,4/15/2020,8,3,0,11
CHATTOOGA,4/16/2020,9,3,0,12
CHATTOOGA,4/17/2020,9,3,0,12
CHATTOOGA,4/18/2020,9,3,0,12
CHATTOOGA,4/19/2020,9,3,0,12
CHATTOOGA,4/20/2020,9,3,0,12
CHATTOOGA,4/21/2020,10,3,0,13
CHATTOOGA,4/22/2020,12,3,0,15
CHATTOOGA,4/23/2020,12,4,0,16
CHATTOOGA,4/24/2020,12,4,0,16
CHATTOOGA,4/25/2020,12,4,0,16
CHATTOOGA,4/26/2020,12,4,0,16
CHATTOOGA,4/27/2020,12,4,0,16
CHATTOOGA,4/28/2020,13,4,0,17
CHATTOOGA,4/29/2020,13,4,0,17
CHATTOOGA,4/30/2020,13,4,0,17
CHATTOOGA,5/1/2020,13,4,0,17
CHATTOOGA,5/2/2020,13,4,0,17
CHATTOOGA,5/3/2020,13,4,0,17
CHATTOOGA,5/4/2020,13,4,0,17
CHATTOOGA,5/5/2020,13,4,0,17
CHATTOOGA,5/6/2020,13,4,0,17
CHATTOOGA,5/7/2020,13,4,0,17
CHATTOOGA,5/8/2020,13,4,0,17
CHATTOOGA,5/9/2020,13,4,0,17
CHATTOOGA,5/10/2020,13,4,0,17
CHATTOOGA,5/11/2020,13,4,0,17
CHATTOOGA,5/12/2020,17,4,0,21
CHATTOOGA,5/13/2020,17,4,0,21
CHATTOOGA,5/14/2020,18,4,0,22
CHATTOOGA,5/15/2020,18,4,0,22
CHATTOOGA,5/16/2020,18,5,0,23
CHATTOOGA,5/17/2020,18,5,0,23
CHATTOOGA,5/18/2020,18,5,0,23
CHATTOOGA,5/19/2020,19,5,0,24
CHATTOOGA,5/20/2020,19,5,0,24
CHATTOOGA,5/21/2020,19,5,0,24
CHATTOOGA,5/22/2020,19,5,0,24
CHATTOOGA,5/23/2020,19,5,0,24
CHATTOOGA,5/24/2020,19,5,0,24
CHATTOOGA,5/25/2020,19,5,0,24
CHATTOOGA,5/26/2020,20,5,0,25
CHATTOOGA,5/27/2020,20,5,0,25
CHATTOOGA,5/28/2020,20,5,0,25
CHATTOOGA,5/29/2020,21,6,0,27
CHATTOOGA,5/30/2020,21,7,0,28
CHATTOOGA,5/31/2020,21,8,0,29
CHATTOOGA,6/1/2020,22,8,0,30
CHATTOOGA,6/2/2020,25,8,2,35
CHATTOOGA,6/3/2020,26,9,3,38
CHATTOOGA,6/4/2020,30,9,3,42
CHATTOOGA,6/5/2020,31,10,3,44
CHATTOOGA,6/6/2020,33,10,3,46
CHATTOOGA,6/7/2020,33,10,3,46
CHATTOOGA,6/8/2020,34,10,3,47
CHATTOOGA,6/9/2020,35,11,3,49
CHATTOOGA,6/10/2020,36,12,3,51
CHATTOOGA,6/11/2020,36,15,3,54
CHATTOOGA,6/12/2020,37,18,3,58
CHATTOOGA,6/13/2020,38,18,3,59
CHATTOOGA,6/14/2020,39,19,3,61
CHATTOOGA,6/15/2020,40,20,3,63
CHATTOOGA,6/16/2020,40,20,3,63
CHATTOOGA,6/17/2020,40,23,3,66
CHATTOOGA,6/18/2020,41,25,3,69
CHATTOOGA,6/19/2020,41,27,3,71
CHATTOOGA,6/20/2020,41,27,3,71
CHATTOOGA,6/21/2020,41,27,3,71
CHATTOOGA,6/22/2020,41,27,3,71
CHATTOOGA,6/23/2020,44,30,3,77
CHATTOOGA,6/24/2020,48,32,3,83
CHATTOOGA,6/25/2020,50,33,3,86
CHATTOOGA,6/26/2020,50,34,3,87
CHATTOOGA,6/27/2020,50,34,3,87
CHATTOOGA,6/28/2020,50,34,3,87
CHATTOOGA,6/29/2020,50,34,3,87
CHATTOOGA,6/30/2020,51,36,3,90
CHATTOOGA,7/1/2020,53,39,3,95
CHATTOOGA,7/2/2020,54,40,3,97
CHATTOOGA,7/3/2020,56,41,3,100
CHATTOOGA,7/4/2020,57,41,3,101
CHATTOOGA,7/5/2020,57,41,3,101
CHATTOOGA,7/6/2020,58,41,3,102
CHATTOOGA,7/7/2020,58,44,3,105
CHATTOOGA,7/8/2020,58,45,3,106
CHATTOOGA,7/9/2020,59,45,3,107
CHATTOOGA,7/10/2020,61,48,3,112
CHATTOOGA,7/11/2020,61,48,3,112
CHATTOOGA,7/12/2020,61,49,3,113
CHATTOOGA,7/13/2020,65,53,3,121
CHATTOOGA,7/14/2020,67,55,3,125
CHATTOOGA,7/15/2020,68,58,3,129
CHATTOOGA,7/16/2020,71,61,3,135
CHATTOOGA,7/17/2020,72,63,3,138
CHATTOOGA,7/18/2020,74,67,3,144
CHATTOOGA,7/19/2020,74,67,3,144
CHATTOOGA,7/20/2020,78,69,3,150
CHATTOOGA,7/21/2020,88,80,3,171
CHATTOOGA,7/22/2020,96,82,3,181
CHATTOOGA,7/23/2020,108,91,3,202
CHATTOOGA,7/24/2020,120,101,3,224
CHATTOOGA,7/25/2020,121,107,3,231
CHATTOOGA,7/26/2020,125,110,3,238
CHATTOOGA,7/27/2020,132,112,3,247
CHATTOOGA,7/28/2020,141,119,3,263
CHATTOOGA,7/29/2020,149,124,3,276
CHATTOOGA,7/30/2020,154,133,3,290
CHATTOOGA,7/31/2020,166,138,3,307
CHATTOOGA,8/1/2020,169,146,3,318
CHATTOOGA,8/2/2020,171,151,3,325
CHATTOOGA,8/3/2020,174,151,3,328
CHATTOOGA,8/4/2020,191,157,7,355
CHATTOOGA,8/5/2020,201,170,7,378
CHATTOOGA,8/6/2020,205,174,8,387
CHATTOOGA,8/7/2020,209,177,8,394
CHATTOOGA,8/8/2020,211,178,8,397
CHATTOOGA,8/9/2020,213,179,8,400
CHATTOOGA,8/10/2020,215,183,8,406
CHATTOOGA,8/11/2020,227,192,9,428
CHATTOOGA,8/12/2020,230,200,9,439
CHATTOOGA,8/13/2020,233,202,9,444
CHATTOOGA,8/14/2020,236,202,10,448
CHATTOOGA,8/15/2020,236,204,11,451
CHATTOOGA,8/16/2020,239,206,11,456
CHATTOOGA,8/17/2020,244,211,11,466
CHATTOOGA,8/18/2020,249,216,12,477
CHATTOOGA,8/19/2020,253,224,13,490
CHATTOOGA,8/20/2020,265,232,13,510
CHATTOOGA,8/21/2020,271,242,14,527
CHATTOOGA,8/22/2020,275,248,14,537
CHATTOOGA,8/23/2020,290,258,14,562
CHATTOOGA,8/24/2020,293,263,14,570
CHATTOOGA,8/25/2020,295,271,14,580
CHATTOOGA,8/26/2020,311,279,14,604
CHATTOOGA,8/27/2020,315,282,14,611
CANDLER,4/24/2020,6,3,0,9
CANDLER,4/25/2020,6,3,0,9
CANDLER,4/26/2020,6,3,0,9
CANDLER,4/27/2020,6,3,0,9
CANDLER,4/28/2020,6,3,0,9
CANDLER,4/29/2020,8,3,0,11
CANDLER,4/30/2020,8,3,0,11
CANDLER,5/1/2020,8,3,0,11
CANDLER,5/2/2020,8,3,0,11
CANDLER,5/3/2020,8,3,0,11
CANDLER,5/4/2020,8,3,0,11
CANDLER,5/5/2020,8,4,0,12
CANDLER,5/6/2020,8,4,0,12
CANDLER,5/7/2020,8,5,0,13
CANDLER,5/8/2020,8,5,0,13
CANDLER,5/9/2020,8,6,0,14
CANDLER,5/10/2020,8,6,0,14
CANDLER,5/11/2020,8,6,0,14
CANDLER,5/12/2020,10,6,0,16
CANDLER,5/13/2020,10,6,0,16
CANDLER,5/14/2020,10,6,0,16
CANDLER,5/15/2020,10,6,0,16
CANDLER,5/16/2020,10,6,0,16
CANDLER,5/17/2020,10,6,0,16
CANDLER,5/18/2020,10,6,0,16
CANDLER,5/19/2020,10,6,0,16
CANDLER,5/20/2020,10,6,0,16
CANDLER,5/21/2020,10,6,0,16
CANDLER,5/22/2020,10,6,0,16
CANDLER,5/23/2020,10,6,0,16
CANDLER,5/24/2020,10,6,0,16
CANDLER,5/25/2020,10,6,0,16
CANDLER,5/26/2020,10,6,0,16
CANDLER,5/27/2020,10,6,0,16
CANDLER,5/28/2020,13,6,0,19
CANDLER,5/29/2020,13,6,0,19
CANDLER,5/30/2020,13,6,0,19
CANDLER,5/31/2020,13,6,0,19
CANDLER,6/1/2020,13,6,0,19
CANDLER,6/2/2020,14,6,0,20
CANDLER,6/3/2020,14,6,0,20
CANDLER,6/4/2020,15,6,0,21
CANDLER,6/5/2020,16,7,0,23
CANDLER,6/6/2020,16,7,0,23
CANDLER,6/7/2020,16,7,0,23
CANDLER,6/8/2020,16,7,1,24
CANDLER,6/9/2020,16,7,1,24
CANDLER,6/10/2020,16,7,1,24
CANDLER,6/11/2020,17,7,1,25
CANDLER,6/12/2020,17,7,1,25
CANDLER,6/13/2020,17,8,1,26
CANDLER,6/14/2020,17,8,1,26
CANDLER,6/15/2020,20,8,1,29
CANDLER,6/16/2020,20,8,1,29
CANDLER,6/17/2020,21,9,1,31
CANDLER,6/18/2020,22,10,1,33
CANDLER,6/19/2020,23,11,1,35
CANDLER,6/20/2020,23,12,1,36
CANDLER,6/21/2020,25,12,1,38
CANDLER,6/22/2020,27,14,1,42
CANDLER,6/23/2020,29,14,1,44
CANDLER,6/24/2020,32,21,1,54
CANDLER,6/25/2020,34,22,1,57
CANDLER,6/26/2020,34,25,1,60
CANDLER,6/27/2020,36,25,1,62
CANDLER,6/28/2020,37,27,1,65
CANDLER,6/29/2020,41,27,1,69
CANDLER,6/30/2020,45,30,1,76
CANDLER,7/1/2020,51,31,1,83
CANDLER,7/2/2020,53,33,1,87
CANDLER,7/3/2020,56,35,1,92
CANDLER,7/4/2020,58,35,1,94
CANDLER,7/5/2020,59,38,1,98
CANDLER,7/6/2020,61,42,1,104
CANDLER,7/7/2020,66,44,1,111
CANDLER,7/8/2020,69,48,1,118
CANDLER,7/9/2020,72,50,1,123
CANDLER,7/10/2020,73,52,1,126
CANDLER,7/11/2020,73,52,1,126
CANDLER,7/12/2020,73,55,1,129
CANDLER,7/13/2020,79,63,1,143
CANDLER,7/14/2020,81,64,1,146
CANDLER,7/15/2020,91,73,1,165
CANDLER,7/16/2020,98,76,1,175
CANDLER,7/17/2020,109,83,1,193
CANDLER,7/18/2020,110,84,1,195
CANDLER,7/19/2020,110,85,1,196
CANDLER,7/20/2020,116,89,1,206
CANDLER,7/21/2020,120,94,1,215
CANDLER,7/22/2020,127,96,1,224
CANDLER,7/23/2020,131,96,1,228
CANDLER,7/24/2020,135,99,1,235
CANDLER,7/25/2020,136,100,1,237
CANDLER,7/26/2020,136,100,1,237
CANDLER,7/27/2020,141,104,1,246
CANDLER,7/28/2020,143,107,1,251
CANDLER,7/29/2020,147,112,1,260
CANDLER,7/30/2020,148,112,1,261
CANDLER,7/31/2020,148,113,1,262
CANDLER,8/1/2020,149,113,1,263
CANDLER,8/2/2020,149,114,1,264
CANDLER,8/3/2020,152,116,1,269
CANDLER,8/4/2020,153,117,1,271
CANDLER,8/5/2020,156,118,1,275
CANDLER,8/6/2020,157,120,1,278
CANDLER,8/7/2020,159,121,1,281
CANDLER,8/8/2020,160,122,1,283
CANDLER,8/9/2020,160,123,1,284
CANDLER,8/10/2020,165,126,1,292
CANDLER,8/11/2020,165,126,1,292
CANDLER,8/12/2020,165,129,1,295
CANDLER,8/13/2020,165,131,1,297
CANDLER,8/14/2020,169,134,1,304
CANDLER,8/15/2020,170,136,1,307
CANDLER,8/16/2020,179,157,1,337
CANDLER,8/17/2020,180,158,1,339
CANDLER,8/18/2020,188,158,1,347
CANDLER,8/19/2020,190,159,1,350
CANDLER,8/20/2020,193,159,1,353
CANDLER,8/21/2020,195,160,1,356
CANDLER,8/22/2020,197,162,1,360
CANDLER,8/23/2020,199,163,1,363
CANDLER,8/24/2020,207,165,1,373
CANDLER,8/25/2020,212,165,1,378
CANDLER,8/26/2020,216,167,1,384
CANDLER,8/27/2020,220,170,1,391
CANDLER,8/28/2020,221,170,1,392
CANDLER,8/29/2020,221,170,1,392
CANDLER,8/30/2020,223,173,1,397
CANDLER,8/31/2020,226,174,1,401
CANDLER,9/1/2020,228,176,1,405
CANDLER,9/2/2020,232,182,1,415
CANDLER,9/3/2020,232,182,1,415
CANDLER,9/4/2020,233,186,1,420
CANDLER,9/5/2020,233,186,1,420
CANDLER,9/6/2020,234,186,1,421
CANDLER,9/7/2020,235,187,1,423
CANDLER,9/8/2020,237,187,2,426
CANDLER,9/9/2020,238,188,2,428
CANDLER,9/10/2020,238,189,2,429
CANDLER,9/11/2020,239,190,2,431
CANDLER,9/12/2020,240,193,2,435
CANDLER,9/13/2020,241,194,2,437
CANDLER,9/14/2020,243,195,2,440
CANDLER,9/15/2020,243,200,2,445
CANDLER,9/16/2020,245,205,2,452
CANDLER,9/17/2020,246,207,2,455
CANDLER,9/18/2020,249,208,2,459
CANDLER,9/19/2020,250,209,2,461
CANDLER,9/20/2020,250,209,2,461
CANDLER,9/21/2020,251,209,2,462
CANDLER,9/22/2020,252,210,2,464
CANDLER,9/23/2020,253,211,2,466
CANDLER,9/24/2020,255,211,2,468
CANDLER,9/25/2020,257,212,2,471
CANDLER,9/26/2020,257,213,2,472
CANDLER,9/27/2020,257,215,2,474
CANDLER,9/28/2020,259,215,2,476
CANDLER,9/29/2020,260,217,2,479
CANDLER,9/30/2020,263,218,2,483
CANDLER,10/1/2020,266,219,2,487
CANDLER,10/2/2020,267,219,2,488
CANDLER,10/3/2020,267,220,2,489
CANDLER,10/4/2020,268,222,2,492
CANDLER,10/5/2020,272,226,2,500
CANDLER,10/6/2020,274,229,2,505
CANDLER,10/7/2020,278,230,2,510
CANDLER,10/8/2020,278,231,2,511
CANDLER,10/9/2020,278,234,2,514
CANDLER,10/10/2020,279,234,2,515
CANDLER,10/11/2020,279,235,2,516
CANDLER,10/12/2020,280,236,2,518
CANDLER,10/13/2020,283,236,2,521
CANDLER,10/14/2020,284,237,2,523
CANDLER,10/15/2020,285,237,2,524
CANDLER,10/16/2020,286,237,2,525
CANDLER,10/17/2020,286,237,2,525
CANDLER,10/18/2020,286,237,2,525
CANDLER,10/19/2020,286,237,2,525
CANDLER,10/20/2020,286,237,2,525
CATOOSA,1/1/2020,0,0,0,0
CATOOSA,1/2/2020,0,0,0,0
CATOOSA,1/3/2020,0,0,0,0
CATOOSA,1/4/2020,0,0,0,0
CATOOSA,1/5/2020,0,0,0,0
CATOOSA,1/6/2020,0,0,0,0
CATOOSA,1/7/2020,0,0,0,0
CATOOSA,1/8/2020,0,0,0,0
CATOOSA,1/9/2020,0,0,0,0
CATOOSA,1/10/2020,1,0,0,1
CATOOSA,1/11/2020,1,0,0,1
CATOOSA,1/12/2020,1,0,0,1
CATOOSA,1/13/2020,1,0,0,1
CATOOSA,1/14/2020,1,0,0,1
CATOOSA,1/15/2020,1,0,0,1
CATOOSA,1/16/2020,1,0,0,1
CATOOSA,1/17/2020,1,0,0,1
CATOOSA,1/18/2020,1,0,0,1
CATOOSA,1/19/2020,1,0,0,1
CATOOSA,1/20/2020,1,0,0,1
CATOOSA,1/21/2020,1,0,0,1
CATOOSA,1/22/2020,1,0,0,1
CATOOSA,1/23/2020,1,0,0,1
CATOOSA,1/24/2020,1,0,0,1
CATOOSA,1/25/2020,1,0,0,1
CATOOSA,1/26/2020,1,0,0,1
CATOOSA,1/27/2020,1,0,0,1
CATOOSA,1/28/2020,1,0,0,1
CATOOSA,1/29/2020,1,0,0,1
CATOOSA,1/30/2020,1,0,0,1
CATOOSA,1/31/2020,1,0,0,1
CATOOSA,2/1/2020,1,0,0,1
CATOOSA,2/2/2020,1,0,0,1
CATOOSA,2/3/2020,1,0,0,1
CATOOSA,2/4/2020,1,0,0,1
CATOOSA,2/5/2020,1,0,0,1
CATOOSA,2/6/2020,1,0,0,1
CATOOSA,2/7/2020,1,0,0,1
CATOOSA,2/8/2020,1,0,0,1
CATOOSA,2/9/2020,1,0,0,1
CATOOSA,2/10/2020,1,0,0,1
CATOOSA,2/11/2020,1,0,0,1
CATOOSA,2/12/2020,1,0,0,1
CATOOSA,2/13/2020,1,0,0,1
CATOOSA,2/14/2020,1,0,0,1
CATOOSA,2/15/2020,1,0,0,1
CATOOSA,2/16/2020,1,0,0,1
CATOOSA,2/17/2020,1,0,0,1
CATOOSA,2/18/2020,1,0,0,1
CATOOSA,2/19/2020,1,0,0,1
CATOOSA,2/20/2020,1,0,0,1
CATOOSA,2/21/2020,1,0,0,1
CATOOSA,2/22/2020,1,0,0,1
CATOOSA,2/23/2020,1,0,0,1
CATOOSA,2/24/2020,1,0,0,1
CATOOSA,2/25/2020,1,0,0,1
CATOOSA,2/26/2020,1,0,0,1
CATOOSA,2/27/2020,1,0,0,1
CATOOSA,2/28/2020,1,0,0,1
CATOOSA,2/29/2020,1,0,0,1
CATOOSA,3/1/2020,1,0,0,1
CATOOSA,3/2/2020,1,0,0,1
CATOOSA,3/3/2020,1,0,0,1
CATOOSA,3/4/2020,1,1,0,2
CATOOSA,3/5/2020,1,1,0,2
CATOOSA,3/6/2020,1,1,0,2
CATOOSA,3/7/2020,1,1,0,2
CATOOSA,3/8/2020,1,1,0,2
CATOOSA,3/9/2020,1,1,0,2
CATOOSA,3/10/2020,1,1,0,2
CATOOSA,3/11/2020,2,1,0,3
CATOOSA,3/12/2020,2,1,0,3
CATOOSA,3/13/2020,3,1,0,4
CATOOSA,3/14/2020,4,2,0,6
CATOOSA,3/15/2020,4,2,0,6
CATOOSA,3/16/2020,4,2,0,6
CATOOSA,3/17/2020,4,2,0,6
CATOOSA,3/18/2020,4,3,0,7
CATOOSA,3/19/2020,5,3,0,8
CATOOSA,3/20/2020,5,3,0,8
CATOOSA,3/21/2020,5,3,0,8
CATOOSA,3/22/2020,6,3,0,9
CATOOSA,3/23/2020,6,3,0,9
CATOOSA,3/24/2020,7,3,0,10
CATOOSA,3/25/2020,7,3,0,10
CATOOSA,3/26/2020,7,3,0,10
CATOOSA,3/27/2020,8,4,0,12
CATOOSA,3/28/2020,8,5,0,13
CATOOSA,3/29/2020,8,5,0,13
CATOOSA,3/30/2020,8,5,0,13
CATOOSA,3/31/2020,8,5,0,13
CATOOSA,4/1/2020,9,6,0,15
CATOOSA,4/2/2020,9,6,0,15
CATOOSA,4/3/2020,9,6,0,15
CATOOSA,4/4/2020,9,6,0,15
CATOOSA,4/5/2020,10,7,0,17
CATOOSA,4/6/2020,11,9,0,20
CATOOSA,4/7/2020,11,9,0,20
CATOOSA,4/8/2020,11,9,0,20
CATOOSA,4/9/2020,11,9,0,20
CATOOSA,4/10/2020,13,9,0,22
CATOOSA,4/11/2020,13,9,0,22
CATOOSA,4/12/2020,13,9,0,22
CATOOSA,4/13/2020,13,9,0,22
CATOOSA,4/14/2020,14,9,0,23
CATOOSA,4/15/2020,15,10,0,25
CATOOSA,4/16/2020,17,10,0,27
CATOOSA,4/17/2020,21,13,1,35
CATOOSA,4/18/2020,21,13,1,35
CATOOSA,4/19/2020,21,13,1,35
CATOOSA,4/20/2020,21,13,1,35
CATOOSA,4/21/2020,31,15,1,47
CATOOSA,4/22/2020,35,15,1,51
CATOOSA,4/23/2020,35,15,1,51
CATOOSA,4/24/2020,37,16,1,54
CATOOSA,4/25/2020,37,17,1,55
CATOOSA,4/26/2020,37,17,1,55
CATOOSA,4/27/2020,37,18,1,56
CATOOSA,4/28/2020,38,18,1,57
CATOOSA,4/29/2020,39,18,1,58
CATOOSA,4/30/2020,39,18,1,58
CATOOSA,5/1/2020,39,19,1,59
CATOOSA,5/2/2020,40,19,1,60
CATOOSA,5/3/2020,40,19,1,60
CATOOSA,5/4/2020,40,21,1,62
CATOOSA,5/5/2020,40,21,1,62
CATOOSA,5/6/2020,40,21,1,62
CATOOSA,5/7/2020,43,22,1,66
CATOOSA,5/8/2020,45,22,1,68
CATOOSA,5/9/2020,46,23,1,70
CATOOSA,5/10/2020,47,27,1,75
CATOOSA,5/11/2020,51,29,1,81
CATOOSA,5/12/2020,53,31,1,85
CATOOSA,5/13/2020,55,31,1,87
CATOOSA,5/14/2020,58,31,1,90
CATOOSA,5/15/2020,65,42,1,108
CATOOSA,5/16/2020,67,42,1,110
CATOOSA,5/17/2020,67,42,1,110
CATOOSA,5/18/2020,68,45,1,114
CATOOSA,5/19/2020,74,48,1,123
CATOOSA,5/20/2020,74,51,1,126
CATOOSA,5/21/2020,78,51,1,130
CATOOSA,5/22/2020,81,51,1,133
CATOOSA,5/23/2020,82,51,1,134
CATOOSA,5/24/2020,82,51,1,134
CATOOSA,5/25/2020,84,55,1,140
CATOOSA,5/26/2020,86,57,1,144
CATOOSA,5/27/2020,89,57,1,147
CATOOSA,5/28/2020,89,59,1,149
CATOOSA,5/29/2020,90,61,1,152
CATOOSA,5/30/2020,93,62,1,156
CATOOSA,5/31/2020,94,63,1,158
CATOOSA,6/1/2020,99,64,1,164
CATOOSA,6/2/2020,100,65,1,166
CATOOSA,6/3/2020,104,66,1,171
CATOOSA,6/4/2020,108,71,1,180
CATOOSA,6/5/2020,114,76,1,191
CATOOSA,6/6/2020,114,79,1,194
CATOOSA,6/7/2020,118,79,1,198
CATOOSA,6/8/2020,136,92,9,237
CATOOSA,6/9/2020,142,96,9,247
CATOOSA,6/10/2020,147,102,9,258
CATOOSA,6/11/2020,151,103,9,263
CATOOSA,6/12/2020,154,105,9,268
CATOOSA,6/13/2020,156,107,9,272
CATOOSA,6/14/2020,156,107,9,272
CATOOSA,6/15/2020,166,114,9,289
CATOOSA,6/16/2020,167,116,9,292
CATOOSA,6/17/2020,167,117,9,293
CATOOSA,6/18/2020,167,120,9,296
CATOOSA,6/19/2020,169,120,9,298
CATOOSA,6/20/2020,170,123,9,302
CATOOSA,6/21/2020,173,126,9,308
CATOOSA,6/22/2020,175,128,9,312
CATOOSA,6/23/2020,182,130,9,321
CATOOSA,6/24/2020,184,132,9,325
CATOOSA,6/25/2020,188,134,9,331
CATOOSA,6/26/2020,189,137,9,335
CATOOSA,6/27/2020,189,141,9,339
CATOOSA,6/28/2020,194,142,9,345
CATOOSA,6/29/2020,199,149,9,357
CATOOSA,6/30/2020,204,155,10,369
CATOOSA,7/1/2020,216,158,10,384
CATOOSA,7/2/2020,221,162,10,393
CATOOSA,7/3/2020,229,167,10,406
CATOOSA,7/4/2020,231,168,10,409
CATOOSA,7/5/2020,235,173,10,418
CATOOSA,7/6/2020,241,179,10,430
CATOOSA,7/7/2020,251,188,10,449
CATOOSA,7/8/2020,254,198,10,462
CATOOSA,7/9/2020,260,200,10,470
CATOOSA,7/10/2020,262,211,10,483
CATOOSA,7/11/2020,268,217,11,496
CATOOSA,7/12/2020,271,217,11,499
CATOOSA,7/13/2020,280,221,11,512
CATOOSA,7/14/2020,287,230,13,530
CATOOSA,7/15/2020,299,235,13,547
CATOOSA,7/16/2020,307,241,14,562
CATOOSA,7/17/2020,313,245,15,573
CATOOSA,7/18/2020,315,246,16,577
CATOOSA,7/19/2020,317,248,16,581
CATOOSA,7/20/2020,320,253,16,589
CATOOSA,7/21/2020,324,260,18,602
CATOOSA,7/22/2020,329,265,20,614
CATOOSA,7/23/2020,334,270,20,624
CATOOSA,7/24/2020,337,273,21,631
CATOOSA,7/25/2020,342,274,21,637
CATOOSA,7/26/2020,344,275,21,640
CATOOSA,7/27/2020,347,277,21,645
CATOOSA,7/28/2020,348,283,21,652
CATOOSA,7/29/2020,353,288,23,664
CATOOSA,7/30/2020,359,294,23,676
CATOOSA,7/31/2020,364,298,23,685
CATOOSA,8/1/2020,365,303,24,692
CATOOSA,8/2/2020,370,306,24,700
CATOOSA,8/3/2020,372,312,24,708
CRISP,3/17/2020,3,7,0,10
CRISP,3/18/2020,5,8,0,13
CLINCH,2/22/2020,0,0,0,0
CRISP,3/19/2020,5,8,0,13
CLINCH,2/23/2020,0,0,0,0
CRISP,3/20/2020,6,8,0,14
CLINCH,2/24/2020,0,0,0,0
CRISP,3/21/2020,7,8,0,15
CLINCH,2/25/2020,0,0,0,0
CRISP,3/22/2020,8,9,0,17
CLINCH,2/26/2020,0,0,0,0
CRISP,3/23/2020,9,9,0,18
CLINCH,2/27/2020,0,0,0,0
CRISP,3/24/2020,13,11,0,24
CRISP,3/25/2020,16,12,0,28
CRISP,3/26/2020,18,12,0,30
CRISP,3/27/2020,20,15,0,35
CRISP,3/28/2020,23,17,0,40
CRISP,3/29/2020,26,18,0,44
CRISP,3/30/2020,29,21,0,50
CRISP,3/31/2020,29,24,0,53
CRISP,4/1/2020,32,28,0,60
CRISP,4/2/2020,37,30,0,67
CRISP,4/3/2020,39,33,0,72
CRISP,4/4/2020,42,33,0,75
CRISP,4/5/2020,43,34,0,77
CRISP,4/6/2020,44,36,0,80
CRISP,4/7/2020,47,37,0,84
CRISP,4/8/2020,50,38,0,88
CRISP,4/9/2020,57,42,0,99
CRISP,4/10/2020,62,46,0,108
CRISP,4/11/2020,64,47,0,111
CRISP,4/12/2020,65,48,0,113
CRISP,4/13/2020,74,50,0,124
CRISP,4/14/2020,78,54,0,132
CRISP,4/15/2020,82,54,0,136
CRISP,4/16/2020,86,56,0,142
CRISP,4/17/2020,89,56,0,145
CRISP,4/18/2020,91,56,0,147
CRISP,4/19/2020,92,56,0,148
CRISP,4/20/2020,93,56,0,149
CRISP,4/21/2020,94,60,0,154
CRISP,4/22/2020,97,62,0,159
CRISP,4/23/2020,97,62,0,159
CRISP,4/24/2020,98,64,0,162
CRISP,4/25/2020,98,66,0,164
CRISP,4/26/2020,98,67,0,165
CRISP,4/27/2020,103,68,0,171
CRISP,4/28/2020,104,71,0,175
CRISP,4/29/2020,105,73,0,178
CRISP,4/30/2020,107,75,0,182
CRISP,5/1/2020,108,75,0,183
CRISP,5/2/2020,109,78,0,187
CRISP,5/3/2020,109,78,0,187
CRISP,5/4/2020,110,78,0,188
CRISP,5/5/2020,110,80,0,190
CRISP,5/6/2020,114,82,0,196
CRISP,5/7/2020,116,84,0,200
CRISP,5/8/2020,116,85,0,201
CRISP,5/9/2020,117,85,0,202
CRISP,5/10/2020,117,87,0,204
CRISP,5/11/2020,119,88,0,207
CRISP,5/12/2020,119,88,0,207
CRISP,5/13/2020,120,88,0,208
CRISP,5/14/2020,121,88,0,209
CRISP,5/15/2020,122,89,0,211
CRISP,5/16/2020,124,89,0,213
CRISP,5/17/2020,129,90,0,219
CRISP,5/18/2020,129,90,0,219
CRISP,5/19/2020,131,91,0,222
CRISP,5/20/2020,135,92,0,227
CRISP,5/21/2020,138,92,0,230
CRISP,5/22/2020,138,92,0,230
CRISP,5/23/2020,140,92,0,232
CRISP,5/24/2020,142,93,0,235
CRISP,5/25/2020,142,93,0,235
CRISP,5/26/2020,142,97,0,239
CRISP,5/27/2020,142,97,0,239
CRISP,5/28/2020,142,99,0,241
CRISP,5/29/2020,142,100,0,242
CRISP,5/30/2020,142,100,0,242
CRISP,5/31/2020,142,100,0,242
CRISP,6/1/2020,145,100,0,245
CRISP,6/2/2020,145,100,0,245
CRISP,6/3/2020,145,101,0,246
CRISP,6/4/2020,146,101,0,247
CRISP,6/5/2020,146,101,0,247
CRISP,6/6/2020,146,102,0,248
CRISP,6/7/2020,147,102,0,249
CRISP,6/8/2020,147,102,0,249
CRISP,6/9/2020,148,103,0,251
CRISP,6/10/2020,149,106,0,255
CRISP,6/11/2020,149,108,0,257
CRISP,6/12/2020,152,114,0,266
CRISP,6/13/2020,152,114,0,266
CRISP,6/14/2020,152,114,0,266
CRISP,6/15/2020,152,116,0,268
CRISP,6/16/2020,152,118,0,270
CRISP,6/17/2020,153,118,0,271
CRISP,6/18/2020,153,119,0,272
CRISP,6/19/2020,154,120,0,274
CRISP,6/20/2020,155,121,0,276
CRISP,6/21/2020,155,122,0,277
CRISP,6/22/2020,156,124,0,280
CRISP,6/23/2020,157,125,0,282
CRISP,6/24/2020,159,126,0,285
CRISP,6/25/2020,160,128,0,288
CRISP,6/26/2020,160,131,0,291
CRISP,6/27/2020,161,134,0,295
CRISP,6/28/2020,163,136,0,299
CRISP,6/29/2020,164,136,0,300
CRISP,6/30/2020,167,139,0,306
CRISP,7/1/2020,170,140,0,310
CRISP,7/2/2020,174,140,0,314
CRISP,7/3/2020,175,140,0,315
CRISP,7/4/2020,179,142,0,321
CRISP,7/5/2020,181,144,0,325
CRISP,7/6/2020,187,147,0,334
CRISP,7/7/2020,191,150,0,341
CRISP,7/8/2020,192,151,0,343
CRISP,7/9/2020,192,152,0,344
CRISP,7/10/2020,194,153,0,347
CRISP,7/11/2020,194,158,0,352
CRISP,7/12/2020,195,160,0,355
CRISP,7/13/2020,202,160,0,362
CRISP,7/14/2020,203,162,0,365
CRISP,7/15/2020,204,163,0,367
CRISP,7/16/2020,206,163,0,369
CRISP,7/17/2020,209,164,0,373
CRISP,7/18/2020,209,164,0,373
CRISP,7/19/2020,210,164,0,374
CRISP,7/20/2020,211,166,0,377
CRISP,7/21/2020,213,166,0,379
CRISP,7/22/2020,215,166,0,381
CRISP,7/23/2020,216,166,0,382
CRISP,7/24/2020,216,168,0,384
CRISP,7/25/2020,218,169,0,387
CRISP,7/26/2020,219,170,0,389
CRISP,7/27/2020,222,171,0,393
CRISP,7/28/2020,222,173,0,395
CRISP,7/29/2020,222,175,0,397
CRISP,7/30/2020,222,175,0,397
CRISP,7/31/2020,224,176,0,400
CRISP,8/1/2020,226,177,0,403
CRISP,8/2/2020,227,177,0,404
CRISP,8/3/2020,228,178,0,406
CRISP,8/4/2020,230,179,0,409
CRISP,8/5/2020,232,179,2,413
CRISP,8/6/2020,233,180,2,415
CRISP,8/7/2020,233,182,2,417
CRISP,8/8/2020,235,183,2,420
CRISP,8/9/2020,236,183,2,421
CRISP,8/10/2020,238,187,2,427
CRISP,8/11/2020,241,187,2,430
CRISP,8/12/2020,241,187,3,431
CRISP,8/13/2020,241,188,3,432
CRISP,8/14/2020,241,191,3,435
CRISP,8/15/2020,241,192,3,436
CRISP,8/16/2020,241,192,3,436
CRISP,8/17/2020,242,192,3,437
CRISP,8/18/2020,245,193,3,441
CRISP,8/19/2020,257,200,3,460
CRISP,8/20/2020,259,201,4,464
CRISP,8/21/2020,261,205,4,470
CRISP,8/22/2020,265,205,4,474
CRISP,8/23/2020,265,207,4,476
CRISP,8/24/2020,269,209,4,482
CRISP,8/25/2020,272,209,4,485
CRISP,8/26/2020,274,214,4,492
CRISP,8/27/2020,275,215,4,494
CRISP,8/28/2020,279,217,4,500
CRISP,8/29/2020,280,217,4,501
CRISP,8/30/2020,281,217,4,502
CRISP,8/31/2020,282,221,4,507
CRISP,9/1/2020,285,221,4,510
CRISP,9/2/2020,288,222,4,514
CRISP,9/3/2020,288,225,4,517
CRISP,9/4/2020,290,228,4,522
CRISP,9/5/2020,290,229,4,523
CRISP,9/6/2020,290,230,4,524
CRISP,9/7/2020,290,234,4,528
CRISP,9/8/2020,290,235,4,529
CRISP,9/9/2020,293,236,4,533
CRISP,9/10/2020,294,236,4,534
CRISP,9/11/2020,296,236,4,536
CRISP,9/12/2020,298,236,4,538
CRISP,9/13/2020,298,237,4,539
CRISP,9/14/2020,302,238,4,544
CRISP,9/15/2020,302,238,4,544
CRISP,9/16/2020,302,238,4,544
CRISP,9/17/2020,304,239,4,547
CRISP,9/18/2020,305,239,4,548
CRISP,9/19/2020,306,239,4,549
CRISP,9/20/2020,307,239,4,550
CRISP,9/21/2020,308,239,4,551
CRISP,9/22/2020,310,240,4,554
CRISP,9/23/2020,313,243,4,560
CRISP,9/24/2020,315,246,4,565
CRISP,9/25/2020,321,250,4,575
CRISP,9/26/2020,321,250,4,575
CRISP,9/27/2020,322,251,4,577
CRISP,9/28/2020,324,253,4,581
CRISP,9/29/2020,325,260,4,589
CRISP,9/30/2020,327,261,5,593
CRISP,10/1/2020,329,261,6,596
CRISP,10/2/2020,329,263,6,598
CRISP,10/3/2020,329,263,6,598
CRISP,10/4/2020,329,265,6,600
CRISP,10/5/2020,333,269,6,608
CRISP,10/6/2020,334,269,6,609
CRISP,10/7/2020,337,270,6,613
CRISP,10/8/2020,337,272,6,615
CRISP,10/9/2020,338,272,6,616
CRISP,10/10/2020,338,274,6,618
CRISP,10/11/2020,340,274,6,620
CRISP,10/12/2020,342,274,6,622
CRISP,10/13/2020,345,275,6,626
CRISP,10/14/2020,345,275,6,626
CRISP,10/15/2020,349,276,7,632
CRISP,10/16/2020,350,276,7,633
CRISP,10/17/2020,350,276,7,633
CRISP,10/18/2020,350,276,7,633
CRISP,10/19/2020,350,276,7,633
CRISP,10/20/2020,350,276,7,633
DADE,1/1/2020,0,0,0,0
DADE,1/2/2020,0,0,0,0
DADE,1/3/2020,0,0,0,0
DADE,1/4/2020,0,0,0,0
DADE,1/5/2020,0,0,0,0
DADE,1/6/2020,0,0,0,0
DADE,1/7/2020,0,0,0,0
DADE,1/8/2020,0,0,0,0
DADE,1/9/2020,0,0,0,0
DADE,1/10/2020,0,0,0,0
DADE,1/11/2020,0,0,0,0
DADE,1/12/2020,0,0,0,0
DADE,1/13/2020,0,0,0,0
DADE,1/14/2020,0,0,0,0
DADE,1/15/2020,0,0,0,0
DADE,1/16/2020,0,0,0,0
DADE,1/17/2020,0,0,0,0
DADE,1/18/2020,0,0,0,0
DADE,1/19/2020,0,0,0,0
DADE,1/20/2020,0,0,0,0
DADE,1/21/2020,0,0,0,0
DADE,1/22/2020,0,0,0,0
DADE,1/23/2020,0,0,0,0
DADE,1/24/2020,0,0,0,0
DADE,1/25/2020,0,0,0,0
DADE,1/26/2020,0,0,0,0
DADE,1/27/2020,0,0,0,0
DADE,1/28/2020,0,0,0,0
DADE,1/29/2020,0,0,0,0
DADE,1/30/2020,0,0,0,0
DADE,1/31/2020,0,0,0,0
DADE,2/1/2020,0,0,0,0
DADE,2/2/2020,0,0,0,0
DADE,2/3/2020,0,0,0,0
DADE,2/4/2020,0,0,0,0
DADE,2/5/2020,0,0,0,0
DADE,2/6/2020,0,0,0,0
DADE,2/7/2020,0,0,0,0
DADE,2/8/2020,0,0,0,0
DADE,2/9/2020,0,0,0,0
DADE,2/10/2020,0,0,0,0
DADE,2/11/2020,0,0,0,0
DADE,2/12/2020,0,0,0,0
DADE,2/13/2020,0,0,0,0
DADE,2/14/2020,0,0,0,0
DADE,2/15/2020,0,0,0,0
DADE,2/16/2020,0,0,0,0
DADE,2/17/2020,0,0,0,0
DADE,2/18/2020,0,0,0,0
DADE,2/19/2020,0,0,0,0
DADE,2/20/2020,0,0,0,0
DADE,2/21/2020,0,0,0,0
DADE,2/22/2020,0,0,0,0
DADE,2/23/2020,0,0,0,0
DADE,2/24/2020,0,0,0,0
DADE,2/25/2020,0,0,0,0
DADE,2/26/2020,0,0,0,0
DADE,2/27/2020,0,0,0,0
DADE,2/28/2020,0,0,0,0
DADE,2/29/2020,0,0,0,0
DADE,3/1/2020,0,0,0,0
DADE,3/2/2020,0,0,0,0
DADE,3/3/2020,0,0,0,0
DADE,3/4/2020,0,0,0,0
DADE,3/5/2020,0,0,0,0
DADE,3/6/2020,0,0,0,0
DADE,3/7/2020,0,0,0,0
DADE,3/8/2020,0,0,0,0
DADE,3/9/2020,0,0,0,0
DADE,3/10/2020,0,0,0,0
DADE,3/11/2020,0,0,0,0
DADE,3/12/2020,0,0,0,0
DADE,3/13/2020,0,0,0,0
DADE,3/14/2020,0,0,0,0
DADE,3/15/2020,1,0,0,1
DADE,3/16/2020,1,0,0,1
DADE,3/17/2020,1,0,0,1
DADE,3/18/2020,1,0,0,1
DADE,3/19/2020,2,0,0,2
DADE,3/20/2020,2,0,0,2
DADE,3/21/2020,2,0,0,2
DADE,3/22/2020,2,0,0,2
DADE,3/23/2020,2,0,0,2
DADE,3/24/2020,2,0,0,2
DADE,3/25/2020,2,0,0,2
DADE,3/26/2020,2,0,0,2
DADE,3/27/2020,2,0,0,2
DADE,3/28/2020,2,0,0,2
DADE,3/29/2020,2,0,0,2
DADE,3/30/2020,3,1,0,4
DADE,3/31/2020,3,1,0,4
DADE,4/1/2020,3,1,0,4
DADE,4/2/2020,3,1,0,4
DADE,4/3/2020,3,1,0,4
DADE,4/4/2020,3,2,0,5
DADE,4/5/2020,4,2,0,6
DADE,4/6/2020,4,2,0,6
DADE,4/7/2020,4,2,0,6
DADE,4/8/2020,4,2,0,6
DADE,4/9/2020,4,2,0,6
DADE,4/10/2020,4,2,0,6
DADE,4/11/2020,4,2,0,6
DADE,4/12/2020,4,2,0,6
DADE,4/13/2020,4,2,0,6
DADE,4/14/2020,6,3,0,9
DADE,4/15/2020,6,3,0,9
DADE,4/16/2020,6,3,0,9
DADE,4/17/2020,6,5,0,11
DADE,4/18/2020,6,5,0,11
DADE,4/19/2020,6,5,0,11
DADE,4/20/2020,6,5,0,11
DADE,4/21/2020,6,6,0,12
DADE,4/22/2020,6,6,0,12
DADE,4/23/2020,6,6,0,12
DADE,4/24/2020,7,6,0,13
DADE,4/25/2020,7,6,0,13
DADE,4/26/2020,8,6,0,14
DADE,4/27/2020,8,6,0,14
DADE,4/28/2020,8,6,0,14
DADE,4/29/2020,8,6,0,14
DADE,4/30/2020,8,6,0,14
DADE,5/1/2020,8,6,0,14
DADE,5/2/2020,8,6,0,14
DADE,5/3/2020,8,7,0,15
DADE,5/4/2020,8,8,0,16
DADE,5/5/2020,8,8,0,16
DADE,5/6/2020,8,8,0,16
DADE,5/7/2020,8,9,0,17
DADE,5/8/2020,8,9,0,17
DADE,5/9/2020,8,9,0,17
DADE,5/10/2020,8,9,0,17
DADE,5/11/2020,8,10,0,18
DADE,5/12/2020,8,10,0,18
DADE,5/13/2020,9,11,1,21
DADE,5/14/2020,11,14,1,26
DADE,5/15/2020,11,14,1,26
DADE,5/16/2020,11,14,1,26
DADE,5/17/2020,11,14,1,26
DADE,5/18/2020,12,14,1,27
DADE,5/19/2020,13,14,1,28
DADE,5/20/2020,13,14,1,28
DADE,5/21/2020,13,14,1,28
DADE,5/22/2020,13,14,1,28
DADE,5/23/2020,13,14,1,28
DADE,5/24/2020,13,14,1,28
DADE,5/25/2020,13,14,1,28
DADE,5/26/2020,13,14,2,29
DADE,5/27/2020,14,15,2,31
DADE,5/28/2020,15,16,2,33
DADE,5/29/2020,18,17,2,37
DADE,5/30/2020,19,18,2,39
DADE,5/31/2020,19,19,2,40
DADE,6/1/2020,19,19,2,40
DADE,6/2/2020,21,20,2,43
DADE,6/3/2020,21,21,2,44
DADE,6/4/2020,21,22,2,45
DADE,6/5/2020,21,22,2,45
DADE,6/6/2020,22,22,2,46
DADE,6/7/2020,22,23,2,47
DADE,6/8/2020,22,25,2,49
DADE,6/9/2020,22,28,2,52
DADE,6/10/2020,22,29,2,53
DADE,6/11/2020,24,30,2,56
DADE,6/12/2020,24,30,2,56
DADE,6/13/2020,25,30,2,57
DADE,6/14/2020,25,30,2,57
DADE,6/15/2020,26,31,2,59
DADE,6/16/2020,26,33,2,61
DADE,6/17/2020,26,34,2,62
DADE,6/18/2020,26,35,2,63
DADE,6/19/2020,27,35,2,64
DADE,6/20/2020,27,35,2,64
DADE,6/21/2020,27,35,2,64
DADE,6/22/2020,27,35,2,64
DADE,6/23/2020,28,35,2,65
DADE,6/24/2020,32,36,2,70
DADE,6/25/2020,35,39,2,76
DADE,6/26/2020,38,39,2,79
DADE,6/27/2020,38,39,2,79
DADE,6/28/2020,38,39,2,79
DADE,6/29/2020,39,40,2,81
DADE,6/30/2020,40,41,2,83
COLQUITT,9/21/2020,944,935,7,1886
COBB,6/7/2020,2034,1644,6,3684
CLINCH,2/28/2020,0,0,0,0
COLQUITT,9/22/2020,946,936,7,1889
CLINCH,2/29/2020,0,0,0,0
COLQUITT,9/23/2020,948,936,7,1891
CLINCH,3/1/2020,0,0,0,0
COLQUITT,9/24/2020,949,938,7,1894
CLINCH,3/2/2020,0,0,0,0
CLINCH,3/3/2020,0,0,0,0
CLINCH,3/4/2020,0,0,0,0
CLINCH,3/5/2020,0,0,0,0
CLINCH,3/6/2020,0,0,0,0
CLINCH,3/7/2020,0,0,0,0
CLINCH,3/8/2020,0,0,0,0
CLINCH,3/9/2020,0,0,0,0
CLINCH,3/10/2020,0,0,0,0
CLINCH,3/11/2020,0,0,0,0
CLINCH,3/12/2020,0,0,0,0
CLINCH,3/13/2020,0,0,0,0
CLINCH,3/14/2020,0,1,0,1
CLINCH,3/15/2020,1,1,0,2
CLINCH,3/16/2020,1,1,0,2
CLINCH,3/17/2020,1,1,0,2
CLINCH,3/18/2020,1,1,0,2
CLINCH,3/19/2020,1,1,0,2
CLINCH,3/20/2020,1,1,0,2
CLINCH,3/21/2020,1,1,0,2
CLINCH,3/22/2020,1,1,0,2
CLINCH,3/23/2020,2,1,0,3
CLINCH,3/24/2020,2,1,0,3
CLINCH,3/25/2020,2,1,0,3
CLINCH,3/26/2020,2,1,0,3
CLINCH,3/27/2020,2,1,0,3
CLINCH,3/28/2020,2,1,0,3
CLINCH,3/29/2020,3,1,0,4
CLINCH,3/30/2020,3,1,0,4
CLINCH,3/31/2020,4,1,0,5
CLINCH,4/1/2020,5,1,0,6
CLINCH,4/2/2020,5,1,0,6
CLINCH,4/3/2020,5,1,0,6
CLINCH,4/4/2020,5,1,0,6
CLINCH,4/5/2020,5,1,0,6
CLINCH,4/6/2020,7,1,0,8
CLINCH,4/7/2020,7,1,0,8
CLINCH,4/8/2020,9,1,0,10
CLINCH,4/9/2020,9,1,0,10
CLINCH,4/10/2020,10,1,0,11
CLINCH,4/11/2020,10,1,0,11
CLINCH,4/12/2020,10,1,0,11
CLINCH,4/13/2020,10,1,0,11
CLINCH,4/14/2020,10,1,0,11
CLINCH,4/15/2020,10,1,0,11
CLINCH,4/16/2020,10,1,0,11
CLINCH,4/17/2020,10,1,0,11
CLINCH,4/18/2020,10,1,0,11
CLINCH,4/19/2020,10,1,0,11
CLINCH,4/20/2020,11,2,0,13
CLINCH,4/21/2020,11,2,0,13
CLINCH,4/22/2020,11,2,0,13
CLINCH,4/23/2020,11,2,0,13
CLINCH,4/24/2020,11,2,0,13
CLINCH,4/25/2020,11,2,0,13
CLINCH,4/26/2020,11,2,0,13
CLINCH,4/27/2020,11,2,0,13
COBB,6/8/2020,2098,1685,7,3790
CLINCH,4/28/2020,12,2,0,14
CLINCH,4/29/2020,12,2,0,14
CLINCH,4/30/2020,12,2,0,14
CLINCH,5/1/2020,12,2,0,14
CLINCH,5/2/2020,12,2,0,14
CLINCH,5/3/2020,12,2,0,14
CLINCH,5/4/2020,13,3,0,16
CLINCH,5/5/2020,13,3,0,16
CLINCH,5/6/2020,14,3,0,17
CLINCH,5/7/2020,17,5,0,22
CLINCH,5/8/2020,19,6,0,25
CLINCH,5/9/2020,19,6,0,25
CLINCH,5/10/2020,26,12,0,38
CLINCH,5/11/2020,27,17,0,44
CLINCH,5/12/2020,27,18,0,45
CLINCH,5/13/2020,28,19,0,47
CLINCH,5/14/2020,31,22,0,53
CLINCH,5/15/2020,31,23,0,54
CLINCH,5/16/2020,32,23,0,55
CLINCH,5/17/2020,32,23,0,55
CLINCH,5/18/2020,32,23,0,55
CLINCH,5/19/2020,32,23,0,55
CLINCH,5/20/2020,33,25,0,58
CLINCH,5/21/2020,34,27,0,61
CLINCH,5/22/2020,34,27,0,61
CLINCH,5/23/2020,34,28,0,62
CLINCH,5/24/2020,36,29,0,65
CLINCH,5/25/2020,36,29,0,65
CLINCH,5/26/2020,36,30,0,66
CLINCH,5/27/2020,36,30,0,66
CLINCH,5/28/2020,36,32,0,68
CLINCH,5/29/2020,37,33,0,70
CLINCH,5/30/2020,37,33,0,70
CLINCH,5/31/2020,37,33,0,70
CLINCH,6/1/2020,38,33,0,71
CLINCH,6/2/2020,38,34,0,72
CLINCH,6/3/2020,38,35,0,73
CLINCH,6/4/2020,39,35,0,74
CLINCH,6/5/2020,40,36,0,76
CLINCH,6/6/2020,40,36,0,76
CLINCH,6/7/2020,42,36,0,78
CLINCH,6/8/2020,42,37,0,79
CLINCH,6/9/2020,44,37,0,81
CLINCH,6/10/2020,45,38,0,83
CLINCH,6/11/2020,47,40,0,87
CLINCH,6/12/2020,48,40,0,88
CLINCH,6/13/2020,48,41,0,89
CLINCH,6/14/2020,49,41,0,90
CLINCH,6/15/2020,50,41,0,91
CLINCH,6/16/2020,52,42,0,94
CLINCH,6/17/2020,54,43,0,97
CLINCH,6/18/2020,56,45,0,101
CLINCH,6/19/2020,57,46,0,103
CLINCH,6/20/2020,60,46,0,106
CLINCH,6/21/2020,61,46,0,107
CLINCH,6/22/2020,64,51,0,115
CLINCH,6/23/2020,66,52,0,118
CLINCH,6/24/2020,68,54,0,122
CLINCH,6/25/2020,69,54,0,123
CLINCH,6/26/2020,71,55,0,126
CLINCH,6/27/2020,71,55,0,126
CLINCH,6/28/2020,72,57,0,129
CLINCH,6/29/2020,77,61,0,138
CLINCH,6/30/2020,77,65,0,142
CLINCH,7/1/2020,78,66,1,145
CLINCH,7/2/2020,78,67,1,146
CLINCH,7/3/2020,79,69,1,149
CLINCH,7/4/2020,79,69,1,149
CLINCH,7/5/2020,80,69,1,150
CLINCH,7/6/2020,81,70,1,152
CLINCH,7/7/2020,88,70,1,159
CLINCH,7/8/2020,91,71,1,163
CLINCH,7/9/2020,91,74,1,166
CLINCH,7/10/2020,95,77,2,174
CLINCH,7/11/2020,95,77,2,174
CLINCH,7/12/2020,96,78,2,176
CLINCH,7/13/2020,100,79,2,181
CLINCH,7/14/2020,103,83,2,188
CLINCH,7/15/2020,103,85,2,190
CLINCH,7/16/2020,104,86,2,192
CLINCH,7/17/2020,108,87,2,197
CLINCH,7/18/2020,109,87,2,198
CLINCH,7/19/2020,109,87,2,198
CLINCH,7/20/2020,110,88,2,200
CLINCH,7/21/2020,111,88,3,202
CLINCH,7/22/2020,111,90,3,204
CLINCH,7/23/2020,112,91,3,206
CLINCH,7/24/2020,113,91,3,207
CLINCH,7/25/2020,114,91,3,208
CLINCH,7/26/2020,114,92,3,209
CLINCH,7/27/2020,115,92,3,210
CLINCH,7/28/2020,119,123,3,245
CLINCH,7/29/2020,119,123,3,245
CLINCH,7/30/2020,120,125,3,248
CLINCH,7/31/2020,121,125,3,249
CLINCH,8/1/2020,121,127,3,251
CLINCH,8/2/2020,121,128,3,252
CLINCH,8/3/2020,125,128,3,256
CLINCH,8/4/2020,126,128,3,257
CLINCH,8/5/2020,130,129,3,262
CLINCH,8/6/2020,131,129,3,263
CLINCH,8/7/2020,134,131,3,268
CLINCH,8/8/2020,135,131,3,269
CLINCH,8/9/2020,136,131,3,270
CLINCH,8/10/2020,142,135,3,280
CLINCH,8/11/2020,143,136,3,282
CLINCH,8/12/2020,143,137,3,283
CLINCH,8/13/2020,145,138,3,286
CLINCH,8/14/2020,146,139,3,288
CLINCH,8/15/2020,148,140,3,291
CLINCH,8/16/2020,148,141,3,292
CLINCH,8/17/2020,151,142,3,296
CLINCH,8/18/2020,154,145,3,302
CLINCH,8/19/2020,156,147,3,306
CLINCH,8/20/2020,156,147,3,306
CLINCH,8/21/2020,158,150,3,311
CLINCH,8/22/2020,159,151,3,313
CLINCH,8/23/2020,159,153,3,315
CLINCH,8/24/2020,159,153,3,315
CLINCH,8/25/2020,160,153,3,316
CLINCH,8/26/2020,162,153,3,318
CLINCH,8/27/2020,163,156,3,322
CLINCH,8/28/2020,164,158,3,325
CLINCH,8/29/2020,167,162,3,332
CLINCH,8/30/2020,167,163,3,333
CLINCH,8/31/2020,170,163,3,336
CLINCH,9/1/2020,175,163,3,341
CLINCH,9/2/2020,175,163,3,341
CLINCH,9/3/2020,175,163,3,341
CLINCH,9/4/2020,176,165,3,344
CLINCH,9/5/2020,176,165,3,344
CLINCH,9/6/2020,179,166,3,348
CLINCH,9/7/2020,179,168,3,350
CLINCH,9/8/2020,184,170,3,357
CLINCH,9/9/2020,186,170,3,359
CLINCH,9/10/2020,187,172,3,362
CLINCH,9/11/2020,195,174,3,372
CLINCH,9/12/2020,196,175,3,374
CLINCH,9/13/2020,198,176,3,377
CLINCH,9/14/2020,199,178,3,380
CLINCH,9/15/2020,201,178,3,382
CLINCH,9/16/2020,203,183,3,389
CLINCH,9/17/2020,204,184,3,391
CLINCH,9/18/2020,205,185,3,393
CLINCH,9/19/2020,208,186,3,397
CLINCH,9/20/2020,208,187,3,398
CLINCH,9/21/2020,210,187,3,400
CLINCH,9/22/2020,211,188,3,402
CLINCH,9/23/2020,212,189,3,404
CLINCH,9/24/2020,212,189,3,404
CLINCH,9/25/2020,212,190,3,405
CLINCH,9/26/2020,212,190,3,405
CLINCH,9/27/2020,214,190,3,407
CLINCH,9/28/2020,214,190,3,407
CLINCH,9/29/2020,214,191,3,408
CLINCH,9/30/2020,215,193,3,411
CLINCH,10/1/2020,215,196,3,414
CLINCH,10/2/2020,217,197,3,417
CLINCH,10/3/2020,217,197,3,417
CLINCH,10/4/2020,217,199,3,419
CLINCH,10/5/2020,218,200,3,421
CLINCH,10/6/2020,218,200,3,421
CLINCH,10/7/2020,218,201,3,422
CLINCH,10/8/2020,220,201,3,424
CLINCH,10/9/2020,220,203,3,426
CLINCH,10/10/2020,220,204,3,427
CLINCH,10/11/2020,220,204,3,427
CLINCH,10/12/2020,220,204,3,427
CLINCH,10/13/2020,221,204,3,428
CLINCH,10/14/2020,221,204,3,428
CLINCH,10/15/2020,222,204,3,429
CLINCH,10/16/2020,222,204,3,429
CLINCH,10/17/2020,222,204,3,429
CLINCH,10/18/2020,222,205,3,430
CLINCH,10/19/2020,222,205,3,430
CLINCH,10/20/2020,222,205,3,430
COBB,1/1/2020,0,0,0,0
COBB,1/2/2020,0,0,0,0
COBB,1/3/2020,0,0,0,0
COBB,1/4/2020,0,0,0,0
COBB,1/5/2020,0,0,0,0
COBB,1/6/2020,0,0,0,0
COBB,1/7/2020,0,0,0,0
COBB,1/8/2020,0,0,0,0
COBB,1/9/2020,0,0,0,0
COBB,1/10/2020,0,0,0,0
COBB,1/11/2020,0,0,0,0
COBB,1/12/2020,0,0,0,0
COBB,1/13/2020,0,0,0,0
COBB,1/14/2020,0,0,0,0
COBB,1/15/2020,0,0,0,0
COBB,1/16/2020,0,0,0,0
COBB,1/17/2020,0,0,0,0
COBB,1/18/2020,0,0,0,0
COBB,1/19/2020,0,0,0,0
COBB,1/20/2020,0,0,0,0
COBB,1/21/2020,0,0,0,0
COBB,1/22/2020,0,0,0,0
COBB,1/23/2020,0,0,0,0
COBB,1/24/2020,0,0,0,0
COBB,1/25/2020,0,0,0,0
COBB,1/26/2020,0,0,0,0
COBB,1/27/2020,0,0,0,0
COBB,1/28/2020,0,0,0,0
COBB,1/29/2020,0,0,0,0
COBB,1/30/2020,0,0,0,0
COBB,1/31/2020,0,0,0,0
COBB,2/1/2020,0,0,0,0
COBB,2/2/2020,0,0,0,0
COBB,2/3/2020,0,0,0,0
COBB,2/4/2020,0,0,0,0
COBB,2/5/2020,0,0,0,0
COBB,2/6/2020,0,0,0,0
COBB,2/7/2020,0,0,0,0
COBB,2/8/2020,0,0,0,0
COBB,2/9/2020,0,0,0,0
COBB,2/10/2020,0,0,0,0
COBB,2/11/2020,0,0,0,0
COBB,2/12/2020,0,0,0,0
COBB,2/13/2020,0,0,0,0
COBB,2/14/2020,0,0,0,0
COBB,2/15/2020,0,0,0,0
COBB,2/16/2020,0,0,0,0
COBB,2/17/2020,0,0,0,0
COBB,2/18/2020,0,0,0,0
COBB,2/19/2020,0,0,0,0
COBB,2/20/2020,0,0,0,0
COBB,2/21/2020,0,1,0,1
COBB,2/22/2020,1,2,0,3
COBB,2/23/2020,2,3,0,5
COBB,2/24/2020,3,4,0,7
COBB,2/25/2020,3,4,0,7
COBB,2/26/2020,4,5,0,9
COBB,2/27/2020,5,5,0,10
COBB,2/28/2020,6,8,0,14
COBB,2/29/2020,7,9,0,16
COBB,3/1/2020,11,12,0,23
COBB,3/2/2020,12,17,0,29
COBB,3/3/2020,13,22,0,35
COBB,3/4/2020,20,27,0,47
COBB,3/5/2020,22,29,0,51
COBB,3/6/2020,24,31,0,55
COBB,3/7/2020,27,36,0,63
COBB,3/8/2020,32,44,0,76
COBB,3/9/2020,39,48,0,87
COBB,3/10/2020,52,55,0,107
COBB,3/11/2020,66,66,0,132
COBB,3/12/2020,74,76,0,150
COBB,3/13/2020,90,94,0,184
COBB,3/14/2020,103,105,0,208
COBB,3/15/2020,120,124,0,244
COBB,3/16/2020,137,141,0,278
COBB,3/17/2020,154,157,0,311
COBB,3/18/2020,173,182,0,355
COBB,3/19/2020,191,196,0,387
COBB,3/20/2020,213,214,0,427
COBB,3/21/2020,228,224,0,452
COBB,3/22/2020,248,240,0,488
COBB,3/23/2020,263,256,0,519
COBB,3/24/2020,276,274,0,550
COBB,3/25/2020,292,302,0,594
COBB,3/26/2020,307,314,0,621
COBB,3/27/2020,323,323,0,646
COBB,3/28/2020,337,335,0,672
COBB,3/29/2020,348,340,0,688
COBB,3/30/2020,363,368,0,731
COBB,3/31/2020,377,375,0,752
COBB,4/1/2020,404,393,0,797
COBB,4/2/2020,421,402,0,823
COBB,4/3/2020,435,415,0,850
COBB,4/4/2020,442,421,0,863
COBB,4/5/2020,455,430,0,885
COBB,4/6/2020,478,451,0,929
COBB,4/7/2020,495,460,0,955
COBB,4/8/2020,518,481,0,999
COBB,4/9/2020,544,497,0,1041
COBB,4/10/2020,571,515,0,1086
COBB,4/11/2020,596,530,0,1126
COBB,4/12/2020,616,537,0,1153
COBB,4/13/2020,658,563,0,1221
COBB,4/14/2020,687,592,0,1279
COBB,4/15/2020,725,614,0,1339
COBB,4/16/2020,742,634,0,1376
COBB,4/17/2020,780,649,0,1429
COBB,4/18/2020,792,663,0,1455
COBB,4/19/2020,803,671,0,1474
COBB,4/20/2020,833,689,0,1522
COBB,4/21/2020,892,722,0,1614
COBB,4/22/2020,927,741,0,1668
COBB,4/23/2020,949,767,0,1716
COBB,4/24/2020,985,786,0,1771
COBB,4/25/2020,1001,801,0,1802
COBB,4/26/2020,1020,817,0,1837
COBB,4/27/2020,1077,846,0,1923
COBB,4/28/2020,1113,859,0,1972
COBB,4/29/2020,1136,878,0,2014
COBB,4/30/2020,1170,904,2,2076
COBB,5/1/2020,1214,921,2,2137
COBB,5/2/2020,1227,936,2,2165
COBB,5/3/2020,1239,944,2,2185
COBB,5/4/2020,1254,969,2,2225
COBB,5/5/2020,1289,983,2,2274
COBB,5/6/2020,1302,997,3,2302
COBB,5/7/2020,1321,1007,3,2331
COBB,5/8/2020,1355,1041,3,2399
COBB,5/9/2020,1365,1057,3,2425
COBB,5/10/2020,1378,1073,3,2454
COBB,5/11/2020,1413,1091,3,2507
COBB,5/12/2020,1441,1121,3,2565
COBB,5/13/2020,1471,1136,3,2610
COBB,5/14/2020,1497,1158,3,2658
COBB,5/15/2020,1520,1176,3,2699
COBB,5/16/2020,1543,1191,3,2737
COBB,5/17/2020,1558,1205,3,2766
COBB,5/18/2020,1583,1227,3,2813
COBB,5/19/2020,1605,1249,3,2857
COBB,5/20/2020,1624,1270,3,2897
COBB,5/21/2020,1648,1289,3,2940
COBB,5/22/2020,1675,1303,3,2981
COBB,5/23/2020,1692,1325,3,3020
COBB,5/24/2020,1698,1335,3,3036
COBB,5/25/2020,1713,1351,3,3067
COBB,5/26/2020,1740,1369,4,3113
COBB,5/27/2020,1761,1385,4,3150
COBB,5/28/2020,1776,1402,5,3183
COBB,5/29/2020,1796,1423,5,3224
COBB,5/30/2020,1811,1441,5,3257
COBB,5/31/2020,1824,1449,5,3278
COBB,6/1/2020,1865,1474,5,3344
COBB,6/2/2020,1885,1505,5,3395
COBB,6/3/2020,1916,1531,5,3452
COBB,6/4/2020,1955,1564,5,3524
COBB,6/5/2020,1994,1602,5,3601
COBB,6/6/2020,2012,1627,5,3644
COLQUITT,9/25/2020,951,942,8,1901
COLQUITT,9/26/2020,952,943,8,1903
COLQUITT,9/27/2020,954,946,8,1908
COLQUITT,9/28/2020,955,948,8,1911
COLQUITT,9/29/2020,958,951,8,1917
COLQUITT,9/30/2020,960,951,8,1919
COLQUITT,10/1/2020,964,955,8,1927
COLQUITT,10/2/2020,967,958,8,1933
COLQUITT,10/3/2020,970,959,8,1937
COLQUITT,10/4/2020,975,965,8,1948
COLQUITT,10/5/2020,985,969,8,1962
COLQUITT,10/6/2020,991,974,8,1973
COLQUITT,10/7/2020,996,982,8,1986
COLQUITT,10/8/2020,1001,986,8,1995
COLQUITT,10/9/2020,1014,991,8,2013
COLQUITT,10/10/2020,1017,997,8,2022
COLQUITT,10/11/2020,1019,1000,8,2027
COLQUITT,10/12/2020,1025,1004,8,2037
COLQUITT,10/13/2020,1037,1012,8,2057
COLQUITT,10/14/2020,1042,1015,8,2065
COLQUITT,10/15/2020,1047,1020,8,2075
COLQUITT,10/16/2020,1047,1021,8,2076
COLQUITT,10/17/2020,1048,1023,8,2079
COLQUITT,10/18/2020,1050,1024,8,2082
COLQUITT,10/19/2020,1052,1024,8,2084
COLQUITT,10/20/2020,1052,1024,8,2084
COWETA,1/1/2020,0,0,0,0
COWETA,1/2/2020,0,0,0,0
COWETA,1/3/2020,0,0,0,0
COWETA,1/4/2020,0,0,0,0
COWETA,1/5/2020,0,0,0,0
COWETA,1/6/2020,0,0,0,0
COWETA,1/7/2020,0,0,0,0
COWETA,1/8/2020,0,0,0,0
COWETA,1/9/2020,0,0,0,0
COWETA,1/10/2020,0,0,0,0
COWETA,1/11/2020,0,0,0,0
COWETA,1/12/2020,0,0,0,0
COWETA,1/13/2020,0,0,0,0
COWETA,1/14/2020,0,0,0,0
COWETA,1/15/2020,0,0,0,0
COWETA,1/16/2020,0,0,0,0
COWETA,1/17/2020,0,0,0,0
COWETA,1/18/2020,0,0,0,0
COWETA,1/19/2020,0,0,0,0
COWETA,1/20/2020,0,0,0,0
COWETA,1/21/2020,0,0,0,0
COWETA,1/22/2020,0,0,0,0
COWETA,1/23/2020,0,0,0,0
COWETA,1/24/2020,0,0,0,0
COWETA,1/25/2020,0,0,0,0
COWETA,1/26/2020,0,0,0,0
COWETA,1/27/2020,0,0,0,0
COWETA,1/28/2020,0,0,0,0
COWETA,1/29/2020,0,0,0,0
COWETA,1/30/2020,0,0,0,0
COWETA,1/31/2020,0,0,0,0
COWETA,2/1/2020,0,0,0,0
COWETA,2/2/2020,0,0,0,0
COWETA,2/3/2020,0,0,0,0
COWETA,2/4/2020,0,0,0,0
COWETA,2/5/2020,0,0,0,0
COWETA,2/6/2020,0,0,0,0
COWETA,2/7/2020,0,0,0,0
COWETA,2/8/2020,0,0,0,0
COBB,6/9/2020,2128,1716,7,3851
COWETA,2/9/2020,0,0,0,0
COWETA,2/10/2020,0,0,0,0
COWETA,2/11/2020,0,0,0,0
COWETA,2/12/2020,0,0,0,0
COWETA,2/13/2020,0,0,0,0
COWETA,2/14/2020,0,0,0,0
COWETA,2/15/2020,0,0,0,0
COWETA,2/16/2020,0,0,0,0
COWETA,2/17/2020,0,0,0,0
COWETA,2/18/2020,0,0,0,0
COWETA,2/19/2020,0,0,0,0
COWETA,2/20/2020,0,0,0,0
COWETA,2/21/2020,0,0,0,0
COWETA,2/22/2020,0,0,0,0
COWETA,2/23/2020,0,0,0,0
COWETA,2/24/2020,0,0,0,0
COWETA,2/25/2020,0,0,0,0
COWETA,2/26/2020,0,0,0,0
COWETA,2/27/2020,0,0,0,0
COWETA,2/28/2020,1,0,0,1
COWETA,2/29/2020,1,0,0,1
COWETA,3/1/2020,1,2,0,3
COWETA,3/2/2020,2,3,0,5
COWETA,3/3/2020,2,3,0,5
COWETA,3/4/2020,2,3,0,5
COWETA,3/5/2020,2,3,0,5
COWETA,3/6/2020,2,3,0,5
COWETA,3/7/2020,2,4,0,6
COWETA,3/8/2020,2,4,0,6
COWETA,3/9/2020,4,5,0,9
COWETA,3/10/2020,4,5,0,9
COWETA,3/11/2020,4,7,0,11
COWETA,3/12/2020,5,9,0,14
COWETA,3/13/2020,8,9,0,17
COWETA,3/14/2020,8,9,0,17
COWETA,3/15/2020,10,10,0,20
COWETA,3/16/2020,11,11,0,22
COWETA,3/17/2020,13,12,0,25
COWETA,3/18/2020,15,15,0,30
COWETA,3/19/2020,18,17,0,35
COWETA,3/20/2020,20,20,0,40
COWETA,3/21/2020,21,21,0,42
COWETA,3/22/2020,24,22,0,46
COWETA,3/23/2020,25,26,0,51
COWETA,3/24/2020,26,29,0,55
COWETA,3/25/2020,28,34,0,62
COWETA,3/26/2020,31,35,0,66
COWETA,3/27/2020,37,36,0,73
COWETA,3/28/2020,40,38,0,78
COWETA,3/29/2020,40,40,0,80
COWETA,3/30/2020,43,40,0,83
COWETA,3/31/2020,45,42,0,87
COWETA,4/1/2020,51,44,0,95
COWETA,4/2/2020,53,44,0,97
COWETA,4/3/2020,54,48,0,102
COWETA,4/4/2020,56,49,0,105
COWETA,4/5/2020,57,50,0,107
COWETA,4/6/2020,64,55,0,119
COWETA,4/7/2020,68,55,0,123
COWETA,4/8/2020,71,57,0,128
COWETA,4/9/2020,76,62,0,138
COWETA,4/10/2020,79,66,0,145
COWETA,4/11/2020,85,68,0,153
COWETA,4/12/2020,88,69,0,157
COWETA,4/13/2020,91,72,0,163
COWETA,4/14/2020,92,76,0,168
COWETA,4/15/2020,98,77,0,175
COWETA,4/16/2020,102,80,0,182
COWETA,4/17/2020,105,81,0,186
COWETA,4/18/2020,106,82,0,188
COWETA,4/19/2020,107,82,0,189
COWETA,4/20/2020,111,88,0,199
COWETA,4/21/2020,114,89,0,203
COWETA,4/22/2020,117,93,0,210
COWETA,4/23/2020,119,93,0,212
COWETA,4/24/2020,121,96,0,217
COWETA,4/25/2020,122,99,0,221
COWETA,4/26/2020,123,101,0,224
COWETA,4/27/2020,129,106,0,235
COWETA,4/28/2020,130,111,0,241
COWETA,4/29/2020,137,115,0,252
COWETA,4/30/2020,139,119,0,258
COWETA,5/1/2020,142,125,0,267
COWETA,5/2/2020,145,126,0,271
COWETA,5/3/2020,148,126,0,274
COWETA,5/4/2020,152,130,0,282
COWETA,5/5/2020,153,131,0,284
COWETA,5/6/2020,153,134,0,287
COWETA,5/7/2020,156,143,0,299
COWETA,5/8/2020,158,144,0,302
COWETA,5/9/2020,159,144,0,303
COWETA,5/10/2020,160,145,0,305
COWETA,5/11/2020,163,146,0,309
COWETA,5/12/2020,164,151,0,315
COWETA,5/13/2020,165,151,0,316
COWETA,5/14/2020,177,156,0,333
COWETA,5/15/2020,180,161,0,341
COWETA,5/16/2020,182,165,0,347
COWETA,5/17/2020,183,165,0,348
COWETA,5/18/2020,193,171,0,364
COWETA,5/19/2020,205,178,0,383
COWETA,5/20/2020,211,180,0,391
COWETA,5/21/2020,214,183,0,397
COWETA,5/22/2020,220,184,0,404
COWETA,5/23/2020,227,185,0,412
COWETA,5/24/2020,227,185,0,412
COWETA,5/25/2020,229,187,0,416
COWETA,5/26/2020,229,192,0,421
COWETA,5/27/2020,249,199,0,448
COWETA,5/28/2020,252,201,0,453
COWETA,5/29/2020,258,202,0,460
COWETA,5/30/2020,259,203,0,462
COWETA,5/31/2020,263,204,0,467
COWETA,6/1/2020,270,210,0,480
COWETA,6/2/2020,274,210,0,484
COWETA,6/3/2020,275,211,0,486
COWETA,6/4/2020,282,215,0,497
COWETA,6/5/2020,283,219,0,502
COWETA,6/6/2020,285,221,0,506
COWETA,6/7/2020,289,223,0,512
COWETA,6/8/2020,298,230,0,528
COWETA,6/9/2020,304,232,0,536
COWETA,6/10/2020,327,241,0,568
COWETA,6/11/2020,331,243,1,575
COWETA,6/12/2020,335,245,1,581
COWETA,6/13/2020,337,248,1,586
COWETA,6/14/2020,341,248,1,590
COWETA,6/15/2020,352,255,1,608
COWETA,6/16/2020,363,265,2,630
COWETA,6/17/2020,375,268,2,645
COWETA,6/18/2020,386,274,2,662
COWETA,6/19/2020,397,286,2,685
COWETA,6/20/2020,398,289,2,689
COWETA,6/21/2020,401,293,2,696
COWETA,6/22/2020,424,304,2,730
COWETA,6/23/2020,442,309,2,753
COWETA,6/24/2020,452,322,3,777
COWETA,6/25/2020,460,329,3,792
COWETA,6/26/2020,473,336,4,813
COWETA,6/27/2020,476,338,4,818
COWETA,6/28/2020,482,341,4,827
COWETA,6/29/2020,493,355,4,852
COWETA,6/30/2020,502,371,4,877
COWETA,7/1/2020,522,384,4,910
COWETA,7/2/2020,537,392,4,933
COWETA,7/3/2020,547,407,5,959
COWETA,7/4/2020,560,412,5,977
COWETA,7/5/2020,565,420,5,990
COWETA,7/6/2020,592,446,5,1043
COWETA,7/7/2020,609,465,6,1080
COWETA,7/8/2020,632,483,6,1121
COWETA,7/9/2020,652,509,7,1168
COWETA,7/10/2020,671,528,7,1206
COWETA,7/11/2020,676,532,7,1215
COWETA,7/12/2020,680,541,7,1228
COWETA,7/13/2020,702,563,7,1272
COWETA,7/14/2020,724,581,7,1312
COWETA,7/15/2020,736,607,7,1350
COWETA,7/16/2020,752,630,7,1389
COWETA,7/17/2020,770,648,7,1425
COWETA,7/18/2020,775,652,7,1434
COWETA,7/19/2020,778,655,7,1440
COWETA,7/20/2020,798,666,7,1471
COWETA,7/21/2020,812,684,7,1503
COWETA,7/22/2020,830,699,7,1536
COWETA,7/23/2020,846,712,7,1565
COWETA,7/24/2020,857,724,9,1590
COWETA,7/25/2020,862,731,9,1602
COWETA,7/26/2020,867,734,9,1610
COWETA,7/27/2020,891,750,9,1650
COWETA,7/28/2020,899,761,9,1669
COWETA,7/29/2020,908,772,9,1689
COWETA,7/30/2020,924,790,9,1723
COWETA,7/31/2020,942,808,9,1759
COWETA,8/1/2020,948,810,9,1767
COWETA,8/2/2020,956,815,9,1780
COWETA,8/3/2020,976,841,9,1826
COWETA,8/4/2020,992,860,9,1861
COWETA,8/5/2020,1014,876,9,1899
COWETA,8/6/2020,1032,897,9,1938
COWETA,8/7/2020,1059,909,9,1977
COWETA,8/8/2020,1074,924,10,2008
COWETA,8/9/2020,1076,931,10,2017
COWETA,8/10/2020,1105,952,10,2067
COWETA,8/11/2020,1127,970,10,2107
COWETA,8/12/2020,1145,989,10,2144
COWETA,8/13/2020,1154,1005,10,2169
COWETA,8/14/2020,1174,1016,10,2200
COWETA,8/15/2020,1189,1029,10,2228
COWETA,8/16/2020,1193,1034,10,2237
COWETA,8/17/2020,1209,1049,10,2268
COWETA,8/18/2020,1224,1059,10,2293
COWETA,8/19/2020,1235,1078,10,2323
COWETA,8/20/2020,1243,1082,10,2335
COWETA,8/21/2020,1252,1097,10,2359
COWETA,8/22/2020,1260,1106,10,2376
COWETA,8/23/2020,1266,1112,10,2388
COWETA,8/24/2020,1287,1120,10,2417
COWETA,8/25/2020,1294,1130,10,2434
COWETA,8/26/2020,1300,1137,10,2447
COWETA,8/27/2020,1308,1144,10,2462
COWETA,8/28/2020,1318,1152,10,2480
COWETA,8/29/2020,1322,1156,10,2488
COWETA,8/30/2020,1324,1164,10,2498
COWETA,8/31/2020,1332,1169,10,2511
COWETA,9/1/2020,1338,1177,10,2525
COWETA,9/2/2020,1347,1183,11,2541
COWETA,9/3/2020,1349,1186,11,2546
COWETA,9/4/2020,1352,1190,11,2553
COWETA,9/5/2020,1353,1193,11,2557
COWETA,9/6/2020,1355,1193,11,2559
COWETA,9/7/2020,1360,1197,11,2568
COWETA,9/8/2020,1368,1202,11,2581
COWETA,9/9/2020,1377,1207,12,2596
COWETA,9/10/2020,1384,1210,12,2606
COWETA,9/11/2020,1393,1214,12,2619
COWETA,9/12/2020,1399,1216,12,2627
COWETA,9/13/2020,1402,1224,12,2638
COWETA,9/14/2020,1408,1229,12,2649
COWETA,9/15/2020,1413,1233,12,2658
COWETA,9/16/2020,1419,1234,12,2665
COWETA,9/17/2020,1420,1236,12,2668
COWETA,9/18/2020,1423,1239,12,2674
COWETA,9/19/2020,1430,1240,12,2682
COWETA,9/20/2020,1434,1242,12,2688
COWETA,9/21/2020,1439,1246,12,2697
COWETA,9/22/2020,1441,1249,12,2702
COWETA,9/23/2020,1446,1252,12,2710
COWETA,9/24/2020,1453,1253,12,2718
COWETA,9/25/2020,1456,1253,12,2721
COWETA,9/26/2020,1458,1255,12,2725
COWETA,9/27/2020,1461,1259,12,2732
COWETA,9/28/2020,1463,1261,12,2736
COWETA,9/29/2020,1468,1263,12,2743
COWETA,9/30/2020,1473,1265,12,2750
COWETA,10/1/2020,1479,1268,12,2759
COWETA,10/2/2020,1482,1270,12,2764
COWETA,10/3/2020,1484,1274,12,2770
COWETA,10/4/2020,1489,1277,12,2778
COWETA,10/5/2020,1497,1280,12,2789
COWETA,10/6/2020,1507,1285,12,2804
COWETA,10/7/2020,1511,1289,12,2812
COWETA,10/8/2020,1515,1297,12,2824
COWETA,10/9/2020,1518,1300,13,2831
COWETA,10/10/2020,1519,1302,13,2834
COWETA,10/11/2020,1524,1304,13,2841
COWETA,10/12/2020,1528,1306,13,2847
COWETA,10/13/2020,1536,1309,13,2858
COWETA,10/14/2020,1539,1311,13,2863
COWETA,10/15/2020,1540,1311,13,2864
COWETA,10/16/2020,1542,1311,13,2866
COWETA,10/17/2020,1542,1313,13,2868
COWETA,10/18/2020,1543,1313,13,2869
COWETA,10/19/2020,1543,1313,13,2869
COWETA,10/20/2020,1543,1313,13,2869
CRISP,1/1/2020,0,0,0,0
CRISP,1/2/2020,0,0,0,0
CRISP,1/3/2020,0,0,0,0
CRISP,1/4/2020,0,0,0,0
CRISP,1/5/2020,0,0,0,0
CRISP,1/6/2020,0,0,0,0
CRISP,1/7/2020,0,0,0,0
CRISP,1/8/2020,0,0,0,0
CRISP,1/9/2020,0,0,0,0
CRISP,1/10/2020,0,0,0,0
CRISP,1/11/2020,0,0,0,0
CRISP,1/12/2020,0,0,0,0
CRISP,1/13/2020,0,0,0,0
CRISP,1/14/2020,0,0,0,0
CRISP,1/15/2020,0,0,0,0
CRISP,1/16/2020,0,0,0,0
CRISP,1/17/2020,0,0,0,0
CRISP,1/18/2020,0,0,0,0
CRISP,1/19/2020,0,0,0,0
CRISP,1/20/2020,0,0,0,0
CRISP,1/21/2020,0,0,0,0
CRISP,1/22/2020,0,0,0,0
CRISP,1/23/2020,0,0,0,0
CRISP,1/24/2020,0,0,0,0
CRISP,1/25/2020,0,0,0,0
CRISP,1/26/2020,0,0,0,0
CRISP,1/27/2020,0,0,0,0
CRISP,1/28/2020,0,0,0,0
CRISP,1/29/2020,0,0,0,0
CRISP,1/30/2020,0,0,0,0
CRISP,1/31/2020,0,0,0,0
CRISP,2/1/2020,0,0,0,0
CRISP,2/2/2020,0,0,0,0
CRISP,2/3/2020,0,0,0,0
CRISP,2/4/2020,0,0,0,0
CRISP,2/5/2020,0,0,0,0
CRISP,2/6/2020,0,0,0,0
CRISP,2/7/2020,0,0,0,0
CRISP,2/8/2020,0,0,0,0
CRISP,2/9/2020,0,0,0,0
CRISP,2/10/2020,0,0,0,0
CRISP,2/11/2020,0,0,0,0
CRISP,2/12/2020,0,0,0,0
CRISP,2/13/2020,0,0,0,0
CRISP,2/14/2020,0,0,0,0
CRISP,2/15/2020,0,0,0,0
CRISP,2/16/2020,0,0,0,0
CRISP,2/17/2020,0,0,0,0
CRISP,2/18/2020,0,0,0,0
CRISP,2/19/2020,0,0,0,0
CRISP,2/20/2020,0,0,0,0
CRISP,2/21/2020,0,0,0,0
CRISP,2/22/2020,0,0,0,0
CRISP,2/23/2020,0,0,0,0
CRISP,2/24/2020,0,0,0,0
CRISP,2/25/2020,0,0,0,0
CRISP,2/26/2020,0,0,0,0
CRISP,2/27/2020,0,0,0,0
CRISP,2/28/2020,0,0,0,0
CRISP,2/29/2020,0,0,0,0
CRISP,3/1/2020,0,0,0,0
CRISP,3/2/2020,0,0,0,0
CRISP,3/3/2020,0,0,0,0
CRISP,3/4/2020,0,0,0,0
CRISP,3/5/2020,0,0,0,0
CRISP,3/6/2020,0,0,0,0
CRISP,3/7/2020,0,0,0,0
CRISP,3/8/2020,0,0,0,0
CRISP,3/9/2020,0,0,0,0
CRISP,3/10/2020,0,0,0,0
CRISP,3/11/2020,0,1,0,1
CRISP,3/12/2020,0,1,0,1
CRISP,3/13/2020,0,1,0,1
CRISP,3/14/2020,0,3,0,3
CRISP,3/15/2020,0,4,0,4
CRISP,3/16/2020,2,5,0,7
COBB,6/10/2020,2155,1757,7,3919
COBB,6/11/2020,2193,1791,7,3991
COBB,6/12/2020,2226,1825,7,4058
COBB,6/13/2020,2253,1857,7,4117
COBB,6/14/2020,2284,1885,7,4176
COBB,6/15/2020,2343,1930,8,4281
COBB,6/16/2020,2401,1997,8,4406
COBB,6/17/2020,2454,2046,8,4508
COBB,6/18/2020,2503,2097,8,4608
COBB,6/19/2020,2564,2159,8,4731
COBB,6/20/2020,2637,2214,8,4859
COBB,6/21/2020,2703,2259,9,4971
COBB,6/22/2020,2817,2351,9,5177
COBB,6/23/2020,2926,2427,10,5363
COBB,6/24/2020,3026,2526,11,5563
COBB,6/25/2020,3133,2621,12,5766
COBB,6/26/2020,3245,2743,14,6002
COBB,6/27/2020,3357,2836,19,6212
COBB,6/28/2020,3472,2928,22,6422
COBB,6/29/2020,3613,3061,27,6701
COBB,6/30/2020,3758,3181,32,6971
COBB,7/1/2020,3905,3321,41,7267
COBB,7/2/2020,4045,3465,45,7555
COBB,7/3/2020,4148,3556,47,7751
COBB,7/4/2020,4235,3630,51,7916
COBB,7/5/2020,4342,3712,52,8106
COBB,7/6/2020,4540,3882,60,8482
COBB,7/7/2020,4752,4046,70,8868
COBB,7/8/2020,4951,4188,76,9215
COBB,7/9/2020,5111,4322,81,9514
COBB,7/10/2020,5281,4444,89,9814
COBB,7/11/2020,5386,4553,92,10031
COBB,7/12/2020,5480,4621,94,10195
COBB,7/13/2020,5632,4765,98,10495
COBB,7/14/2020,5826,4919,116,10861
COBB,7/15/2020,5993,5064,132,11189
COBB,7/16/2020,6124,5195,151,11470
COBB,7/17/2020,6262,5304,173,11739
COBB,7/18/2020,6369,5382,179,11930
COBB,7/19/2020,6454,5438,186,12078
COBB,7/20/2020,6610,5568,196,12374
COBB,7/21/2020,6717,5674,203,12594
COBB,7/22/2020,6822,5774,209,12805
COBB,7/23/2020,6935,5873,210,13018
COBB,7/24/2020,7024,5974,211,13209
COBB,7/25/2020,7094,6042,212,13348
COBB,7/26/2020,7164,6115,212,13491
COBB,7/27/2020,7283,6204,213,13700
COBB,7/28/2020,7392,6296,215,13903
COBB,7/29/2020,7512,6397,218,14127
COBB,7/30/2020,7625,6482,219,14326
COBB,7/31/2020,7720,6569,219,14508
COBB,8/1/2020,7800,6642,221,14663
COBB,8/2/2020,7871,6692,222,14785
COBB,8/3/2020,7966,6776,224,14966
COBB,8/4/2020,8072,6878,225,15175
COBB,8/5/2020,8168,6963,228,15359
COBB,8/6/2020,8257,7024,228,15509
COBB,8/7/2020,8319,7077,229,15625
COBB,8/8/2020,8386,7131,229,15746
COBB,8/9/2020,8441,7171,230,15842
COBB,8/10/2020,8511,7238,230,15979
COBB,8/11/2020,8576,7312,230,16118
COBB,8/12/2020,8633,7381,232,16246
COBB,8/13/2020,8691,7425,232,16348
COBB,8/14/2020,8739,7470,232,16441
COBB,8/15/2020,8782,7520,232,16534
COBB,8/16/2020,8826,7559,232,16617
COBB,8/17/2020,8915,7606,233,16754
COBB,8/18/2020,8983,7655,235,16873
COBB,8/19/2020,9038,7708,237,16983
COBB,8/20/2020,9097,7767,238,17102
COBB,8/21/2020,9168,7809,240,17217
COBB,8/22/2020,9214,7844,240,17298
COBB,8/23/2020,9265,7895,240,17400
COBB,8/24/2020,9341,7946,240,17527
COBB,8/25/2020,9401,8005,242,17648
COBB,8/26/2020,9451,8057,243,17751
COBB,8/27/2020,9502,8106,243,17851
COBB,8/28/2020,9557,8155,244,17956
COBB,8/29/2020,9598,8191,244,18033
COBB,8/30/2020,9650,8232,244,18126
COBB,8/31/2020,9728,8302,245,18275
COBB,9/1/2020,9793,8362,245,18400
COBB,9/2/2020,9851,8425,246,18522
COBB,9/3/2020,9906,8463,246,18615
COBB,9/4/2020,9948,8501,246,18695
COBB,9/5/2020,9985,8526,247,18758
COBB,9/6/2020,10017,8561,247,18825
COBB,9/7/2020,10055,8600,247,18902
COBB,9/8/2020,10111,8649,247,19007
COBB,9/9/2020,10156,8695,247,19098
COBB,9/10/2020,10187,8740,247,19174
COBB,9/11/2020,10241,8779,247,19267
COBB,9/12/2020,10274,8807,247,19328
COBB,9/13/2020,10295,8820,247,19362
COBB,9/14/2020,10331,8860,248,19439
COBB,9/15/2020,10362,8899,248,19509
COBB,9/16/2020,10401,8937,248,19586
COBB,9/17/2020,10429,8968,249,19646
COBB,9/18/2020,10458,8994,250,19702
COBB,9/19/2020,10486,9018,251,19755
COBB,9/20/2020,10514,9037,251,19802
COBB,9/21/2020,10544,9080,252,19876
COBB,9/22/2020,10578,9116,253,19947
COBB,9/23/2020,10613,9144,253,20010
COBB,9/24/2020,10644,9170,253,20067
COBB,9/25/2020,10675,9199,253,20127
COBB,9/26/2020,10702,9220,253,20175
COBB,9/27/2020,10716,9240,253,20209
COBB,9/28/2020,10740,9265,253,20258
COBB,9/29/2020,10763,9293,253,20309
COBB,9/30/2020,10800,9334,253,20387
COBB,10/1/2020,10835,9363,253,20451
COBB,10/2/2020,10861,9397,254,20512
COBB,10/3/2020,10883,9426,254,20563
COBB,10/4/2020,10903,9447,254,20604
COBB,10/5/2020,10944,9493,255,20692
COBB,10/6/2020,10978,9533,256,20767
COBB,10/7/2020,11009,9569,257,20835
COBB,10/8/2020,11039,9596,257,20892
COBB,10/9/2020,11067,9622,258,20947
COBB,10/10/2020,11091,9647,258,20996
COBB,10/11/2020,11108,9665,258,21031
COBB,10/12/2020,11136,9709,258,21103
COBB,10/13/2020,11156,9730,258,21144
COBB,10/14/2020,11174,9743,258,21175
COBB,10/15/2020,11185,9759,258,21202
COBB,10/16/2020,11198,9770,258,21226
COBB,10/17/2020,11209,9781,258,21248
COBB,10/18/2020,11213,9782,258,21253
COBB,10/19/2020,11214,9783,258,21255
COBB,10/20/2020,11214,9783,258,21255
COLQUITT,1/1/2020,0,0,0,0
COLQUITT,1/2/2020,0,0,0,0
COLQUITT,1/3/2020,0,0,0,0
COLQUITT,1/4/2020,0,0,0,0
COLQUITT,1/5/2020,0,0,0,0
COLQUITT,1/6/2020,0,0,0,0
COLQUITT,1/7/2020,0,0,0,0
COLQUITT,1/8/2020,0,0,0,0
COLQUITT,1/9/2020,0,0,0,0
COLQUITT,1/10/2020,0,0,0,0
COLQUITT,1/11/2020,0,0,0,0
COLQUITT,1/12/2020,0,0,0,0
COLQUITT,1/13/2020,0,0,0,0
COLQUITT,1/14/2020,0,0,0,0
COLQUITT,1/15/2020,0,0,0,0
COLQUITT,1/16/2020,0,0,0,0
COLQUITT,1/17/2020,0,0,0,0
COLQUITT,1/18/2020,0,0,0,0
COLQUITT,1/19/2020,0,0,0,0
COLQUITT,1/20/2020,0,0,0,0
COLQUITT,1/21/2020,0,0,0,0
COLQUITT,1/22/2020,0,0,0,0
COLQUITT,1/23/2020,0,0,0,0
COLQUITT,1/24/2020,0,0,0,0
COLQUITT,1/25/2020,0,0,0,0
COLQUITT,1/26/2020,0,0,0,0
COLQUITT,1/27/2020,0,0,0,0
COLQUITT,1/28/2020,0,0,0,0
COLQUITT,1/29/2020,0,0,0,0
COLQUITT,1/30/2020,0,0,0,0
COLQUITT,1/31/2020,0,0,0,0
COLQUITT,2/1/2020,0,0,0,0
COLQUITT,2/2/2020,0,0,0,0
COLQUITT,2/3/2020,0,0,0,0
COLQUITT,2/4/2020,0,0,0,0
COLQUITT,2/5/2020,0,0,0,0
COLQUITT,2/6/2020,0,0,0,0
COLQUITT,2/7/2020,0,0,0,0
COLQUITT,2/8/2020,0,0,0,0
COLQUITT,2/9/2020,0,0,0,0
COLQUITT,2/10/2020,0,0,0,0
COLQUITT,2/11/2020,0,0,0,0
COLQUITT,2/12/2020,0,0,0,0
COLQUITT,2/13/2020,0,0,0,0
COLQUITT,2/14/2020,0,0,0,0
COLQUITT,2/15/2020,0,0,0,0
COLQUITT,2/16/2020,0,0,0,0
COLQUITT,2/17/2020,0,0,0,0
COLQUITT,2/18/2020,0,0,0,0
COLQUITT,2/19/2020,0,0,0,0
COLQUITT,2/20/2020,0,0,0,0
COLQUITT,2/21/2020,0,0,0,0
COLQUITT,2/22/2020,0,0,0,0
COLQUITT,2/23/2020,0,0,0,0
COLQUITT,2/24/2020,0,0,0,0
COLQUITT,2/25/2020,0,0,0,0
COLQUITT,2/26/2020,0,0,0,0
COLQUITT,2/27/2020,0,0,0,0
COLQUITT,2/28/2020,0,0,0,0
COLQUITT,2/29/2020,0,0,0,0
COLQUITT,3/1/2020,0,0,0,0
COLQUITT,3/2/2020,0,0,0,0
COLQUITT,3/3/2020,0,0,0,0
COLQUITT,3/4/2020,0,0,0,0
COLQUITT,3/5/2020,0,0,0,0
COLQUITT,3/6/2020,0,0,0,0
COLQUITT,3/7/2020,0,0,0,0
COLQUITT,3/8/2020,0,0,0,0
COLQUITT,3/9/2020,1,0,0,1
COLQUITT,3/10/2020,1,0,0,1
COLQUITT,3/11/2020,1,0,0,1
COLQUITT,3/12/2020,1,0,0,1
COLQUITT,3/13/2020,1,0,0,1
COLQUITT,3/14/2020,1,0,0,1
COLQUITT,3/15/2020,3,1,0,4
COLQUITT,3/16/2020,5,2,0,7
COLQUITT,3/17/2020,5,4,0,9
COLQUITT,3/18/2020,6,5,0,11
COLQUITT,3/19/2020,8,6,0,14
COLQUITT,3/20/2020,9,8,0,17
COLQUITT,3/21/2020,10,9,0,19
COLQUITT,3/22/2020,12,12,0,24
COLQUITT,3/23/2020,15,14,0,29
COLQUITT,3/24/2020,18,14,0,32
COLQUITT,3/25/2020,20,15,0,35
COLQUITT,3/26/2020,20,16,0,36
COLQUITT,3/27/2020,23,17,0,40
COLQUITT,3/28/2020,26,20,0,46
COLQUITT,3/29/2020,26,22,0,48
COLQUITT,3/30/2020,27,28,0,55
COLQUITT,3/31/2020,34,30,0,64
COLQUITT,4/1/2020,41,36,0,77
COLQUITT,4/2/2020,45,42,0,87
COLQUITT,4/3/2020,49,42,0,91
COLQUITT,4/4/2020,55,43,0,98
COLQUITT,4/5/2020,58,43,1,102
COLQUITT,4/6/2020,60,45,1,106
COLQUITT,4/7/2020,60,47,1,108
COLQUITT,4/8/2020,60,47,1,108
COLQUITT,4/9/2020,60,47,1,108
COLQUITT,4/10/2020,60,48,1,109
COLQUITT,4/11/2020,69,54,1,124
COLQUITT,4/12/2020,70,57,1,128
COLQUITT,4/13/2020,72,62,1,135
COLQUITT,4/14/2020,79,72,1,152
COLQUITT,4/15/2020,79,75,1,155
COLQUITT,4/16/2020,83,79,1,163
COLQUITT,4/17/2020,85,82,1,168
COLQUITT,4/18/2020,88,82,1,171
COLQUITT,4/19/2020,88,82,1,171
COLQUITT,4/20/2020,91,83,1,175
COLQUITT,4/21/2020,95,86,1,182
COLQUITT,4/22/2020,96,89,1,186
COLQUITT,4/23/2020,98,90,1,189
COLQUITT,4/24/2020,101,92,1,194
COLQUITT,4/25/2020,101,93,1,195
COLQUITT,4/26/2020,102,94,1,197
COLQUITT,4/27/2020,105,97,1,203
COLQUITT,4/28/2020,105,99,1,205
COLQUITT,4/29/2020,107,103,1,211
COLQUITT,4/30/2020,110,103,1,214
COLQUITT,5/1/2020,113,108,1,222
COLQUITT,5/2/2020,113,108,1,222
COLQUITT,5/3/2020,115,108,1,224
COLQUITT,5/4/2020,116,111,1,228
COLQUITT,5/5/2020,117,112,1,230
COLQUITT,5/6/2020,118,116,1,235
COLQUITT,5/7/2020,120,117,1,238
COLQUITT,5/8/2020,125,122,1,248
COLQUITT,5/9/2020,128,127,1,256
COLQUITT,5/10/2020,135,133,1,269
COLQUITT,5/11/2020,144,138,1,283
COLQUITT,5/12/2020,153,147,1,301
COLQUITT,5/13/2020,155,158,1,314
COLQUITT,5/14/2020,156,159,1,316
COLQUITT,5/15/2020,164,171,1,336
COLQUITT,5/16/2020,168,174,1,343
COLQUITT,5/17/2020,173,186,1,360
COLQUITT,5/18/2020,184,202,1,387
COLQUITT,5/19/2020,194,219,1,414
COLQUITT,5/20/2020,198,228,1,427
COLQUITT,5/21/2020,203,263,1,467
COLQUITT,5/22/2020,209,265,1,475
COLQUITT,5/23/2020,215,270,1,486
COLQUITT,5/24/2020,219,275,1,495
COLQUITT,5/25/2020,223,278,1,502
COLQUITT,5/26/2020,226,282,1,509
COLQUITT,5/27/2020,232,287,1,520
COLQUITT,5/28/2020,236,293,1,530
COLQUITT,5/29/2020,239,295,1,535
COLQUITT,5/30/2020,245,301,1,547
COLQUITT,5/31/2020,249,304,1,554
COLQUITT,6/1/2020,255,313,1,569
COLQUITT,6/2/2020,262,318,1,581
COLQUITT,6/3/2020,266,325,1,592
COLQUITT,6/4/2020,270,337,1,608
COLQUITT,6/5/2020,273,347,1,621
COLQUITT,6/6/2020,277,352,1,630
COLQUITT,6/7/2020,283,356,1,640
COLQUITT,6/8/2020,289,367,1,657
COLQUITT,6/9/2020,296,374,1,671
COLQUITT,6/10/2020,303,382,1,686
COLQUITT,6/11/2020,313,391,1,705
COLQUITT,6/12/2020,320,404,1,725
COLQUITT,6/13/2020,325,412,1,738
COLQUITT,6/14/2020,332,429,1,762
COLQUITT,6/15/2020,340,446,1,787
COLQUITT,6/16/2020,349,457,1,807
COLQUITT,6/17/2020,359,468,1,828
COLQUITT,6/18/2020,362,483,1,846
COLQUITT,6/19/2020,373,495,1,869
COLQUITT,6/20/2020,379,503,1,883
COLQUITT,6/21/2020,388,506,2,896
COLQUITT,6/22/2020,402,523,2,927
COLQUITT,6/23/2020,418,536,3,957
COLQUITT,6/24/2020,428,546,3,977
COLQUITT,6/25/2020,439,561,3,1003
COLQUITT,6/26/2020,451,571,3,1025
COLQUITT,6/27/2020,459,584,3,1046
COLQUITT,6/28/2020,479,589,3,1071
COLQUITT,6/29/2020,495,605,3,1103
COLQUITT,6/30/2020,519,626,4,1149
COLQUITT,7/1/2020,526,634,4,1164
COLQUITT,7/2/2020,536,642,4,1182
COLQUITT,7/3/2020,552,648,4,1204
COLQUITT,7/4/2020,558,651,4,1213
COLQUITT,7/5/2020,568,659,4,1231
COLQUITT,7/6/2020,579,666,4,1249
COLQUITT,7/7/2020,591,672,4,1267
COLQUITT,7/8/2020,598,679,4,1281
COLQUITT,7/9/2020,604,686,4,1294
COLQUITT,7/10/2020,611,690,4,1305
COLQUITT,7/11/2020,615,694,4,1313
COLQUITT,7/12/2020,617,697,4,1318
COLQUITT,7/13/2020,624,706,4,1334
COLQUITT,7/14/2020,630,714,4,1348
COLQUITT,7/15/2020,632,715,4,1351
COLQUITT,7/16/2020,635,726,4,1365
COLQUITT,7/17/2020,638,731,4,1373
COLQUITT,7/18/2020,642,731,4,1377
COLQUITT,7/19/2020,646,734,4,1384
COLQUITT,7/20/2020,651,737,4,1392
COLQUITT,7/21/2020,660,741,4,1405
COLQUITT,7/22/2020,667,745,4,1416
COLQUITT,7/23/2020,674,752,4,1430
COLQUITT,7/24/2020,680,752,4,1436
COLQUITT,7/25/2020,681,755,4,1440
COLQUITT,7/26/2020,683,757,4,1444
COLQUITT,7/27/2020,687,762,4,1453
COLQUITT,7/28/2020,692,766,4,1462
COLQUITT,7/29/2020,701,770,4,1475
COLQUITT,7/30/2020,708,775,4,1487
COLQUITT,7/31/2020,714,778,4,1496
COLQUITT,8/1/2020,720,781,4,1505
COLQUITT,8/2/2020,721,782,4,1507
COLQUITT,8/3/2020,726,786,4,1516
COLQUITT,8/4/2020,728,790,4,1522
COLQUITT,8/5/2020,737,796,4,1537
COLQUITT,8/6/2020,741,798,4,1543
COLQUITT,8/7/2020,749,803,4,1556
COLQUITT,8/8/2020,756,805,4,1565
COLQUITT,8/9/2020,756,806,4,1566
COLQUITT,8/10/2020,758,809,4,1571
COLQUITT,8/11/2020,764,811,4,1579
COLQUITT,8/12/2020,769,813,4,1586
COLQUITT,8/13/2020,770,815,4,1589
COLQUITT,8/14/2020,773,817,4,1594
COLQUITT,8/15/2020,779,819,4,1602
COLQUITT,8/16/2020,785,819,4,1608
COLQUITT,8/17/2020,794,823,4,1621
COLQUITT,8/18/2020,798,825,4,1627
COLQUITT,8/19/2020,804,828,4,1636
COLQUITT,8/20/2020,811,830,4,1645
COLQUITT,8/21/2020,818,835,4,1657
COLQUITT,8/22/2020,822,840,4,1666
COLQUITT,8/23/2020,822,841,5,1668
COLQUITT,8/24/2020,827,849,5,1681
COLQUITT,8/25/2020,839,853,5,1697
COLQUITT,8/26/2020,846,854,5,1705
COLQUITT,8/27/2020,848,857,5,1710
COLQUITT,8/28/2020,853,863,5,1721
COLQUITT,8/29/2020,855,868,5,1728
COLQUITT,8/30/2020,858,874,5,1737
COLQUITT,8/31/2020,863,876,5,1744
COLQUITT,9/1/2020,870,881,5,1756
COLQUITT,9/2/2020,874,890,5,1769
COLQUITT,9/3/2020,874,892,5,1771
COLQUITT,9/4/2020,879,896,5,1780
COLQUITT,9/5/2020,882,896,5,1783
COLQUITT,9/6/2020,886,896,5,1787
COLQUITT,9/7/2020,887,898,5,1790
COLQUITT,9/8/2020,899,900,5,1804
COLQUITT,9/9/2020,905,909,5,1819
COLQUITT,9/10/2020,914,912,5,1831
COLQUITT,9/11/2020,917,916,5,1838
COLQUITT,9/12/2020,919,917,5,1841
COLQUITT,9/13/2020,920,920,5,1845
COLQUITT,9/14/2020,925,921,5,1851
COLQUITT,9/15/2020,927,923,7,1857
COLQUITT,9/16/2020,932,925,7,1864
COLQUITT,9/17/2020,932,925,7,1864
COLQUITT,9/18/2020,935,928,7,1870
COLQUITT,9/19/2020,937,931,7,1875
COLQUITT,9/20/2020,939,932,7,1878
CHATTOOGA,8/28/2020,318,285,14,617
CHATTOOGA,8/29/2020,319,286,14,619
CHATTOOGA,8/30/2020,331,295,14,640
CHATTOOGA,8/31/2020,333,298,14,645
CHATTOOGA,9/1/2020,337,306,14,657
CHATTOOGA,9/2/2020,342,311,14,667
CHATTOOGA,9/3/2020,348,315,14,677
CHATTOOGA,9/4/2020,352,317,14,683
CHATTOOGA,9/5/2020,354,317,14,685
CHATTOOGA,9/6/2020,357,318,14,689
CHATTOOGA,9/7/2020,361,322,14,697
CHATTOOGA,9/8/2020,363,325,14,702
CHATTOOGA,9/9/2020,368,329,14,711
CHATTOOGA,9/10/2020,370,329,15,714
CHATTOOGA,9/11/2020,375,330,15,720
CHATTOOGA,9/12/2020,375,331,15,721
CHATTOOGA,9/13/2020,375,335,15,725
CHATTOOGA,9/14/2020,377,336,15,728
CHATTOOGA,9/15/2020,383,340,15,738
CHATTOOGA,9/16/2020,388,341,15,744
CHATTOOGA,9/17/2020,390,343,15,748
CHATTOOGA,9/18/2020,395,348,15,758
CHATTOOGA,9/19/2020,396,349,15,760
CHATTOOGA,9/20/2020,400,351,15,766
CHATTOOGA,9/21/2020,401,352,15,768
CHATTOOGA,9/22/2020,407,357,15,779
CHATTOOGA,9/23/2020,413,359,15,787
CHATTOOGA,9/24/2020,416,359,15,790
CHATTOOGA,9/25/2020,420,361,15,796
CHATTOOGA,9/26/2020,425,363,15,803
CHATTOOGA,9/27/2020,428,365,15,808
CHATTOOGA,9/28/2020,431,367,15,813
CHATTOOGA,9/29/2020,432,370,15,817
CHATTOOGA,9/30/2020,435,372,15,822
CHATTOOGA,10/1/2020,438,373,15,826
CHATTOOGA,10/2/2020,441,374,15,830
CHATTOOGA,10/3/2020,443,376,15,834
CHATTOOGA,10/4/2020,444,376,15,835
CHATTOOGA,10/5/2020,446,379,15,840
CHATTOOGA,10/6/2020,449,382,15,846
CHATTOOGA,10/7/2020,451,383,15,849
CHATTOOGA,10/8/2020,454,385,15,854
CHATTOOGA,10/9/2020,461,387,15,863
CHATTOOGA,10/10/2020,461,389,15,865
CHATTOOGA,10/11/2020,461,389,16,866
CHATTOOGA,10/12/2020,461,391,16,868
CHATTOOGA,10/13/2020,465,395,16,876
CHATTOOGA,10/14/2020,465,395,16,876
CHATTOOGA,10/15/2020,466,395,16,877
CHATTOOGA,10/16/2020,467,395,16,878
CHATTOOGA,10/17/2020,470,395,16,881
CHATTOOGA,10/18/2020,470,395,16,881
CHATTOOGA,10/19/2020,470,395,16,881
CHATTOOGA,10/20/2020,470,395,16,881
CLAYTON,1/1/2020,0,0,0,0
CLAYTON,1/2/2020,0,0,0,0
CLAYTON,1/3/2020,0,0,0,0
CLAYTON,1/4/2020,0,0,0,0
CLAYTON,1/5/2020,0,0,0,0
CLAYTON,1/6/2020,0,0,0,0
CLAYTON,1/7/2020,0,0,0,0
CLAYTON,1/8/2020,0,0,0,0
CLAYTON,1/9/2020,0,0,0,0
CLAYTON,1/10/2020,0,0,0,0
CLAYTON,1/11/2020,0,0,0,0
CLAYTON,1/12/2020,0,0,0,0
CLAYTON,1/13/2020,0,0,0,0
CLAYTON,1/14/2020,0,0,0,0
CLAYTON,1/15/2020,0,0,0,0
CLAYTON,1/16/2020,0,0,0,0
CLAYTON,1/17/2020,0,0,0,0
CLAYTON,1/18/2020,0,0,0,0
CLAYTON,1/19/2020,0,0,0,0
CLAYTON,1/20/2020,0,0,0,0
CLAYTON,1/21/2020,0,0,0,0
CLAYTON,1/22/2020,0,0,0,0
CLAYTON,1/23/2020,0,0,0,0
CLAYTON,1/24/2020,0,0,0,0
CLAYTON,1/25/2020,0,0,0,0
CLAYTON,1/26/2020,0,0,0,0
CLAYTON,1/27/2020,0,0,0,0
CLAYTON,1/28/2020,0,1,0,1
CLAYTON,1/29/2020,0,1,0,1
CLAYTON,1/30/2020,0,1,0,1
CLAYTON,1/31/2020,0,1,0,1
CLAYTON,2/1/2020,0,1,0,1
CLAYTON,2/2/2020,1,1,0,2
CLAYTON,2/3/2020,1,1,0,2
CLAYTON,2/4/2020,1,1,0,2
CLAYTON,2/5/2020,1,1,0,2
CLAYTON,2/6/2020,1,1,0,2
CLAYTON,2/7/2020,1,1,0,2
CLAYTON,2/8/2020,2,1,0,3
CLAYTON,2/9/2020,2,1,0,3
CLAYTON,2/10/2020,2,1,0,3
CLAYTON,2/11/2020,2,1,0,3
CLAYTON,2/12/2020,2,1,0,3
CLAYTON,2/13/2020,2,1,0,3
CLAYTON,2/14/2020,2,1,0,3
CLAYTON,2/15/2020,2,1,0,3
CLAYTON,2/16/2020,2,1,0,3
CLAYTON,2/17/2020,2,1,0,3
CLAYTON,2/18/2020,2,1,0,3
CLAYTON,2/19/2020,2,1,0,3
CLAYTON,2/20/2020,2,1,0,3
CLAYTON,2/21/2020,2,1,0,3
CLAYTON,2/22/2020,2,1,0,3
CLAYTON,2/23/2020,2,1,0,3
CLAYTON,2/24/2020,2,1,0,3
CLAYTON,2/25/2020,2,1,0,3
CLAYTON,2/26/2020,2,1,0,3
CLAYTON,2/27/2020,2,1,0,3
CLAYTON,2/28/2020,2,1,0,3
CLAYTON,2/29/2020,2,1,0,3
CLAYTON,3/1/2020,7,2,0,9
CLAYTON,3/2/2020,8,2,0,10
CLAYTON,3/3/2020,9,3,0,12
CLAYTON,3/4/2020,10,4,0,14
CLAYTON,3/5/2020,10,5,0,15
CLAYTON,3/6/2020,12,6,0,18
CLAYTON,3/7/2020,13,6,0,19
CLAYTON,3/8/2020,13,8,0,21
CLAYTON,3/9/2020,14,10,0,24
CLAYTON,3/10/2020,16,11,0,27
CLAYTON,3/11/2020,16,13,0,29
CLAYTON,3/12/2020,16,16,0,32
CLAYTON,3/13/2020,24,17,0,41
CLAYTON,3/14/2020,29,21,0,50
CLAYTON,3/15/2020,34,24,0,58
CLAYTON,3/16/2020,44,28,0,72
CLAYTON,3/17/2020,50,32,0,82
CLAYTON,3/18/2020,51,38,0,89
CLAYTON,3/19/2020,57,43,0,100
CLAYTON,3/20/2020,68,45,0,113
CLAYTON,3/21/2020,75,50,0,125
CLAYTON,3/22/2020,89,58,0,147
CLAYTON,3/23/2020,100,62,0,162
CLAYTON,3/24/2020,115,69,0,184
CLAYTON,3/25/2020,123,77,0,200
CLAYTON,3/26/2020,137,80,0,217
CLAYTON,3/27/2020,150,91,0,241
CLAYTON,3/28/2020,160,94,0,254
CLAYTON,3/29/2020,165,98,0,263
CLAYTON,3/30/2020,180,103,0,283
CLAYTON,3/31/2020,196,106,0,302
CLAYTON,4/1/2020,206,120,0,326
CLAYTON,4/2/2020,218,129,0,347
CLAYTON,4/3/2020,229,135,0,364
CLAYTON,4/4/2020,235,137,0,372
CLAYTON,4/5/2020,238,139,0,377
CLAYTON,4/6/2020,277,177,0,454
CLAYTON,4/7/2020,288,183,0,471
CLAYTON,4/8/2020,294,196,0,490
CLAYTON,4/9/2020,301,204,0,505
CLAYTON,4/10/2020,325,220,0,545
CLAYTON,4/11/2020,327,220,0,547
CLAYTON,4/12/2020,330,223,0,553
CLAYTON,4/13/2020,334,226,0,560
CLAYTON,4/14/2020,348,233,0,581
CLAYTON,4/15/2020,354,247,0,601
CLAYTON,4/16/2020,373,263,2,638
CLAYTON,4/17/2020,378,272,2,652
CLAYTON,4/18/2020,384,276,2,662
CLAYTON,4/19/2020,385,279,2,666
CLAYTON,4/20/2020,409,291,2,702
CLAYTON,4/21/2020,417,297,2,716
CLAYTON,4/22/2020,420,301,2,723
CLAYTON,4/23/2020,430,306,2,738
CLAYTON,4/24/2020,440,311,2,753
CLAYTON,4/25/2020,443,314,2,759
CLAYTON,4/26/2020,451,319,2,772
CLAYTON,4/27/2020,491,333,2,826
CLAYTON,4/28/2020,508,343,2,853
CLAYTON,4/29/2020,513,350,2,865
CLAYTON,4/30/2020,523,361,2,886
CLAYTON,5/1/2020,544,375,4,923
CLAYTON,5/2/2020,549,382,5,936
CLAYTON,5/3/2020,551,387,6,944
CLAYTON,5/4/2020,564,398,6,968
CLAYTON,5/5/2020,574,421,6,1001
CLAYTON,5/6/2020,581,429,6,1016
CLAYTON,5/7/2020,590,440,6,1036
CLAYTON,5/8/2020,595,450,6,1051
CLAYTON,5/9/2020,597,456,6,1059
CLAYTON,5/10/2020,602,461,6,1069
CLAYTON,5/11/2020,612,475,6,1093
CLAYTON,5/12/2020,620,481,6,1107
CLAYTON,5/13/2020,637,495,6,1138
CLAYTON,5/14/2020,648,498,6,1152
CLAYTON,5/15/2020,662,503,6,1171
CLAYTON,5/16/2020,669,506,6,1181
CLAYTON,5/17/2020,673,510,6,1189
CLAYTON,5/18/2020,687,516,6,1209
CLAYTON,5/19/2020,695,519,6,1220
CLAYTON,5/20/2020,704,527,6,1237
CLAYTON,5/21/2020,708,537,6,1251
CLAYTON,5/22/2020,717,546,7,1270
CLAYTON,5/23/2020,720,550,7,1277
CLAYTON,5/24/2020,724,555,7,1286
CLAYTON,5/25/2020,725,557,7,1289
CLAYTON,5/26/2020,733,567,8,1308
CLAYTON,5/27/2020,743,572,8,1323
CLAYTON,5/28/2020,750,578,8,1336
CLAYTON,5/29/2020,759,585,8,1352
CLAYTON,5/30/2020,765,589,8,1362
CLAYTON,5/31/2020,769,596,8,1373
CLAYTON,6/1/2020,786,610,8,1404
CLAYTON,6/2/2020,798,619,9,1426
CLAYTON,6/3/2020,805,626,9,1440
CLAYTON,6/4/2020,817,640,13,1470
CLAYTON,6/5/2020,824,656,14,1494
CLAYTON,6/6/2020,828,662,14,1504
CLAYTON,6/7/2020,833,668,14,1515
CLAYTON,6/8/2020,850,679,16,1545
CLAYTON,6/9/2020,866,684,16,1566
CLAYTON,6/10/2020,877,696,16,1589
CLAYTON,6/11/2020,889,714,16,1619
CLAYTON,6/12/2020,909,722,16,1647
CLAYTON,6/13/2020,915,726,16,1657
CLAYTON,6/14/2020,923,730,16,1669
CLAYTON,6/15/2020,959,752,17,1728
CLAYTON,6/16/2020,979,774,17,1770
CLAYTON,6/17/2020,1004,795,21,1820
CLAYTON,6/18/2020,1033,815,21,1869
CLAYTON,6/19/2020,1067,834,21,1922
CLAYTON,6/20/2020,1096,850,22,1968
CLAYTON,6/21/2020,1119,861,22,2002
CLAYTON,6/22/2020,1165,895,23,2083
CLAYTON,6/23/2020,1225,933,23,2181
CLAYTON,6/24/2020,1268,968,24,2260
CLAYTON,6/25/2020,1307,993,27,2327
CLAYTON,6/26/2020,1348,1026,28,2402
CLAYTON,6/27/2020,1379,1047,31,2457
CLAYTON,6/28/2020,1411,1075,31,2517
CLAYTON,6/29/2020,1475,1131,35,2641
CLAYTON,6/30/2020,1531,1176,37,2744
CLAYTON,7/1/2020,1605,1243,41,2889
CLAYTON,7/2/2020,1669,1289,42,3000
CLAYTON,7/3/2020,1719,1335,44,3098
CLAYTON,7/4/2020,1751,1359,44,3154
CLAYTON,7/5/2020,1786,1385,44,3215
CLAYTON,7/6/2020,1855,1438,47,3340
CLAYTON,7/7/2020,1926,1507,52,3485
CLAYTON,7/8/2020,2006,1563,54,3623
CLAYTON,7/9/2020,2091,1607,55,3753
CLAYTON,7/10/2020,2152,1659,56,3867
CLAYTON,7/11/2020,2203,1695,57,3955
CLAYTON,7/12/2020,2232,1708,58,3998
CLAYTON,7/13/2020,2306,1769,60,4135
CLAYTON,7/14/2020,2370,1822,61,4253
CLAYTON,7/15/2020,2430,1867,67,4364
CLAYTON,7/16/2020,2489,1911,70,4470
CLAYTON,7/17/2020,2544,1946,70,4560
CLAYTON,7/18/2020,2577,1965,70,4612
CLAYTON,7/19/2020,2604,1971,71,4646
CLAYTON,7/20/2020,2667,2023,71,4761
CLAYTON,7/21/2020,2724,2058,71,4853
CLAYTON,7/22/2020,2774,2094,75,4943
CLAYTON,7/23/2020,2837,2132,75,5044
CLAYTON,7/24/2020,2883,2172,79,5134
CLAYTON,7/25/2020,2919,2189,79,5187
CLAYTON,7/26/2020,2932,2199,79,5210
CLAYTON,7/27/2020,2979,2240,81,5300
CLAYTON,7/28/2020,3011,2271,82,5364
CLAYTON,7/29/2020,3077,2311,83,5471
CLAYTON,7/30/2020,3114,2339,85,5538
CLAYTON,7/31/2020,3155,2375,85,5615
CLAYTON,8/1/2020,3185,2391,85,5661
CLAYTON,8/2/2020,3195,2401,85,5681
CLAYTON,8/3/2020,3245,2433,86,5764
CLAYTON,8/4/2020,3287,2468,90,5845
CLAYTON,8/5/2020,3334,2504,99,5937
CLAYTON,8/6/2020,3361,2533,99,5993
CLAYTON,8/7/2020,3405,2568,99,6072
CLAYTON,8/8/2020,3425,2587,100,6112
CLAYTON,8/9/2020,3436,2602,100,6138
CLAYTON,8/10/2020,3474,2632,101,6207
CLAYTON,8/11/2020,3504,2666,101,6271
CLAYTON,8/12/2020,3534,2692,101,6327
CLAYTON,8/13/2020,3559,2709,101,6369
CLAYTON,8/14/2020,3593,2730,101,6424
CLAYTON,8/15/2020,3607,2747,101,6455
CLAYTON,8/16/2020,3628,2759,101,6488
CLAYTON,8/17/2020,3654,2782,101,6537
CLAYTON,8/18/2020,3675,2803,102,6580
CLAYTON,8/19/2020,3694,2820,102,6616
CLAYTON,8/20/2020,3715,2839,103,6657
CLAYTON,8/21/2020,3732,2857,103,6692
CLAYTON,8/22/2020,3738,2861,103,6702
CLAYTON,8/23/2020,3744,2866,103,6713
CLAYTON,8/24/2020,3762,2877,103,6742
CLAYTON,8/25/2020,3776,2883,103,6762
CLAYTON,8/26/2020,3787,2898,104,6789
CLAYTON,8/27/2020,3801,2909,104,6814
CLAYTON,8/28/2020,3817,2919,104,6840
CLAYTON,8/29/2020,3831,2931,104,6866
CLAYTON,8/30/2020,3836,2933,104,6873
CLAYTON,8/31/2020,3844,2950,104,6898
CLAYTON,9/1/2020,3854,2957,104,6915
CLAYTON,9/2/2020,3871,2970,105,6946
CLAYTON,9/3/2020,3882,2977,105,6964
CLAYTON,9/4/2020,3896,2984,105,6985
CLAYTON,9/5/2020,3907,2988,105,7000
CLAYTON,9/6/2020,3915,2993,105,7013
CLAYTON,9/7/2020,3921,2998,105,7024
CLAYTON,9/8/2020,3935,3022,105,7062
CLAYTON,9/9/2020,3943,3038,105,7086
CLAYTON,9/10/2020,3955,3050,107,7112
CLAYTON,9/11/2020,3970,3061,107,7138
CLAYTON,9/12/2020,3976,3067,107,7150
CLAYTON,9/13/2020,3984,3069,108,7161
CLAYTON,9/14/2020,3995,3084,108,7187
CLAYTON,9/15/2020,4005,3090,108,7203
CLAYTON,9/16/2020,4012,3102,108,7222
CLAYTON,9/17/2020,4018,3114,108,7240
CLAYTON,9/18/2020,4025,3121,108,7254
CLAYTON,9/19/2020,4033,3125,108,7266
CLAYTON,9/20/2020,4041,3136,108,7285
CLAYTON,9/21/2020,4053,3144,108,7305
CLAYTON,9/22/2020,4065,3151,108,7324
CLAYTON,9/23/2020,4077,3155,108,7340
CLAYTON,9/24/2020,4082,3167,108,7357
CLAYTON,9/25/2020,4092,3170,109,7371
CLAYTON,9/26/2020,4106,3177,110,7393
CLAYTON,9/27/2020,4117,3183,110,7410
CLAYTON,9/28/2020,4135,3201,111,7447
CLAYTON,9/29/2020,4150,3212,113,7475
CLAYTON,9/30/2020,4163,3222,113,7498
CLAYTON,10/1/2020,4180,3239,113,7532
CLAYTON,10/2/2020,4194,3246,113,7553
CLAYTON,10/3/2020,4206,3255,114,7575
CLAYTON,10/4/2020,4215,3265,114,7594
CLAYTON,10/5/2020,4236,3272,114,7622
CLAYTON,10/6/2020,4244,3284,115,7643
CLAYTON,10/7/2020,4265,3303,115,7683
CLAYTON,10/8/2020,4281,3314,115,7710
CLAYTON,10/9/2020,4291,3327,115,7733
CLAYTON,10/10/2020,4305,3340,115,7760
CLAYTON,10/11/2020,4314,3343,115,7772
CLAYTON,10/12/2020,4329,3358,115,7802
CLAYTON,10/13/2020,4343,3371,115,7829
CLAYTON,10/14/2020,4354,3380,115,7849
CLAYTON,10/15/2020,4363,3391,115,7869
CLAYTON,10/16/2020,4373,3397,115,7885
CLAYTON,10/17/2020,4376,3403,115,7894
CLAYTON,10/18/2020,4377,3403,115,7895
CLAYTON,10/19/2020,4378,3404,115,7897
CLAYTON,10/20/2020,4378,3404,115,7897
CLINCH,1/1/2020,0,0,0,0
CLINCH,1/2/2020,0,0,0,0
CLINCH,1/3/2020,0,0,0,0
CLINCH,1/4/2020,0,0,0,0
CLINCH,1/5/2020,0,0,0,0
CLINCH,1/6/2020,0,0,0,0
CLINCH,1/7/2020,0,0,0,0
CLINCH,1/8/2020,0,0,0,0
CLINCH,1/9/2020,0,0,0,0
CLINCH,1/10/2020,0,0,0,0
CLINCH,1/11/2020,0,0,0,0
CLINCH,1/12/2020,0,0,0,0
CLINCH,1/13/2020,0,0,0,0
CLINCH,1/14/2020,0,0,0,0
CLINCH,1/15/2020,0,0,0,0
CLINCH,1/16/2020,0,0,0,0
CLINCH,1/17/2020,0,0,0,0
CLINCH,1/18/2020,0,0,0,0
CLINCH,1/19/2020,0,0,0,0
CLINCH,1/20/2020,0,0,0,0
CLINCH,1/21/2020,0,0,0,0
CLINCH,1/22/2020,0,0,0,0
CLINCH,1/23/2020,0,0,0,0
CLINCH,1/24/2020,0,0,0,0
CLINCH,1/25/2020,0,0,0,0
CLINCH,1/26/2020,0,0,0,0
CLINCH,1/27/2020,0,0,0,0
CLINCH,1/28/2020,0,0,0,0
CLINCH,1/29/2020,0,0,0,0
CLINCH,1/30/2020,0,0,0,0
CLINCH,1/31/2020,0,0,0,0
CLINCH,2/1/2020,0,0,0,0
CLINCH,2/2/2020,0,0,0,0
CLINCH,2/3/2020,0,0,0,0
CLINCH,2/4/2020,0,0,0,0
CLINCH,2/5/2020,0,0,0,0
CLINCH,2/6/2020,0,0,0,0
CLINCH,2/7/2020,0,0,0,0
CLINCH,2/8/2020,0,0,0,0
CLINCH,2/9/2020,0,0,0,0
CLINCH,2/10/2020,0,0,0,0
CLINCH,2/11/2020,0,0,0,0
CLINCH,2/12/2020,0,0,0,0
CLINCH,2/13/2020,0,0,0,0
CLINCH,2/14/2020,0,0,0,0
CLINCH,2/15/2020,0,0,0,0
CLINCH,2/16/2020,0,0,0,0
CLINCH,2/17/2020,0,0,0,0
CLINCH,2/18/2020,0,0,0,0
CLINCH,2/19/2020,0,0,0,0
CLINCH,2/20/2020,0,0,0,0
CLINCH,2/21/2020,0,0,0,0
EMANUEL,1/19/2020,0,0,0,0
EMANUEL,1/20/2020,0,0,0,0
EMANUEL,1/21/2020,0,0,0,0
EMANUEL,1/22/2020,0,0,0,0
EMANUEL,1/23/2020,0,0,0,0
EMANUEL,1/24/2020,0,0,0,0
EMANUEL,1/25/2020,0,0,0,0
EMANUEL,1/26/2020,0,0,0,0
EMANUEL,1/27/2020,0,0,0,0
EMANUEL,1/28/2020,0,0,0,0
EMANUEL,1/29/2020,0,0,0,0
EARLY,7/25/2020,210,128,4,342
EMANUEL,1/30/2020,0,0,0,0
DADE,7/1/2020,41,41,2,84
DECATUR,10/15/2020,670,576,18,1264
EMANUEL,1/31/2020,0,0,0,0
EMANUEL,2/1/2020,0,0,0,0
EMANUEL,2/2/2020,0,0,0,0
EMANUEL,2/3/2020,0,0,0,0
EMANUEL,2/4/2020,0,0,0,0
EMANUEL,2/5/2020,0,0,0,0
EMANUEL,2/6/2020,0,0,0,0
EMANUEL,2/7/2020,0,0,0,0
EMANUEL,2/8/2020,0,0,0,0
EMANUEL,2/9/2020,0,0,0,0
EMANUEL,2/10/2020,0,0,0,0
EMANUEL,2/11/2020,0,0,0,0
EMANUEL,2/12/2020,0,0,0,0
EMANUEL,2/13/2020,0,0,0,0
EMANUEL,2/14/2020,0,0,0,0
EMANUEL,2/15/2020,0,0,0,0
EMANUEL,2/16/2020,0,0,0,0
EMANUEL,2/17/2020,0,0,0,0
EMANUEL,2/18/2020,0,0,0,0
EMANUEL,2/19/2020,0,0,0,0
EMANUEL,2/20/2020,0,0,0,0
EMANUEL,2/21/2020,0,0,0,0
EMANUEL,2/22/2020,0,0,0,0
EMANUEL,2/23/2020,0,0,0,0
EMANUEL,2/24/2020,0,0,0,0
EMANUEL,2/25/2020,0,0,0,0
EMANUEL,2/26/2020,0,0,0,0
EMANUEL,2/27/2020,0,0,0,0
EMANUEL,2/28/2020,0,0,0,0
EMANUEL,2/29/2020,0,0,0,0
EMANUEL,3/1/2020,0,0,0,0
EMANUEL,3/2/2020,0,0,0,0
EMANUEL,3/3/2020,0,0,0,0
EMANUEL,3/4/2020,0,0,0,0
EMANUEL,3/5/2020,0,0,0,0
EMANUEL,3/6/2020,0,0,0,0
EMANUEL,3/7/2020,0,0,0,0
EMANUEL,3/8/2020,0,0,0,0
EMANUEL,3/9/2020,0,0,0,0
EMANUEL,3/10/2020,0,0,0,0
EMANUEL,3/11/2020,0,0,0,0
EMANUEL,3/12/2020,0,0,0,0
EMANUEL,3/13/2020,0,0,0,0
EMANUEL,3/14/2020,0,0,0,0
EMANUEL,3/15/2020,0,0,0,0
EMANUEL,3/16/2020,0,0,0,0
EMANUEL,3/17/2020,0,0,0,0
EMANUEL,3/18/2020,0,1,0,1
EMANUEL,3/19/2020,0,1,0,1
EMANUEL,3/20/2020,0,1,0,1
EMANUEL,3/21/2020,0,1,0,1
EMANUEL,3/22/2020,0,1,0,1
EMANUEL,3/23/2020,0,1,0,1
EMANUEL,3/24/2020,0,1,0,1
EMANUEL,3/25/2020,0,1,0,1
EMANUEL,3/26/2020,0,1,0,1
EMANUEL,3/27/2020,0,2,0,2
EMANUEL,3/28/2020,0,2,0,2
EMANUEL,3/29/2020,0,2,0,2
EMANUEL,3/30/2020,0,2,0,2
EMANUEL,3/31/2020,2,2,0,4
EMANUEL,4/1/2020,2,2,0,4
EMANUEL,4/2/2020,2,2,0,4
EMANUEL,4/3/2020,3,3,0,6
EMANUEL,4/4/2020,3,3,0,6
EMANUEL,4/5/2020,3,3,0,6
EMANUEL,4/6/2020,5,4,0,9
EMANUEL,4/7/2020,7,4,0,11
EMANUEL,4/8/2020,7,4,0,11
EMANUEL,4/9/2020,7,4,0,11
EMANUEL,4/10/2020,7,4,0,11
EMANUEL,4/11/2020,7,5,0,12
EMANUEL,4/12/2020,8,6,0,14
EMANUEL,4/13/2020,9,6,0,15
EMANUEL,4/14/2020,9,9,0,18
EMANUEL,4/15/2020,9,10,0,19
EMANUEL,4/16/2020,10,10,0,20
EMANUEL,4/17/2020,10,10,0,20
EMANUEL,4/18/2020,10,10,0,20
EMANUEL,4/19/2020,11,10,0,21
EMANUEL,4/20/2020,11,10,0,21
EMANUEL,4/21/2020,11,10,0,21
EMANUEL,4/22/2020,11,10,0,21
EMANUEL,4/23/2020,12,10,0,22
EMANUEL,4/24/2020,12,10,0,22
EMANUEL,4/25/2020,12,10,0,22
EMANUEL,4/26/2020,12,10,0,22
EMANUEL,4/27/2020,12,10,0,22
EMANUEL,4/28/2020,12,11,0,23
EMANUEL,4/29/2020,12,11,0,23
EMANUEL,4/30/2020,12,11,0,23
EMANUEL,5/1/2020,12,11,0,23
EMANUEL,5/2/2020,12,11,0,23
EMANUEL,5/3/2020,12,11,0,23
EMANUEL,5/4/2020,12,11,0,23
EMANUEL,5/5/2020,12,11,0,23
EMANUEL,5/6/2020,13,11,0,24
EMANUEL,5/7/2020,13,11,0,24
EMANUEL,5/8/2020,14,11,0,25
EMANUEL,5/9/2020,14,11,0,25
EMANUEL,5/10/2020,14,11,0,25
EMANUEL,5/11/2020,14,11,0,25
EMANUEL,5/12/2020,14,11,0,25
EMANUEL,5/13/2020,14,11,0,25
EMANUEL,5/14/2020,15,11,0,26
EMANUEL,5/15/2020,15,11,0,26
EMANUEL,5/16/2020,16,11,0,27
EMANUEL,5/17/2020,16,11,0,27
EMANUEL,5/18/2020,16,11,0,27
EMANUEL,5/19/2020,16,11,0,27
EMANUEL,5/20/2020,16,11,0,27
EMANUEL,5/21/2020,16,11,0,27
EMANUEL,5/22/2020,16,11,0,27
EMANUEL,5/23/2020,17,11,0,28
EMANUEL,5/24/2020,17,11,0,28
EMANUEL,5/25/2020,17,11,0,28
EMANUEL,5/26/2020,17,11,0,28
EMANUEL,5/27/2020,17,11,0,28
EMANUEL,5/28/2020,20,11,0,31
EMANUEL,5/29/2020,20,12,0,32
EMANUEL,5/30/2020,20,12,0,32
EMANUEL,5/31/2020,20,12,0,32
EMANUEL,6/1/2020,20,12,0,32
EMANUEL,6/2/2020,20,12,0,32
EMANUEL,6/3/2020,20,14,0,34
EMANUEL,6/4/2020,23,15,0,38
EMANUEL,6/5/2020,24,16,0,40
EMANUEL,6/6/2020,24,16,0,40
EMANUEL,6/7/2020,24,16,0,40
EMANUEL,6/8/2020,27,18,0,45
EMANUEL,6/9/2020,30,19,0,49
EMANUEL,6/10/2020,32,19,0,51
EMANUEL,6/11/2020,35,21,0,56
EMANUEL,6/12/2020,39,21,0,60
EMANUEL,6/13/2020,40,21,0,61
EMANUEL,6/14/2020,41,21,0,62
EMANUEL,6/15/2020,43,27,0,70
EMANUEL,6/16/2020,44,29,0,73
EMANUEL,6/17/2020,47,31,0,78
EMANUEL,6/18/2020,52,34,0,86
EMANUEL,6/19/2020,53,35,0,88
EMANUEL,6/20/2020,55,37,0,92
EMANUEL,6/21/2020,57,38,0,95
EMANUEL,6/22/2020,58,45,0,103
EMANUEL,6/23/2020,64,49,0,113
EMANUEL,6/24/2020,75,60,0,135
EMANUEL,6/25/2020,80,63,0,143
EMANUEL,6/26/2020,85,71,0,156
EMANUEL,6/27/2020,88,73,0,161
EMANUEL,6/28/2020,94,74,0,168
EMANUEL,6/29/2020,101,81,0,182
EMANUEL,6/30/2020,103,85,0,188
EMANUEL,7/1/2020,107,90,0,197
EMANUEL,7/2/2020,108,95,0,203
EMANUEL,7/3/2020,114,97,0,211
EMANUEL,7/4/2020,117,101,0,218
EMANUEL,7/5/2020,119,102,0,221
EMANUEL,7/6/2020,125,109,0,234
EMANUEL,7/7/2020,128,112,0,240
EMANUEL,7/8/2020,129,115,0,244
EMANUEL,7/9/2020,131,118,0,249
EMANUEL,7/10/2020,137,124,0,261
EMANUEL,7/11/2020,139,127,0,266
EMANUEL,7/12/2020,143,128,0,271
EMANUEL,7/13/2020,147,133,0,280
EMANUEL,7/14/2020,150,135,0,285
EMANUEL,7/15/2020,158,140,0,298
EMANUEL,7/16/2020,163,143,0,306
EMANUEL,7/17/2020,172,151,0,323
EMANUEL,7/18/2020,176,154,0,330
EMANUEL,7/19/2020,178,155,1,334
EMANUEL,7/20/2020,186,163,1,350
EMANUEL,7/21/2020,223,172,1,396
EMANUEL,7/22/2020,228,176,2,406
EMANUEL,7/23/2020,232,180,2,414
EMANUEL,7/24/2020,242,185,2,429
EMANUEL,7/25/2020,245,186,2,433
EMANUEL,7/26/2020,248,188,2,438
EMANUEL,7/27/2020,255,192,2,449
EMANUEL,7/28/2020,269,197,2,468
EMANUEL,7/29/2020,275,202,2,479
EMANUEL,7/30/2020,282,206,2,490
EMANUEL,7/31/2020,294,213,2,509
EMANUEL,8/1/2020,301,218,2,521
EMANUEL,8/2/2020,302,221,2,525
EMANUEL,8/3/2020,309,225,2,536
EMANUEL,8/4/2020,316,229,2,547
EMANUEL,8/5/2020,333,234,2,569
EMANUEL,8/6/2020,342,238,2,582
EMANUEL,8/7/2020,349,245,2,596
EMANUEL,8/8/2020,354,248,2,604
EMANUEL,8/9/2020,358,250,2,610
EMANUEL,8/10/2020,365,259,2,626
EMANUEL,8/11/2020,378,269,2,649
EMANUEL,8/12/2020,385,274,2,661
EMANUEL,8/13/2020,392,279,2,673
EMANUEL,8/14/2020,402,284,2,688
EMANUEL,8/15/2020,405,285,2,692
EMANUEL,8/16/2020,409,288,2,699
EMANUEL,8/17/2020,415,292,2,709
EMANUEL,8/18/2020,419,299,2,720
EMANUEL,8/19/2020,424,301,2,727
EMANUEL,8/20/2020,431,304,2,737
EMANUEL,8/21/2020,437,307,2,746
EMANUEL,8/22/2020,444,309,2,755
EMANUEL,8/23/2020,448,310,2,760
EMANUEL,8/24/2020,455,313,2,770
EMANUEL,8/25/2020,463,320,2,785
EMANUEL,8/26/2020,469,322,2,793
EMANUEL,8/27/2020,478,327,2,807
EMANUEL,8/28/2020,483,331,2,816
EMANUEL,8/29/2020,489,334,2,825
EMANUEL,8/30/2020,494,339,2,835
EMANUEL,8/31/2020,502,350,2,854
EMANUEL,9/1/2020,507,354,2,863
EMANUEL,9/2/2020,518,360,2,880
EMANUEL,9/3/2020,523,366,2,891
EMANUEL,9/4/2020,530,375,2,907
EMANUEL,9/5/2020,539,379,2,920
EMANUEL,9/6/2020,541,382,2,925
EMANUEL,9/7/2020,546,383,2,931
EMANUEL,9/8/2020,555,394,2,951
EMANUEL,9/9/2020,562,399,2,963
EMANUEL,9/10/2020,568,402,2,972
EMANUEL,9/11/2020,580,408,2,990
EMANUEL,9/12/2020,585,410,2,997
EMANUEL,9/13/2020,592,411,2,1005
EMANUEL,9/14/2020,597,419,2,1018
EMANUEL,9/15/2020,607,423,2,1032
EMANUEL,9/16/2020,612,423,2,1037
EMANUEL,9/17/2020,620,427,3,1050
EMANUEL,9/18/2020,622,430,3,1055
EMANUEL,9/19/2020,622,430,3,1055
EMANUEL,9/20/2020,624,430,3,1057
EMANUEL,9/21/2020,631,431,4,1066
EMANUEL,9/22/2020,634,434,4,1072
EMANUEL,9/23/2020,636,442,4,1082
EMANUEL,9/24/2020,638,444,4,1086
EMANUEL,9/25/2020,644,446,4,1094
EMANUEL,9/26/2020,646,450,4,1100
EMANUEL,9/27/2020,646,451,4,1101
EMANUEL,9/28/2020,649,452,4,1105
EMANUEL,9/29/2020,652,453,4,1109
EMANUEL,9/30/2020,654,453,4,1111
EMANUEL,10/1/2020,661,457,4,1122
EMANUEL,10/2/2020,662,458,4,1124
EMANUEL,10/3/2020,664,458,4,1126
EMANUEL,10/4/2020,665,460,4,1129
EMANUEL,10/5/2020,667,461,4,1132
EMANUEL,10/6/2020,671,464,4,1139
EMANUEL,10/7/2020,671,465,5,1141
EMANUEL,10/8/2020,672,467,5,1144
EMANUEL,10/9/2020,675,468,5,1148
EMANUEL,10/10/2020,677,468,5,1150
EMANUEL,10/11/2020,678,469,5,1152
EMANUEL,10/12/2020,681,472,5,1158
EMANUEL,10/13/2020,681,472,5,1158
EMANUEL,10/14/2020,683,474,5,1162
EMANUEL,10/15/2020,683,475,5,1163
EMANUEL,10/16/2020,685,475,5,1165
EMANUEL,10/17/2020,686,477,5,1168
EMANUEL,10/18/2020,686,477,5,1168
EMANUEL,10/19/2020,686,477,5,1168
EMANUEL,10/20/2020,686,477,5,1168
EVANS,1/1/2020,0,0,0,0
EVANS,1/2/2020,0,0,0,0
EVANS,1/3/2020,0,0,0,0
EVANS,1/4/2020,0,0,0,0
EVANS,1/5/2020,0,0,0,0
EVANS,1/6/2020,0,0,0,0
EVANS,1/7/2020,0,0,0,0
EVANS,1/8/2020,0,0,0,0
EVANS,1/9/2020,0,0,0,0
EVANS,1/10/2020,0,0,0,0
EVANS,1/11/2020,0,0,0,0
EVANS,1/12/2020,0,0,0,0
EVANS,1/13/2020,0,0,0,0
EVANS,1/14/2020,0,0,0,0
EVANS,1/15/2020,0,0,0,0
EVANS,1/16/2020,0,0,0,0
EVANS,1/17/2020,0,0,0,0
EVANS,1/18/2020,0,0,0,0
EVANS,1/19/2020,0,0,0,0
EVANS,1/20/2020,0,0,0,0
EVANS,1/21/2020,0,0,0,0
EVANS,1/22/2020,0,0,0,0
EVANS,1/23/2020,0,0,0,0
EVANS,1/24/2020,0,0,0,0
EVANS,1/25/2020,0,0,0,0
EVANS,1/26/2020,0,0,0,0
EVANS,1/27/2020,0,0,0,0
EVANS,1/28/2020,0,0,0,0
EVANS,1/29/2020,0,0,0,0
EVANS,1/30/2020,0,0,0,0
EVANS,1/31/2020,0,0,0,0
EVANS,2/1/2020,0,0,0,0
EVANS,2/2/2020,0,0,0,0
EVANS,2/3/2020,0,0,0,0
EVANS,2/4/2020,0,0,0,0
EVANS,2/5/2020,0,0,0,0
EVANS,2/6/2020,0,0,0,0
EVANS,2/7/2020,0,0,0,0
EVANS,2/8/2020,0,0,0,0
EVANS,2/9/2020,0,0,0,0
EVANS,2/10/2020,0,0,0,0
EVANS,2/11/2020,0,0,0,0
EVANS,2/12/2020,0,0,0,0
EVANS,2/13/2020,0,0,0,0
EVANS,2/14/2020,0,0,0,0
EVANS,2/15/2020,0,0,0,0
EVANS,2/16/2020,0,0,0,0
EVANS,2/17/2020,0,0,0,0
EVANS,2/18/2020,0,0,0,0
EVANS,2/19/2020,0,0,0,0
EVANS,2/20/2020,0,0,0,0
EVANS,2/21/2020,0,0,0,0
EVANS,2/22/2020,0,0,0,0
EVANS,2/23/2020,0,0,0,0
EVANS,2/24/2020,0,0,0,0
EVANS,2/25/2020,0,0,0,0
EVANS,2/26/2020,0,0,0,0
EVANS,2/27/2020,0,0,0,0
EVANS,2/28/2020,0,0,0,0
EVANS,2/29/2020,0,0,0,0
EVANS,3/1/2020,0,0,0,0
DOUGHERTY,4/10/2020,846,466,12,1324
EVANS,3/2/2020,0,0,0,0
EVANS,3/3/2020,0,0,0,0
EVANS,3/4/2020,0,0,0,0
EVANS,3/5/2020,0,0,0,0
EVANS,3/6/2020,0,0,0,0
EVANS,3/7/2020,0,0,0,0
EVANS,3/8/2020,0,0,0,0
EVANS,3/9/2020,0,0,0,0
EVANS,3/10/2020,0,0,0,0
EVANS,3/11/2020,0,0,0,0
EVANS,3/12/2020,0,0,0,0
EVANS,3/13/2020,0,0,0,0
EVANS,3/14/2020,0,0,0,0
EVANS,3/15/2020,0,0,0,0
EVANS,3/16/2020,0,0,0,0
EVANS,3/17/2020,0,0,0,0
EVANS,3/18/2020,0,1,0,1
EVANS,3/19/2020,0,1,0,1
EVANS,3/20/2020,0,1,0,1
EVANS,3/21/2020,0,1,0,1
EVANS,3/22/2020,0,1,0,1
EVANS,3/23/2020,0,1,0,1
EVANS,3/24/2020,0,1,0,1
EVANS,3/25/2020,0,1,0,1
EVANS,3/26/2020,0,1,0,1
EVANS,3/27/2020,0,1,0,1
EVANS,3/28/2020,0,1,0,1
EVANS,3/29/2020,0,1,0,1
EVANS,3/30/2020,0,1,0,1
EVANS,3/31/2020,0,1,0,1
EVANS,4/1/2020,0,1,0,1
EVANS,4/2/2020,0,1,0,1
EVANS,4/3/2020,0,1,0,1
EVANS,4/4/2020,0,1,0,1
EVANS,4/5/2020,0,1,0,1
EVANS,4/6/2020,0,1,0,1
EVANS,4/7/2020,0,1,0,1
EVANS,4/8/2020,0,2,0,2
EVANS,4/9/2020,0,2,0,2
EVANS,4/10/2020,0,2,0,2
EVANS,4/11/2020,1,2,0,3
EVANS,4/12/2020,1,2,0,3
EVANS,4/13/2020,1,2,0,3
EVANS,4/14/2020,1,2,0,3
EVANS,4/15/2020,1,2,0,3
EVANS,4/16/2020,2,2,0,4
EVANS,4/17/2020,2,2,0,4
EVANS,4/18/2020,2,2,0,4
EVANS,4/19/2020,2,2,0,4
EVANS,4/20/2020,3,2,0,5
EVANS,4/21/2020,3,2,0,5
EVANS,4/22/2020,3,2,0,5
EVANS,4/23/2020,4,2,0,6
EVANS,4/24/2020,4,2,0,6
EVANS,4/25/2020,4,2,0,6
EVANS,4/26/2020,4,2,0,6
EVANS,4/27/2020,4,2,0,6
EVANS,4/28/2020,4,2,0,6
EVANS,4/29/2020,4,2,0,6
EVANS,4/30/2020,4,2,0,6
EVANS,5/1/2020,4,2,0,6
EVANS,5/2/2020,4,2,0,6
EVANS,5/3/2020,4,2,0,6
DADE,7/2/2020,41,41,2,84
DADE,7/3/2020,42,43,2,87
DADE,7/4/2020,42,43,2,87
DADE,7/5/2020,42,43,2,87
DADE,7/6/2020,43,43,2,88
DADE,7/7/2020,44,45,2,91
DADE,7/8/2020,44,45,2,91
DADE,7/9/2020,45,46,2,93
DADE,7/10/2020,45,49,2,96
DADE,7/11/2020,46,50,2,98
DADE,7/12/2020,47,50,2,99
DECATUR,10/16/2020,670,576,18,1264
DADE,7/13/2020,47,52,2,101
DADE,7/14/2020,47,52,2,101
DADE,7/15/2020,48,53,2,103
DADE,7/16/2020,49,53,2,104
DADE,7/17/2020,49,53,2,104
DADE,7/18/2020,49,53,2,104
DADE,7/19/2020,50,54,2,106
DADE,7/20/2020,51,54,2,107
DADE,7/21/2020,51,54,2,107
DADE,7/22/2020,52,54,2,108
DADE,7/23/2020,54,56,2,112
DADE,7/24/2020,56,58,2,116
DADE,7/25/2020,56,60,2,118
DADE,7/26/2020,56,61,2,119
DADE,7/27/2020,58,63,2,123
DADE,7/28/2020,61,64,2,127
DADE,7/29/2020,62,66,2,130
DADE,7/30/2020,64,67,2,133
DADE,7/31/2020,66,69,2,137
DOUGHERTY,4/11/2020,857,470,12,1339
EARLY,7/26/2020,210,129,4,343
DADE,8/1/2020,66,71,2,139
DADE,8/2/2020,68,71,2,141
DADE,8/3/2020,71,72,2,145
DADE,8/4/2020,71,74,2,147
DADE,8/5/2020,76,81,3,160
DADE,8/6/2020,76,82,4,162
DADE,8/7/2020,80,83,4,167
DADE,8/8/2020,83,83,4,170
DADE,8/9/2020,84,83,4,171
DADE,8/10/2020,85,85,4,174
DADE,8/11/2020,87,87,4,178
DADE,8/12/2020,88,88,4,180
DADE,8/13/2020,88,89,4,181
DADE,8/14/2020,89,91,4,184
DADE,8/15/2020,89,93,4,186
DADE,8/16/2020,89,93,4,186
DADE,8/17/2020,93,93,4,190
DADE,8/18/2020,94,94,4,192
DADE,8/19/2020,96,94,4,194
DADE,8/20/2020,97,95,4,196
DADE,8/21/2020,97,96,4,197
DADE,8/22/2020,98,96,4,198
DADE,8/23/2020,98,96,4,198
DADE,8/24/2020,100,99,4,203
DADE,8/25/2020,102,100,4,206
DADE,8/26/2020,104,101,4,209
DADE,8/27/2020,107,104,4,215
DADE,8/28/2020,111,108,4,223
DADE,8/29/2020,111,108,4,223
DADE,8/30/2020,115,108,4,227
DADE,8/31/2020,118,111,4,233
DADE,9/1/2020,119,113,4,236
DADE,9/2/2020,121,113,4,238
DADE,9/3/2020,124,116,4,244
DADE,9/4/2020,127,116,4,247
DADE,9/5/2020,128,116,4,248
DADE,9/6/2020,130,117,4,251
DADE,9/7/2020,132,117,4,253
DADE,9/8/2020,135,120,4,259
DADE,9/9/2020,137,123,4,264
DADE,9/10/2020,140,124,5,269
DADE,9/11/2020,144,124,5,273
DADE,9/12/2020,144,124,5,273
DADE,9/13/2020,145,124,5,274
DADE,9/14/2020,147,127,5,279
DADE,9/15/2020,148,128,5,281
DADE,9/16/2020,149,129,5,283
DADE,9/17/2020,150,129,5,284
DADE,9/18/2020,150,130,5,285
DADE,9/19/2020,150,131,5,286
DADE,9/20/2020,150,131,5,286
DADE,9/21/2020,150,131,5,286
DADE,9/22/2020,150,131,5,286
DADE,9/23/2020,150,131,5,286
DADE,9/24/2020,153,132,5,290
DADE,9/25/2020,153,132,5,290
DADE,9/26/2020,154,132,5,291
DADE,9/27/2020,154,133,5,292
DADE,9/28/2020,155,133,5,293
DADE,9/29/2020,156,133,5,294
DADE,9/30/2020,156,134,5,295
DADE,10/1/2020,157,135,6,298
DADE,10/2/2020,160,136,6,302
DADE,10/3/2020,162,138,6,306
DADE,10/4/2020,163,139,6,308
DADE,10/5/2020,163,139,6,308
DADE,10/6/2020,163,142,6,311
DADE,10/7/2020,163,142,6,311
DADE,10/8/2020,166,146,6,318
DADE,10/9/2020,169,146,7,322
DADE,10/10/2020,172,147,8,327
DADE,10/11/2020,172,148,8,328
DADE,10/12/2020,172,149,8,329
DADE,10/13/2020,172,149,8,329
DADE,10/14/2020,172,153,8,333
DADE,10/15/2020,172,153,8,333
DADE,10/16/2020,172,153,8,333
DADE,10/17/2020,172,153,8,333
DADE,10/18/2020,172,153,8,333
DADE,10/19/2020,172,153,8,333
DADE,10/20/2020,172,153,8,333
DECATUR,1/1/2020,0,0,0,0
DECATUR,1/2/2020,0,0,0,0
DECATUR,1/3/2020,0,0,0,0
DECATUR,1/4/2020,0,0,0,0
DECATUR,1/5/2020,0,0,0,0
DECATUR,1/6/2020,0,0,0,0
DECATUR,1/7/2020,0,0,0,0
DECATUR,1/8/2020,0,0,0,0
DECATUR,1/9/2020,0,0,0,0
DECATUR,1/10/2020,0,0,0,0
DECATUR,1/11/2020,0,0,0,0
DECATUR,1/12/2020,0,0,0,0
DECATUR,1/13/2020,0,0,0,0
DECATUR,1/14/2020,0,0,0,0
DECATUR,1/15/2020,0,0,0,0
DECATUR,1/16/2020,0,0,0,0
DECATUR,1/17/2020,0,0,0,0
DECATUR,1/18/2020,0,0,0,0
DECATUR,1/19/2020,0,0,0,0
DECATUR,1/20/2020,0,0,0,0
DECATUR,1/21/2020,0,0,0,0
DECATUR,1/22/2020,0,0,0,0
DECATUR,1/23/2020,0,0,0,0
DECATUR,1/24/2020,0,0,0,0
DECATUR,1/25/2020,0,0,0,0
DECATUR,1/26/2020,0,0,0,0
DECATUR,1/27/2020,0,0,0,0
DECATUR,1/28/2020,0,0,0,0
DECATUR,1/29/2020,0,0,0,0
DECATUR,1/30/2020,0,0,0,0
DECATUR,1/31/2020,0,0,0,0
DECATUR,2/1/2020,0,0,0,0
DECATUR,2/2/2020,0,0,0,0
DECATUR,2/3/2020,0,0,0,0
DECATUR,2/4/2020,0,0,0,0
DECATUR,2/5/2020,0,0,0,0
DECATUR,2/6/2020,0,0,0,0
DECATUR,2/7/2020,0,0,0,0
DECATUR,2/8/2020,0,0,0,0
DECATUR,2/9/2020,0,0,0,0
DECATUR,2/10/2020,0,0,0,0
DECATUR,2/11/2020,0,0,0,0
DECATUR,2/12/2020,0,0,0,0
DECATUR,2/13/2020,0,0,0,0
DECATUR,2/14/2020,0,0,0,0
DECATUR,2/15/2020,0,0,0,0
DECATUR,2/16/2020,0,0,0,0
DECATUR,2/17/2020,0,0,0,0
DECATUR,2/18/2020,0,0,0,0
DECATUR,2/19/2020,0,0,0,0
DECATUR,2/20/2020,0,0,0,0
DECATUR,2/21/2020,0,0,0,0
DECATUR,2/22/2020,0,0,0,0
DECATUR,2/23/2020,0,0,0,0
DECATUR,2/24/2020,0,0,0,0
DECATUR,2/25/2020,0,0,0,0
DECATUR,2/26/2020,0,0,0,0
DECATUR,2/27/2020,0,0,0,0
DECATUR,2/28/2020,0,0,0,0
DECATUR,2/29/2020,0,0,0,0
DECATUR,3/1/2020,0,0,0,0
DECATUR,3/2/2020,0,0,0,0
DECATUR,3/3/2020,0,0,0,0
DECATUR,3/4/2020,0,0,0,0
DECATUR,3/5/2020,0,0,0,0
DECATUR,3/6/2020,0,0,0,0
DECATUR,3/7/2020,0,0,0,0
DECATUR,3/8/2020,0,0,0,0
DECATUR,3/9/2020,0,0,0,0
DECATUR,3/10/2020,0,0,0,0
DECATUR,3/11/2020,1,0,0,1
DECATUR,3/12/2020,1,0,0,1
DECATUR,3/13/2020,2,0,0,2
DECATUR,3/14/2020,2,0,0,2
DECATUR,3/15/2020,3,0,0,3
DECATUR,3/16/2020,3,0,0,3
DECATUR,3/17/2020,3,0,0,3
DECATUR,3/18/2020,3,0,0,3
DECATUR,3/19/2020,4,1,0,5
DECATUR,3/20/2020,7,1,0,8
DECATUR,3/21/2020,7,1,0,8
DECATUR,3/22/2020,8,1,0,9
DECATUR,3/23/2020,10,2,0,12
DECATUR,3/24/2020,11,2,0,13
DECATUR,3/25/2020,12,2,0,14
DECATUR,3/26/2020,16,2,0,18
DECATUR,3/27/2020,16,3,0,19
DECATUR,3/28/2020,19,5,0,24
DECATUR,3/29/2020,20,6,0,26
DECATUR,3/30/2020,21,6,0,27
DECATUR,3/31/2020,21,6,0,27
DECATUR,4/1/2020,22,7,0,29
DECATUR,4/2/2020,23,7,0,30
DECATUR,4/3/2020,23,7,0,30
DECATUR,4/4/2020,25,7,0,32
DECATUR,4/5/2020,26,8,0,34
DECATUR,4/6/2020,26,9,0,35
DECATUR,4/7/2020,26,9,0,35
DECATUR,4/8/2020,30,11,0,41
DECATUR,4/9/2020,30,13,0,43
DECATUR,4/10/2020,32,14,0,46
DECATUR,4/11/2020,35,15,0,50
DECATUR,4/12/2020,37,16,0,53
DECATUR,4/13/2020,37,18,0,55
DECATUR,4/14/2020,38,23,0,61
DECATUR,4/15/2020,40,23,0,63
DECATUR,4/16/2020,41,25,0,66
DECATUR,4/17/2020,42,31,0,73
DECATUR,4/18/2020,42,31,0,73
DECATUR,4/19/2020,43,31,0,74
DECATUR,4/20/2020,45,32,0,77
DECATUR,4/21/2020,46,32,0,78
DECATUR,4/22/2020,48,33,0,81
DECATUR,4/23/2020,49,36,0,85
DECATUR,4/24/2020,51,38,0,89
DECATUR,4/25/2020,52,39,0,91
DECATUR,4/26/2020,52,39,0,91
DECATUR,4/27/2020,53,42,0,95
DECATUR,4/28/2020,53,42,0,95
DECATUR,4/29/2020,53,47,0,100
DECATUR,4/30/2020,54,47,0,101
DECATUR,5/1/2020,55,47,0,102
DECATUR,5/2/2020,56,47,0,103
DECATUR,5/3/2020,58,48,0,106
DECATUR,5/4/2020,59,48,0,107
DECATUR,5/5/2020,61,48,0,109
DECATUR,5/6/2020,63,51,0,114
DECATUR,5/7/2020,64,52,0,116
DECATUR,5/8/2020,65,57,0,122
DECATUR,5/9/2020,66,57,0,123
DECATUR,5/10/2020,68,59,0,127
DECATUR,5/11/2020,69,59,0,128
DECATUR,5/12/2020,70,61,0,131
DECATUR,5/13/2020,71,61,0,132
DECATUR,5/14/2020,72,62,0,134
DECATUR,5/15/2020,75,65,0,140
DECATUR,5/16/2020,76,66,0,142
DECATUR,5/17/2020,78,68,0,146
DECATUR,5/18/2020,81,69,0,150
DECATUR,5/19/2020,84,70,0,154
DECATUR,5/20/2020,89,76,0,165
DECATUR,5/21/2020,91,78,0,169
DECATUR,5/22/2020,94,79,0,173
DECATUR,5/23/2020,98,84,0,182
DECATUR,5/24/2020,98,85,0,183
DECATUR,5/25/2020,98,89,0,187
DECATUR,5/26/2020,102,89,0,191
DECATUR,5/27/2020,103,92,0,195
DECATUR,5/28/2020,106,95,0,201
DECATUR,5/29/2020,108,96,0,204
DECATUR,5/30/2020,111,99,0,210
DECATUR,5/31/2020,111,99,0,210
DECATUR,6/1/2020,112,102,0,214
DECATUR,6/2/2020,113,102,0,215
DECATUR,6/3/2020,114,103,0,217
DECATUR,6/4/2020,114,103,0,217
DECATUR,6/5/2020,114,103,0,217
DECATUR,6/6/2020,114,103,0,217
DECATUR,6/7/2020,114,104,0,218
DECATUR,6/8/2020,114,106,0,220
DECATUR,6/9/2020,115,107,0,222
DECATUR,6/10/2020,116,109,0,225
DECATUR,6/11/2020,120,113,0,233
DECATUR,6/12/2020,121,114,0,235
DECATUR,6/13/2020,122,114,0,236
DECATUR,6/14/2020,122,115,0,237
DECATUR,6/15/2020,122,118,0,240
DECATUR,6/16/2020,122,119,0,241
DECATUR,6/17/2020,122,120,0,242
DECATUR,6/18/2020,123,120,0,243
DECATUR,6/19/2020,123,120,0,243
DECATUR,6/20/2020,123,120,0,243
DECATUR,6/21/2020,123,120,0,243
DECATUR,6/22/2020,124,121,0,245
DECATUR,6/23/2020,125,121,0,246
DECATUR,6/24/2020,128,122,0,250
DECATUR,6/25/2020,129,124,0,253
DECATUR,6/26/2020,131,124,0,255
DECATUR,6/27/2020,133,127,0,260
DECATUR,6/28/2020,134,127,0,261
DECATUR,6/29/2020,135,127,0,262
DECATUR,6/30/2020,139,130,0,269
DECATUR,7/1/2020,144,133,0,277
DECATUR,7/2/2020,144,135,0,279
DECATUR,7/3/2020,148,138,0,286
DECATUR,7/4/2020,150,140,0,290
DECATUR,7/5/2020,152,146,0,298
DECATUR,7/6/2020,159,152,0,311
DECATUR,7/7/2020,163,160,0,323
DECATUR,7/8/2020,169,165,0,334
DECATUR,7/9/2020,174,174,0,348
DECATUR,7/10/2020,185,179,0,364
DECATUR,7/11/2020,191,185,0,376
DECATUR,7/12/2020,193,188,0,381
DECATUR,7/13/2020,206,194,0,400
DECATUR,7/14/2020,215,206,1,422
DECATUR,7/15/2020,220,211,1,432
DECATUR,7/16/2020,232,219,1,452
DECATUR,7/17/2020,241,224,2,467
DECATUR,7/18/2020,246,233,2,481
DECATUR,7/19/2020,251,235,2,488
DECATUR,7/20/2020,265,242,2,509
DECATUR,7/21/2020,271,248,2,521
DECATUR,7/22/2020,278,256,2,536
DECATUR,7/23/2020,291,261,2,554
DECATUR,7/24/2020,304,274,3,581
DECATUR,7/25/2020,312,279,4,595
DECATUR,7/26/2020,316,282,4,602
DECATUR,7/27/2020,324,289,4,617
DECATUR,7/28/2020,358,305,5,668
DECATUR,7/29/2020,368,308,5,681
DECATUR,7/30/2020,377,310,5,692
DECATUR,7/31/2020,387,315,5,707
DECATUR,8/1/2020,395,319,6,720
DECATUR,8/2/2020,396,325,6,727
DECATUR,8/3/2020,407,343,6,756
DECATUR,8/4/2020,421,353,9,783
DECATUR,8/5/2020,430,366,10,806
DECATUR,8/6/2020,437,369,11,817
DECATUR,8/7/2020,443,373,11,827
DECATUR,8/8/2020,449,376,11,836
DECATUR,8/9/2020,450,382,11,843
DECATUR,8/10/2020,459,389,11,859
DECATUR,8/11/2020,461,391,11,863
DECATUR,8/12/2020,466,396,11,873
DECATUR,8/13/2020,473,403,12,888
DECATUR,8/14/2020,479,404,13,896
DECATUR,8/15/2020,485,410,13,908
DECATUR,8/16/2020,494,413,13,920
DECATUR,8/17/2020,502,426,13,941
DECATUR,8/18/2020,510,429,13,952
DECATUR,8/19/2020,512,433,13,958
DECATUR,8/20/2020,517,439,13,969
DECATUR,8/21/2020,521,447,13,981
DECATUR,8/22/2020,524,450,13,987
DECATUR,8/23/2020,529,453,13,995
DECATUR,8/24/2020,534,458,13,1005
DECATUR,8/25/2020,541,461,14,1016
DECATUR,8/26/2020,543,465,15,1023
DECATUR,8/27/2020,553,472,15,1040
DECATUR,8/28/2020,554,474,15,1043
DECATUR,8/29/2020,558,475,15,1048
DECATUR,8/30/2020,560,478,15,1053
DECATUR,8/31/2020,565,481,15,1061
DECATUR,9/1/2020,569,484,16,1069
DECATUR,9/2/2020,570,489,16,1075
DECATUR,9/3/2020,573,491,16,1080
DECATUR,9/4/2020,579,495,16,1090
DECATUR,9/5/2020,580,496,16,1092
DECATUR,9/6/2020,581,496,16,1093
DECATUR,9/7/2020,585,498,16,1099
DECATUR,9/8/2020,587,499,16,1102
DECATUR,9/9/2020,591,503,16,1110
DECATUR,9/10/2020,593,507,16,1116
DECATUR,9/11/2020,596,507,16,1119
DECATUR,9/12/2020,597,509,16,1122
DECATUR,9/13/2020,599,512,16,1127
DECATUR,9/14/2020,600,514,16,1130
DECATUR,9/15/2020,602,518,16,1136
DECATUR,9/16/2020,605,519,16,1140
DECATUR,9/17/2020,610,521,16,1147
DECATUR,9/18/2020,614,522,16,1152
DECATUR,9/19/2020,615,523,16,1154
DECATUR,9/20/2020,616,523,16,1155
DECATUR,9/21/2020,621,527,16,1164
DECATUR,9/22/2020,623,529,16,1168
DECATUR,9/23/2020,626,530,16,1172
DECATUR,9/24/2020,627,536,16,1179
DECATUR,9/25/2020,628,540,16,1184
DECATUR,9/26/2020,631,544,16,1191
DECATUR,9/27/2020,635,545,16,1196
DECATUR,9/28/2020,639,554,17,1210
DECATUR,9/29/2020,644,556,17,1217
DECATUR,9/30/2020,650,559,17,1226
DECATUR,10/1/2020,651,563,18,1232
DECATUR,10/2/2020,653,567,18,1238
DECATUR,10/3/2020,654,567,18,1239
DECATUR,10/4/2020,655,567,18,1240
DECATUR,10/5/2020,657,568,18,1243
DECATUR,10/6/2020,657,568,18,1243
DECATUR,10/7/2020,659,569,18,1246
DECATUR,10/8/2020,659,569,18,1246
DECATUR,10/9/2020,661,570,18,1249
DECATUR,10/10/2020,663,570,18,1251
DECATUR,10/11/2020,663,571,18,1252
DECATUR,10/12/2020,667,574,18,1259
DECATUR,10/13/2020,668,574,18,1260
DECATUR,10/14/2020,670,575,18,1263
EARLY,7/27/2020,212,129,5,346
DECATUR,10/17/2020,670,576,18,1264
EARLY,7/28/2020,212,130,5,347
DOUGHERTY,4/12/2020,863,476,12,1351
DECATUR,10/18/2020,670,576,18,1264
EARLY,7/29/2020,212,130,5,347
DOUGHERTY,4/13/2020,875,483,12,1370
DECATUR,10/19/2020,670,576,18,1264
EARLY,7/30/2020,214,132,5,351
DOUGHERTY,4/14/2020,894,495,12,1401
DECATUR,10/20/2020,670,576,18,1264
EARLY,7/31/2020,217,132,5,354
DOUGHERTY,4/15/2020,909,510,12,1431
DOOLY,1/1/2020,0,0,0,0
DOOLY,1/2/2020,0,0,0,0
DOOLY,1/3/2020,0,0,0,0
DOOLY,1/4/2020,0,0,0,0
DOOLY,1/5/2020,0,0,0,0
DOOLY,1/6/2020,0,0,0,0
DOOLY,1/7/2020,0,0,0,0
DOOLY,1/8/2020,0,0,0,0
DOOLY,1/9/2020,0,0,0,0
DOOLY,1/10/2020,0,0,0,0
DOOLY,1/11/2020,0,0,0,0
DOOLY,1/12/2020,0,0,0,0
DOOLY,1/13/2020,0,0,0,0
DOOLY,1/14/2020,0,0,0,0
DOOLY,1/15/2020,0,0,0,0
DOOLY,1/16/2020,0,0,0,0
DOOLY,1/17/2020,0,0,0,0
DOOLY,1/18/2020,0,0,0,0
DOOLY,1/19/2020,0,0,0,0
DOOLY,1/20/2020,0,0,0,0
DOOLY,1/21/2020,0,0,0,0
DOOLY,1/22/2020,0,0,0,0
DOOLY,1/23/2020,0,0,0,0
DOOLY,1/24/2020,0,0,0,0
DOOLY,1/25/2020,0,0,0,0
DOOLY,1/26/2020,0,0,0,0
DOOLY,1/27/2020,0,0,0,0
DOOLY,1/28/2020,0,0,0,0
DOOLY,1/29/2020,0,0,0,0
DOOLY,1/30/2020,0,0,0,0
DOOLY,1/31/2020,0,0,0,0
DOOLY,2/1/2020,0,0,0,0
DOOLY,2/2/2020,0,0,0,0
DOOLY,2/3/2020,0,0,0,0
DOOLY,2/4/2020,0,0,0,0
DOOLY,2/5/2020,0,0,0,0
DOOLY,2/6/2020,0,0,0,0
DOOLY,2/7/2020,0,0,0,0
DOOLY,2/8/2020,0,0,0,0
DOOLY,2/9/2020,0,0,0,0
DOOLY,2/10/2020,0,0,0,0
DOOLY,2/11/2020,0,0,0,0
DOOLY,2/12/2020,0,0,0,0
DOOLY,2/13/2020,0,0,0,0
DOOLY,2/14/2020,0,0,0,0
DOOLY,2/15/2020,0,0,0,0
DOOLY,2/16/2020,0,0,0,0
DOOLY,2/17/2020,0,0,0,0
DOOLY,2/18/2020,0,0,0,0
DOOLY,2/19/2020,0,0,0,0
DOOLY,2/20/2020,0,0,0,0
DOOLY,2/21/2020,0,0,0,0
DOOLY,2/22/2020,0,0,0,0
DOOLY,2/23/2020,0,0,0,0
DOOLY,2/24/2020,0,0,0,0
DOOLY,2/25/2020,0,0,0,0
DOOLY,2/26/2020,0,0,0,0
DOOLY,2/27/2020,0,0,0,0
DOOLY,2/28/2020,0,0,0,0
DOOLY,2/29/2020,0,0,0,0
DOOLY,3/1/2020,0,0,0,0
DOOLY,3/2/2020,0,0,0,0
DOOLY,3/3/2020,0,0,0,0
DOOLY,3/4/2020,0,0,0,0
DOOLY,3/5/2020,0,0,0,0
DOOLY,3/6/2020,0,0,0,0
DOOLY,3/7/2020,0,0,0,0
DOOLY,3/8/2020,0,0,0,0
DOOLY,3/9/2020,0,0,0,0
DOOLY,3/10/2020,0,0,0,0
DOOLY,3/11/2020,0,0,0,0
DOOLY,3/12/2020,0,0,0,0
DOOLY,3/13/2020,0,0,0,0
DOOLY,3/14/2020,0,0,0,0
DOOLY,3/15/2020,0,0,0,0
DOOLY,3/16/2020,0,0,0,0
DOOLY,3/17/2020,0,0,0,0
DOOLY,3/18/2020,0,1,0,1
DOOLY,3/19/2020,1,1,0,2
DOOLY,3/20/2020,4,1,0,5
DOOLY,3/21/2020,5,2,0,7
DOOLY,3/22/2020,5,3,0,8
DOOLY,3/23/2020,6,5,0,11
DOOLY,3/24/2020,6,5,0,11
DOOLY,3/25/2020,8,6,0,14
DOOLY,3/26/2020,10,6,0,16
DOOLY,3/27/2020,12,6,0,18
DOOLY,3/28/2020,13,6,0,19
DOOLY,3/29/2020,15,6,0,21
DOOLY,3/30/2020,15,8,0,23
DOOLY,3/31/2020,16,8,0,24
DOOLY,4/1/2020,16,10,0,26
DOOLY,4/2/2020,16,13,0,29
DOOLY,4/3/2020,18,14,0,32
DOOLY,4/4/2020,19,14,0,33
DOOLY,4/5/2020,20,14,0,34
DOOLY,4/6/2020,25,17,0,42
DOOLY,4/7/2020,28,19,0,47
DOOLY,4/8/2020,29,21,0,50
DOOLY,4/9/2020,31,21,0,52
DOOLY,4/10/2020,33,24,0,57
DOOLY,4/11/2020,34,25,0,59
DOOLY,4/12/2020,36,29,0,65
DOOLY,4/13/2020,37,33,0,70
DOOLY,4/14/2020,37,35,0,72
DOOLY,4/15/2020,38,35,0,73
DOOLY,4/16/2020,39,36,0,75
DOOLY,4/17/2020,40,38,0,78
DOOLY,4/18/2020,42,39,0,81
DOOLY,4/19/2020,44,39,0,83
DOOLY,4/20/2020,46,41,0,87
DOOLY,4/21/2020,49,43,0,92
DOOLY,4/22/2020,58,60,0,118
DOOLY,4/23/2020,58,60,0,118
DOOLY,4/24/2020,59,61,0,120
DOOLY,4/25/2020,62,61,0,123
DOOLY,4/26/2020,63,61,0,124
DOOLY,4/27/2020,67,62,0,129
DOOLY,4/28/2020,68,65,0,133
DOOLY,4/29/2020,68,66,0,134
DOOLY,4/30/2020,68,66,0,134
DOOLY,5/1/2020,69,67,0,136
DOOLY,5/2/2020,70,68,0,138
DOOLY,5/3/2020,70,68,0,138
DOOLY,5/4/2020,74,71,0,145
DOOLY,5/5/2020,76,71,0,147
DOOLY,5/6/2020,76,71,0,147
DOOLY,5/7/2020,77,71,0,148
DOOLY,5/8/2020,77,73,0,150
DOOLY,5/9/2020,78,73,0,151
DOOLY,5/10/2020,78,74,0,152
DOOLY,5/11/2020,80,76,0,156
DOOLY,5/12/2020,81,76,0,157
DOOLY,5/13/2020,82,77,0,159
DOOLY,5/14/2020,82,77,0,159
DOOLY,5/15/2020,83,78,0,161
DOOLY,5/16/2020,83,78,0,161
DOOLY,5/17/2020,83,78,0,161
DOOLY,5/18/2020,85,79,0,164
DOOLY,5/19/2020,87,82,0,169
DOOLY,5/20/2020,87,82,0,169
DOOLY,5/21/2020,88,82,0,170
DOOLY,5/22/2020,88,82,0,170
DOOLY,5/23/2020,89,83,0,172
DOOLY,5/24/2020,89,84,0,173
DOOLY,5/25/2020,89,85,0,174
DOOLY,5/26/2020,90,87,0,177
DOOLY,5/27/2020,90,89,0,179
DOOLY,5/28/2020,90,89,0,179
DOOLY,5/29/2020,91,89,0,180
DOOLY,5/30/2020,91,89,0,180
DOOLY,5/31/2020,91,89,0,180
DOOLY,6/1/2020,93,91,0,184
DOOLY,6/2/2020,94,92,0,186
DOOLY,6/3/2020,94,93,0,187
DOOLY,6/4/2020,94,93,0,187
DOOLY,6/5/2020,95,95,0,190
DOOLY,6/6/2020,95,95,0,190
DOOLY,6/7/2020,95,95,0,190
DOOLY,6/8/2020,95,96,0,191
DOOLY,6/9/2020,95,98,0,193
DOOLY,6/10/2020,95,98,0,193
DOOLY,6/11/2020,95,98,0,193
DOOLY,6/12/2020,95,98,0,193
DOOLY,6/13/2020,95,98,0,193
DOOLY,6/14/2020,95,98,0,193
DOOLY,6/15/2020,95,98,0,193
DOOLY,6/16/2020,95,98,0,193
DOOLY,6/17/2020,95,99,0,194
DOOLY,6/18/2020,96,100,0,196
DOOLY,6/19/2020,97,101,0,198
DOOLY,6/20/2020,97,103,0,200
DOOLY,6/21/2020,98,103,0,201
DOOLY,6/22/2020,99,105,0,204
DOOLY,6/23/2020,99,105,0,204
DOOLY,6/24/2020,99,105,0,204
DOOLY,6/25/2020,100,106,0,206
DOOLY,6/26/2020,101,108,0,209
DOOLY,6/27/2020,102,108,0,210
DOOLY,6/28/2020,102,108,0,210
DOOLY,6/29/2020,103,110,0,213
DOOLY,6/30/2020,103,110,0,213
DOOLY,7/1/2020,103,113,0,216
DOOLY,7/2/2020,103,114,0,217
DOOLY,7/3/2020,103,114,0,217
DOOLY,7/4/2020,104,115,0,219
DOOLY,7/5/2020,104,115,0,219
DOOLY,7/6/2020,105,117,0,222
DOOLY,7/7/2020,106,118,0,224
DOOLY,7/8/2020,108,118,0,226
DOOLY,7/9/2020,108,118,0,226
DOOLY,7/10/2020,109,118,0,227
DOOLY,7/11/2020,110,119,0,229
DOOLY,7/12/2020,110,119,0,229
DOOLY,7/13/2020,111,119,0,230
DOOLY,7/14/2020,111,120,0,231
DOOLY,7/15/2020,111,121,0,232
DOOLY,7/16/2020,111,122,0,233
DOOLY,7/17/2020,112,123,0,235
DOOLY,7/18/2020,112,123,0,235
DOOLY,7/19/2020,112,123,0,235
DOOLY,7/20/2020,112,123,0,235
DOOLY,7/21/2020,112,124,0,236
DOOLY,7/22/2020,114,124,0,238
DOOLY,7/23/2020,114,124,0,238
DOOLY,7/24/2020,116,124,0,240
DOOLY,7/25/2020,118,126,0,244
DOOLY,7/26/2020,118,126,0,244
DOOLY,7/27/2020,119,126,0,245
DOOLY,7/28/2020,120,127,0,247
DOOLY,7/29/2020,122,127,1,250
DOOLY,7/30/2020,123,129,1,253
DOOLY,7/31/2020,123,129,1,253
DOOLY,8/1/2020,124,129,1,254
DOOLY,8/2/2020,124,131,1,256
DOOLY,8/3/2020,125,133,1,259
DOOLY,8/4/2020,125,135,1,261
DOOLY,8/5/2020,126,135,1,262
DOOLY,8/6/2020,127,135,1,263
DOOLY,8/7/2020,128,135,1,264
DOOLY,8/8/2020,128,135,1,264
DOOLY,8/9/2020,128,135,1,264
DOOLY,8/10/2020,128,135,1,264
DOOLY,8/11/2020,129,136,1,266
DOOLY,8/12/2020,129,137,1,267
DOOLY,8/13/2020,131,138,1,270
DOOLY,8/14/2020,131,138,1,270
DOOLY,8/15/2020,133,139,1,273
DOOLY,8/16/2020,133,139,1,273
DOOLY,8/17/2020,135,142,1,278
DOOLY,8/18/2020,135,142,1,278
DOOLY,8/19/2020,137,142,1,280
DOOLY,8/20/2020,137,142,1,280
DOOLY,8/21/2020,137,143,1,281
DOOLY,8/22/2020,137,143,1,281
DOOLY,8/23/2020,137,143,1,281
DOOLY,8/24/2020,139,145,1,285
DOOLY,8/25/2020,139,145,1,285
DOOLY,8/26/2020,139,145,1,285
DOOLY,8/27/2020,140,145,1,286
DOOLY,8/28/2020,141,145,1,287
DOOLY,8/29/2020,143,145,1,289
DOOLY,8/30/2020,144,146,1,291
DOOLY,8/31/2020,145,146,1,292
DOOLY,9/1/2020,146,147,1,294
DOOLY,9/2/2020,147,149,1,297
DOOLY,9/3/2020,149,149,1,299
DOOLY,9/4/2020,150,151,1,302
DOOLY,9/5/2020,151,151,1,303
DOOLY,9/6/2020,151,152,1,304
DOOLY,9/7/2020,154,152,1,307
DOOLY,9/8/2020,155,153,1,309
DOOLY,9/9/2020,157,153,1,311
DOOLY,9/10/2020,158,154,1,313
DOOLY,9/11/2020,160,156,1,317
DOOLY,9/12/2020,161,158,1,320
DOOLY,9/13/2020,163,159,1,323
DOOLY,9/14/2020,164,161,1,326
DOOLY,9/15/2020,168,162,1,331
DOOLY,9/16/2020,168,165,1,334
DOOLY,9/17/2020,168,165,1,334
DOOLY,9/18/2020,168,165,1,334
DOOLY,9/19/2020,169,165,1,335
DOOLY,9/20/2020,170,167,1,338
DOOLY,9/21/2020,170,168,1,339
DOOLY,9/22/2020,170,169,1,340
DOOLY,9/23/2020,170,169,1,340
DOOLY,9/24/2020,170,169,1,340
DOOLY,9/25/2020,172,169,1,342
DOOLY,9/26/2020,172,169,1,342
DOOLY,9/27/2020,172,169,1,342
DOOLY,9/28/2020,175,170,1,346
DOOLY,9/29/2020,177,171,1,349
DOOLY,9/30/2020,177,171,1,349
DOOLY,10/1/2020,177,171,1,349
DOOLY,10/2/2020,177,171,1,349
DOOLY,10/3/2020,178,172,1,351
DOOLY,10/4/2020,179,172,1,352
DOOLY,10/5/2020,179,172,1,352
DOOLY,10/6/2020,179,172,1,352
DOOLY,10/7/2020,179,173,1,353
DOOLY,10/8/2020,179,173,1,353
DOOLY,10/9/2020,179,173,1,353
DOOLY,10/10/2020,179,173,1,353
DOOLY,10/11/2020,179,174,1,354
DOOLY,10/12/2020,180,174,1,355
DOOLY,10/13/2020,180,175,1,356
DOOLY,10/14/2020,180,177,2,359
DOOLY,10/15/2020,180,177,2,359
DOOLY,10/16/2020,180,177,2,359
DOOLY,10/17/2020,180,177,2,359
DOOLY,10/18/2020,180,177,2,359
DOOLY,10/19/2020,180,177,2,359
DOOLY,10/20/2020,180,177,2,359
DOUGHERTY,1/1/2020,0,0,0,0
DOUGHERTY,1/2/2020,0,0,0,0
DOUGHERTY,1/3/2020,0,0,0,0
DOUGHERTY,1/4/2020,0,0,0,0
DOUGHERTY,1/5/2020,0,0,0,0
DOUGHERTY,1/6/2020,0,0,0,0
DOUGHERTY,1/7/2020,0,0,0,0
DOUGHERTY,1/8/2020,0,0,0,0
DOUGHERTY,1/9/2020,0,0,0,0
DOUGHERTY,1/10/2020,0,0,0,0
DOUGHERTY,1/11/2020,0,0,0,0
DOUGHERTY,1/12/2020,0,0,0,0
DOUGHERTY,1/13/2020,0,0,0,0
DOUGHERTY,1/14/2020,0,0,0,0
DOUGHERTY,1/15/2020,0,0,0,0
DOUGHERTY,1/16/2020,0,0,0,0
DOUGHERTY,1/17/2020,0,0,0,0
DOUGHERTY,1/18/2020,0,0,0,0
DOUGHERTY,1/19/2020,0,0,0,0
DOUGHERTY,1/20/2020,0,0,0,0
DOUGHERTY,1/21/2020,0,0,0,0
DOUGHERTY,1/22/2020,0,0,0,0
DOUGHERTY,1/23/2020,0,0,0,0
DOUGHERTY,1/24/2020,0,0,0,0
DOUGHERTY,1/25/2020,0,0,0,0
DOUGHERTY,1/26/2020,0,0,0,0
DOUGHERTY,1/27/2020,0,0,0,0
DOUGHERTY,1/28/2020,0,0,0,0
DOUGHERTY,1/29/2020,0,0,0,0
DOUGHERTY,1/30/2020,0,0,0,0
DOUGHERTY,1/31/2020,0,0,0,0
DOUGHERTY,2/1/2020,1,0,0,1
DOUGHERTY,2/2/2020,1,0,0,1
DOUGHERTY,2/3/2020,1,0,0,1
DOUGHERTY,2/4/2020,1,0,0,1
DOUGHERTY,2/5/2020,1,0,0,1
DOUGHERTY,2/6/2020,1,0,0,1
DOUGHERTY,2/7/2020,1,0,0,1
DOUGHERTY,2/8/2020,1,0,0,1
DOUGHERTY,2/9/2020,1,0,0,1
DOUGHERTY,2/10/2020,1,0,0,1
DOUGHERTY,2/11/2020,1,0,0,1
DOUGHERTY,2/12/2020,1,0,0,1
DOUGHERTY,2/13/2020,1,0,0,1
DOUGHERTY,2/14/2020,1,2,0,3
DOUGHERTY,2/15/2020,1,2,0,3
DOUGHERTY,2/16/2020,1,2,0,3
DOUGHERTY,2/17/2020,1,2,0,3
DOUGHERTY,2/18/2020,1,2,0,3
DOUGHERTY,2/19/2020,1,2,0,3
DOUGHERTY,2/20/2020,1,2,0,3
DOUGHERTY,2/21/2020,1,2,0,3
DOUGHERTY,2/22/2020,1,2,0,3
DOUGHERTY,2/23/2020,1,2,0,3
DOUGHERTY,2/24/2020,1,2,0,3
DOUGHERTY,2/25/2020,2,2,0,4
DOUGHERTY,2/26/2020,2,3,0,5
DOUGHERTY,2/27/2020,2,4,0,6
DOUGHERTY,2/28/2020,2,4,0,6
DOUGHERTY,2/29/2020,3,4,0,7
DOUGHERTY,3/1/2020,6,6,0,12
DOUGHERTY,3/2/2020,11,7,0,18
DOUGHERTY,3/3/2020,11,8,0,19
DOUGHERTY,3/4/2020,13,10,0,23
DOUGHERTY,3/5/2020,15,10,0,25
DOUGHERTY,3/6/2020,26,13,0,39
DOUGHERTY,3/7/2020,32,15,0,47
DOUGHERTY,3/8/2020,40,17,0,57
DOUGHERTY,3/9/2020,47,19,0,66
DOUGHERTY,3/10/2020,55,21,0,76
DOUGHERTY,3/11/2020,66,22,0,88
DOUGHERTY,3/12/2020,79,27,0,106
DOUGHERTY,3/13/2020,94,39,0,133
DOUGHERTY,3/14/2020,109,46,0,155
DOUGHERTY,3/15/2020,122,55,0,177
DOUGHERTY,3/16/2020,144,68,0,212
DOUGHERTY,3/17/2020,174,83,0,257
DOUGHERTY,3/18/2020,206,93,0,299
DOUGHERTY,3/19/2020,234,118,0,352
DOUGHERTY,3/20/2020,266,136,0,402
DOUGHERTY,3/21/2020,289,149,0,438
DOUGHERTY,3/22/2020,305,164,0,469
DOUGHERTY,3/23/2020,354,188,0,542
DOUGHERTY,3/24/2020,390,211,0,601
DOUGHERTY,3/25/2020,425,241,1,667
DOUGHERTY,3/26/2020,464,259,1,724
DOUGHERTY,3/27/2020,495,275,1,771
DOUGHERTY,3/28/2020,524,292,1,817
DOUGHERTY,3/29/2020,552,302,1,855
DOUGHERTY,3/30/2020,596,325,1,922
DOUGHERTY,3/31/2020,626,336,1,963
DOUGHERTY,4/1/2020,654,353,2,1009
DOUGHERTY,4/2/2020,680,369,3,1052
DOUGHERTY,4/3/2020,700,381,6,1087
DOUGHERTY,4/4/2020,711,392,6,1109
DOUGHERTY,4/5/2020,726,398,6,1130
DOUGHERTY,4/6/2020,757,413,6,1176
DOUGHERTY,4/7/2020,775,423,6,1204
DOUGHERTY,4/8/2020,805,439,10,1254
DOUGHERTY,4/9/2020,825,445,12,1282
EARLY,8/1/2020,218,132,5,355
EARLY,8/2/2020,219,132,5,356
DOUGHERTY,4/16/2020,921,515,12,1448
EARLY,8/3/2020,221,135,5,361
DOUGHERTY,4/17/2020,931,522,13,1466
EARLY,8/4/2020,223,136,5,364
DOUGHERTY,4/18/2020,942,524,15,1481
DOUGHERTY,4/19/2020,944,528,15,1487
DOUGHERTY,4/20/2020,957,533,15,1505
DOUGHERTY,4/21/2020,967,536,17,1520
DOUGHERTY,4/22/2020,977,540,18,1535
DOUGHERTY,4/23/2020,990,546,18,1554
DOUGHERTY,4/24/2020,994,552,18,1564
DOUGHERTY,4/25/2020,998,555,18,1571
DOUGHERTY,4/26/2020,1000,555,18,1573
DOUGHERTY,4/27/2020,1005,558,18,1581
DOUGHERTY,4/28/2020,1008,559,18,1585
DOUGHERTY,4/29/2020,1018,564,20,1602
DOUGHERTY,4/30/2020,1024,566,20,1610
DOUGHERTY,5/1/2020,1033,567,20,1620
DOUGHERTY,5/2/2020,1034,569,20,1623
DOUGHERTY,5/3/2020,1035,571,20,1626
DOUGHERTY,5/4/2020,1040,573,20,1633
DOUGHERTY,5/5/2020,1044,576,20,1640
DOUGHERTY,5/6/2020,1051,581,20,1652
DOUGHERTY,5/7/2020,1055,583,20,1658
DOUGHERTY,5/8/2020,1062,585,20,1667
DOUGHERTY,5/9/2020,1063,586,20,1669
DOUGHERTY,5/10/2020,1067,586,20,1673
DOUGHERTY,5/11/2020,1071,589,20,1680
DOUGHERTY,5/12/2020,1073,591,20,1684
DOUGHERTY,5/13/2020,1074,592,20,1686
DOUGHERTY,5/14/2020,1074,594,20,1688
DOUGHERTY,5/15/2020,1085,603,20,1708
DOUGHERTY,5/16/2020,1088,605,21,1714
DOUGHERTY,5/17/2020,1088,606,21,1715
DOUGHERTY,5/18/2020,1094,611,22,1727
DOUGHERTY,5/19/2020,1103,620,22,1745
DOUGHERTY,5/20/2020,1111,623,22,1756
DOUGHERTY,5/21/2020,1113,628,22,1763
DOUGHERTY,5/22/2020,1117,632,22,1771
DOUGHERTY,5/23/2020,1117,633,22,1772
DOUGHERTY,5/24/2020,1118,633,22,1773
DOUGHERTY,5/25/2020,1120,634,22,1776
DOUGHERTY,5/26/2020,1126,637,22,1785
DOUGHERTY,5/27/2020,1129,637,22,1788
DOUGHERTY,5/28/2020,1130,639,22,1791
DOUGHERTY,5/29/2020,1135,643,22,1800
DOUGHERTY,5/30/2020,1138,646,22,1806
DOUGHERTY,5/31/2020,1139,646,22,1807
DOUGHERTY,6/1/2020,1140,649,22,1811
DOUGHERTY,6/2/2020,1143,650,22,1815
DOUGHERTY,6/3/2020,1146,651,22,1819
DOUGHERTY,6/4/2020,1149,652,22,1823
DOUGHERTY,6/5/2020,1153,657,22,1832
DOUGHERTY,6/6/2020,1154,660,22,1836
DOUGHERTY,6/7/2020,1155,662,22,1839
DOUGHERTY,6/8/2020,1157,666,22,1845
DOUGHERTY,6/9/2020,1157,666,22,1845
DOUGHERTY,6/10/2020,1160,667,22,1849
DOUGHERTY,6/11/2020,1163,667,22,1852
DOUGHERTY,6/12/2020,1165,667,22,1854
DOUGHERTY,6/13/2020,1165,671,22,1858
DOUGHERTY,6/14/2020,1165,672,22,1859
DOUGHERTY,6/15/2020,1168,678,22,1868
DOUGHERTY,6/16/2020,1173,682,22,1877
DOUGHERTY,6/17/2020,1175,686,22,1883
DOUGHERTY,6/18/2020,1179,688,22,1889
DOUGHERTY,6/19/2020,1185,692,22,1899
DOUGHERTY,6/20/2020,1186,695,22,1903
DOUGHERTY,6/21/2020,1190,696,22,1908
DOUGHERTY,6/22/2020,1194,702,22,1918
DOUGHERTY,6/23/2020,1209,708,22,1939
DOUGHERTY,6/24/2020,1215,715,22,1952
DOUGHERTY,6/25/2020,1224,720,22,1966
DOUGHERTY,6/26/2020,1230,727,22,1979
DOUGHERTY,6/27/2020,1237,733,22,1992
DOUGHERTY,6/28/2020,1251,738,22,2011
DOUGHERTY,6/29/2020,1259,742,22,2023
DOUGHERTY,6/30/2020,1283,751,22,2056
DOUGHERTY,7/1/2020,1292,759,22,2073
DOUGHERTY,7/2/2020,1308,766,22,2096
DOUGHERTY,7/3/2020,1321,769,22,2112
DOUGHERTY,7/4/2020,1331,778,22,2131
DOUGHERTY,7/5/2020,1339,785,22,2146
DOUGHERTY,7/6/2020,1357,805,23,2185
DOUGHERTY,7/7/2020,1370,817,23,2210
DOUGHERTY,7/8/2020,1393,826,23,2242
DOUGHERTY,7/9/2020,1400,830,23,2253
DOUGHERTY,7/10/2020,1409,840,23,2272
DOUGHERTY,7/11/2020,1420,844,23,2287
DOUGHERTY,7/12/2020,1433,853,24,2310
DOUGHERTY,7/13/2020,1452,863,24,2339
DOUGHERTY,7/14/2020,1465,875,24,2364
DOUGHERTY,7/15/2020,1478,888,24,2390
DOUGHERTY,7/16/2020,1493,891,24,2408
DOUGHERTY,7/17/2020,1503,905,25,2433
DOUGHERTY,7/18/2020,1514,907,25,2446
DOUGHERTY,7/19/2020,1521,912,25,2458
DOUGHERTY,7/20/2020,1534,920,25,2479
DOUGHERTY,7/21/2020,1546,931,25,2502
DOUGHERTY,7/22/2020,1557,940,25,2522
DOUGHERTY,7/23/2020,1567,954,25,2546
DOUGHERTY,7/24/2020,1570,961,26,2557
DOUGHERTY,7/25/2020,1577,967,26,2570
DOUGHERTY,7/26/2020,1582,967,26,2575
DOUGHERTY,7/27/2020,1596,981,26,2603
DOUGHERTY,7/28/2020,1602,986,26,2614
DOUGHERTY,7/29/2020,1612,992,26,2630
DOUGHERTY,7/30/2020,1624,996,26,2646
DOUGHERTY,7/31/2020,1627,1006,26,2659
DOUGHERTY,8/1/2020,1637,1008,26,2671
DOUGHERTY,8/2/2020,1644,1012,26,2682
DOUGHERTY,8/3/2020,1652,1023,26,2701
DOUGHERTY,8/4/2020,1662,1032,28,2722
DOUGHERTY,8/5/2020,1664,1034,29,2727
DOUGHERTY,8/6/2020,1677,1040,29,2746
DOUGHERTY,8/7/2020,1688,1048,29,2765
DOUGHERTY,8/8/2020,1695,1050,29,2774
DOUGHERTY,8/9/2020,1703,1053,29,2785
DOUGHERTY,8/10/2020,1715,1059,29,2803
DOUGHERTY,8/11/2020,1722,1062,30,2814
DOUGHERTY,8/12/2020,1728,1065,30,2823
DOUGHERTY,8/13/2020,1735,1069,30,2834
DOUGHERTY,8/14/2020,1737,1070,30,2837
DOUGHERTY,8/15/2020,1740,1074,30,2844
DOUGHERTY,8/16/2020,1748,1079,30,2857
DOUGHERTY,8/17/2020,1758,1085,30,2873
DOUGHERTY,8/18/2020,1770,1090,30,2890
DOUGHERTY,8/19/2020,1778,1096,30,2904
DOUGHERTY,8/20/2020,1787,1099,30,2916
DOUGHERTY,8/21/2020,1799,1105,30,2934
DOUGHERTY,8/22/2020,1800,1110,30,2940
DOUGHERTY,8/23/2020,1806,1112,30,2948
DOUGHERTY,8/24/2020,1810,1116,30,2956
DOUGHERTY,8/25/2020,1819,1121,30,2970
DOUGHERTY,8/26/2020,1824,1127,30,2981
DOUGHERTY,8/27/2020,1829,1135,30,2994
DOUGHERTY,8/28/2020,1839,1139,30,3008
DOUGHERTY,8/29/2020,1842,1142,30,3014
DOUGHERTY,8/30/2020,1848,1144,30,3022
DOUGHERTY,8/31/2020,1853,1152,30,3035
DOUGHERTY,9/1/2020,1859,1155,30,3044
DOUGHERTY,9/2/2020,1862,1157,30,3049
DOUGHERTY,9/3/2020,1865,1160,30,3055
DOUGHERTY,9/4/2020,1870,1166,30,3066
DOUGHERTY,9/5/2020,1875,1167,30,3072
DOUGHERTY,9/6/2020,1876,1170,30,3076
DOUGHERTY,9/7/2020,1876,1172,31,3079
DOUGHERTY,9/8/2020,1885,1178,31,3094
DOUGHERTY,9/9/2020,1891,1180,31,3102
DOUGHERTY,9/10/2020,1893,1184,31,3108
DOUGHERTY,9/11/2020,1898,1187,31,3116
DOUGHERTY,9/12/2020,1901,1190,31,3122
DOUGHERTY,9/13/2020,1903,1191,31,3125
DOUGHERTY,9/14/2020,1909,1195,31,3135
DOUGHERTY,9/15/2020,1911,1195,31,3137
DOUGHERTY,9/16/2020,1914,1195,31,3140
DOUGHERTY,9/17/2020,1916,1201,31,3148
DOUGHERTY,9/18/2020,1918,1203,31,3152
DOUGHERTY,9/19/2020,1920,1204,31,3155
DOUGHERTY,9/20/2020,1921,1204,31,3156
DOUGHERTY,9/21/2020,1924,1208,31,3163
DOUGHERTY,9/22/2020,1926,1212,31,3169
DOUGHERTY,9/23/2020,1929,1214,31,3174
DOUGHERTY,9/24/2020,1929,1215,32,3176
DOUGHERTY,9/25/2020,1933,1218,32,3183
DOUGHERTY,9/26/2020,1933,1220,32,3185
DOUGHERTY,9/27/2020,1933,1223,32,3188
DOUGHERTY,9/28/2020,1934,1224,32,3190
DOUGHERTY,9/29/2020,1939,1225,32,3196
DOUGHERTY,9/30/2020,1943,1228,32,3203
DOUGHERTY,10/1/2020,1947,1231,32,3210
DOUGHERTY,10/2/2020,1949,1232,32,3213
DOUGHERTY,10/3/2020,1953,1234,32,3219
DOUGHERTY,10/4/2020,1956,1240,32,3228
DOUGHERTY,10/5/2020,1957,1245,32,3234
DOUGHERTY,10/6/2020,1961,1249,32,3242
DOUGHERTY,10/7/2020,1964,1250,32,3246
DOUGHERTY,10/8/2020,1965,1251,32,3248
DOUGHERTY,10/9/2020,1966,1254,32,3252
DOUGHERTY,10/10/2020,1967,1255,32,3254
DOUGHERTY,10/11/2020,1967,1257,32,3256
DOUGHERTY,10/12/2020,1968,1258,32,3258
DOUGHERTY,10/13/2020,1972,1259,32,3263
DOUGHERTY,10/14/2020,1973,1260,33,3266
DOUGHERTY,10/15/2020,1974,1261,33,3268
DOUGHERTY,10/16/2020,1976,1261,33,3270
DOUGHERTY,10/17/2020,1976,1262,33,3271
DOUGHERTY,10/18/2020,1976,1262,33,3271
DOUGHERTY,10/19/2020,1976,1262,33,3271
DOUGHERTY,10/20/2020,1976,1262,33,3271
EARLY,1/1/2020,0,0,0,0
EARLY,1/2/2020,0,0,0,0
EARLY,1/3/2020,0,0,0,0
EARLY,1/4/2020,0,0,0,0
EARLY,1/5/2020,0,0,0,0
EARLY,1/6/2020,0,0,0,0
EARLY,1/7/2020,0,0,0,0
EARLY,1/8/2020,0,0,0,0
EARLY,1/9/2020,0,0,0,0
EARLY,1/10/2020,0,0,0,0
EARLY,1/11/2020,0,0,0,0
EARLY,1/12/2020,0,0,0,0
EARLY,1/13/2020,0,0,0,0
EARLY,1/14/2020,0,0,0,0
EARLY,1/15/2020,0,0,0,0
EARLY,1/16/2020,0,0,0,0
EARLY,1/17/2020,0,0,0,0
EARLY,1/18/2020,0,0,0,0
EARLY,1/19/2020,0,0,0,0
EARLY,1/20/2020,0,0,0,0
EARLY,1/21/2020,0,0,0,0
EARLY,1/22/2020,0,0,0,0
EARLY,1/23/2020,0,0,0,0
EARLY,1/24/2020,0,0,0,0
EARLY,1/25/2020,0,0,0,0
EARLY,1/26/2020,0,0,0,0
EARLY,1/27/2020,0,0,0,0
EARLY,1/28/2020,0,0,0,0
EARLY,1/29/2020,0,0,0,0
EARLY,1/30/2020,0,0,0,0
EARLY,1/31/2020,0,0,0,0
EARLY,2/1/2020,0,0,0,0
EARLY,2/2/2020,0,0,0,0
EARLY,2/3/2020,0,0,0,0
EARLY,2/4/2020,0,0,0,0
EARLY,2/5/2020,0,0,0,0
EARLY,2/6/2020,0,0,0,0
EARLY,2/7/2020,0,0,0,0
EARLY,2/8/2020,0,0,0,0
EARLY,2/9/2020,0,0,0,0
EARLY,2/10/2020,0,0,0,0
EARLY,2/11/2020,0,0,0,0
EARLY,2/12/2020,0,0,0,0
EARLY,2/13/2020,0,0,0,0
EARLY,2/14/2020,0,0,0,0
EARLY,2/15/2020,0,0,0,0
EARLY,2/16/2020,0,0,0,0
EARLY,2/17/2020,0,0,0,0
EARLY,2/18/2020,0,0,0,0
EARLY,2/19/2020,0,0,0,0
EARLY,2/20/2020,0,0,0,0
EARLY,2/21/2020,0,0,0,0
EARLY,2/22/2020,0,0,0,0
EARLY,2/23/2020,0,0,0,0
EARLY,2/24/2020,0,0,0,0
EARLY,2/25/2020,0,0,0,0
EARLY,2/26/2020,0,0,0,0
EARLY,2/27/2020,0,0,0,0
EARLY,2/28/2020,0,0,0,0
EARLY,2/29/2020,0,0,0,0
EARLY,3/1/2020,1,0,0,1
EARLY,3/2/2020,1,0,0,1
EARLY,3/3/2020,1,1,0,2
EARLY,3/4/2020,1,1,0,2
EARLY,3/5/2020,1,1,0,2
EARLY,3/6/2020,1,1,0,2
EARLY,3/7/2020,1,2,0,3
EARLY,3/8/2020,1,2,0,3
EARLY,3/9/2020,1,2,0,3
EARLY,3/10/2020,1,3,0,4
EARLY,3/11/2020,2,3,0,5
EARLY,3/12/2020,2,3,0,5
EARLY,3/13/2020,2,3,0,5
EARLY,3/14/2020,2,3,0,5
EARLY,3/15/2020,2,4,0,6
EARLY,3/16/2020,3,5,0,8
EARLY,3/17/2020,6,6,0,12
EARLY,3/18/2020,8,8,0,16
EARLY,3/19/2020,8,10,0,18
EARLY,3/20/2020,9,10,0,19
EARLY,3/21/2020,9,12,0,21
EARLY,3/22/2020,10,12,0,22
EARLY,3/23/2020,14,15,0,29
EARLY,3/24/2020,17,19,0,36
EARLY,3/25/2020,22,20,0,42
EARLY,3/26/2020,25,21,0,46
EARLY,3/27/2020,31,21,0,52
EARLY,3/28/2020,32,22,0,54
EARLY,3/29/2020,35,22,0,57
EARLY,3/30/2020,47,25,0,72
EARLY,3/31/2020,54,31,0,85
EARLY,4/1/2020,60,32,0,92
EARLY,4/2/2020,66,33,0,99
EARLY,4/3/2020,70,34,1,105
EARLY,4/4/2020,70,35,2,107
EARLY,4/5/2020,73,37,2,112
EARLY,4/6/2020,80,39,2,121
EARLY,4/7/2020,82,42,2,126
EARLY,4/8/2020,89,45,2,136
EARLY,4/9/2020,93,48,3,144
EARLY,4/10/2020,98,50,3,151
EARLY,4/11/2020,100,50,3,153
EARLY,4/12/2020,100,50,3,153
EARLY,4/13/2020,111,58,3,172
EARLY,4/14/2020,117,58,3,178
EARLY,4/15/2020,121,62,3,186
EARLY,4/16/2020,121,63,3,187
EARLY,4/17/2020,125,63,3,191
EARLY,4/18/2020,126,63,3,192
EARLY,4/19/2020,126,64,3,193
EARLY,4/20/2020,127,65,3,195
EARLY,4/21/2020,129,66,3,198
EARLY,4/22/2020,130,68,3,201
EARLY,4/23/2020,131,68,3,202
EARLY,4/24/2020,131,70,3,204
EARLY,4/25/2020,132,71,3,206
EARLY,4/26/2020,132,71,3,206
EARLY,4/27/2020,133,73,3,209
EARLY,4/28/2020,135,73,3,211
EARLY,4/29/2020,136,73,3,212
EARLY,4/30/2020,137,74,3,214
EARLY,5/1/2020,138,76,3,217
EARLY,5/2/2020,138,76,3,217
EARLY,5/3/2020,138,76,3,217
EARLY,5/4/2020,138,76,3,217
EARLY,5/5/2020,138,78,3,219
EARLY,5/6/2020,138,78,3,219
EARLY,5/7/2020,138,78,3,219
EARLY,5/8/2020,138,79,3,220
EARLY,5/9/2020,141,79,3,223
EARLY,5/10/2020,142,79,3,224
EARLY,5/11/2020,143,79,3,225
EARLY,5/12/2020,144,79,3,226
EARLY,5/13/2020,145,79,3,227
EARLY,5/14/2020,146,80,3,229
EARLY,5/15/2020,147,80,3,230
EARLY,5/16/2020,147,80,3,230
EARLY,5/17/2020,147,80,3,230
EARLY,5/18/2020,149,80,3,232
EARLY,5/19/2020,149,81,3,233
EARLY,5/20/2020,149,81,3,233
EARLY,5/21/2020,149,81,3,233
EARLY,5/22/2020,150,82,3,235
EARLY,5/23/2020,150,82,3,235
EARLY,5/24/2020,150,83,3,236
EARLY,5/25/2020,150,83,3,236
EARLY,5/26/2020,150,85,3,238
EARLY,5/27/2020,150,85,3,238
EARLY,5/28/2020,152,86,3,241
EARLY,5/29/2020,152,87,3,242
EARLY,5/30/2020,153,87,3,243
EARLY,5/31/2020,153,87,3,243
EARLY,6/1/2020,154,88,3,245
EARLY,6/2/2020,155,88,3,246
EARLY,6/3/2020,155,88,3,246
EARLY,6/4/2020,155,88,3,246
EARLY,6/5/2020,156,88,3,247
EARLY,6/6/2020,156,88,3,247
EARLY,6/7/2020,157,88,3,248
EARLY,6/8/2020,157,88,4,249
EARLY,6/9/2020,157,88,4,249
EARLY,6/10/2020,157,89,4,250
EARLY,6/11/2020,157,90,4,251
EARLY,6/12/2020,157,90,4,251
EARLY,6/13/2020,159,90,4,253
EARLY,6/14/2020,159,92,4,255
EARLY,6/15/2020,160,92,4,256
EARLY,6/16/2020,160,92,4,256
EARLY,6/17/2020,161,92,4,257
EARLY,6/18/2020,164,92,4,260
EARLY,6/19/2020,165,92,4,261
EARLY,6/20/2020,165,92,4,261
EARLY,6/21/2020,165,92,4,261
EARLY,6/22/2020,165,93,4,262
EARLY,6/23/2020,165,95,4,264
EARLY,6/24/2020,167,95,4,266
EARLY,6/25/2020,167,95,4,266
EARLY,6/26/2020,168,98,4,270
EARLY,6/27/2020,169,98,4,271
EARLY,6/28/2020,169,99,4,272
EARLY,6/29/2020,172,101,4,277
EARLY,6/30/2020,173,101,4,278
EARLY,7/1/2020,178,101,4,283
EARLY,7/2/2020,181,104,4,289
EARLY,7/3/2020,183,104,4,291
EARLY,7/4/2020,183,106,4,293
EARLY,7/5/2020,184,107,4,295
EARLY,7/6/2020,187,109,4,300
EARLY,7/7/2020,190,111,4,305
EARLY,7/8/2020,190,112,4,306
EARLY,7/9/2020,192,112,4,308
EARLY,7/10/2020,193,114,4,311
EARLY,7/11/2020,193,116,4,313
EARLY,7/12/2020,194,116,4,314
EARLY,7/13/2020,197,118,4,319
EARLY,7/14/2020,200,119,4,323
EARLY,7/15/2020,202,121,4,327
EARLY,7/16/2020,203,122,4,329
EARLY,7/17/2020,205,122,4,331
EARLY,7/18/2020,205,124,4,333
EARLY,7/19/2020,205,124,4,333
EARLY,7/20/2020,205,125,4,334
EARLY,7/21/2020,208,125,4,337
EARLY,7/22/2020,208,125,4,337
EARLY,7/23/2020,210,127,4,341
EARLY,7/24/2020,210,127,4,341
EARLY,8/5/2020,223,136,5,364
EARLY,8/6/2020,226,137,5,368
EARLY,8/7/2020,228,141,5,374
EARLY,8/8/2020,229,141,5,375
EARLY,8/9/2020,231,141,5,377
EARLY,8/10/2020,235,142,5,382
EARLY,8/11/2020,236,144,5,385
EARLY,8/12/2020,240,145,5,390
EARLY,8/13/2020,242,147,5,394
EARLY,8/14/2020,242,147,5,394
EARLY,8/15/2020,245,148,5,398
EARLY,8/16/2020,246,149,5,400
EARLY,8/17/2020,248,149,5,402
EARLY,8/18/2020,249,150,5,404
EARLY,8/19/2020,249,151,5,405
EARLY,8/20/2020,250,152,5,407
EARLY,8/21/2020,251,153,5,409
EARLY,8/22/2020,252,154,5,411
EARLY,8/23/2020,254,154,5,413
EARLY,8/24/2020,256,155,5,416
EARLY,8/25/2020,258,155,5,418
EARLY,8/26/2020,261,156,5,422
EARLY,8/27/2020,261,156,5,422
EARLY,8/28/2020,264,156,5,425
EARLY,8/29/2020,266,156,5,427
EARLY,8/30/2020,266,156,5,427
EARLY,8/31/2020,270,157,5,432
EARLY,9/1/2020,272,157,5,434
EARLY,9/2/2020,273,158,5,436
EARLY,9/3/2020,276,159,5,440
EARLY,9/4/2020,278,159,5,442
EARLY,9/5/2020,280,159,5,444
EARLY,9/6/2020,281,159,5,445
EARLY,9/7/2020,281,159,5,445
EARLY,9/8/2020,285,160,6,451
EARLY,9/9/2020,289,160,6,455
EARLY,9/10/2020,290,162,6,458
EARLY,9/11/2020,292,164,6,462
EARLY,9/12/2020,293,165,6,464
EARLY,9/13/2020,296,166,6,468
EARLY,9/14/2020,297,169,6,472
EARLY,9/15/2020,300,172,6,478
EARLY,9/16/2020,306,172,6,484
EARLY,9/17/2020,306,174,6,486
EARLY,9/18/2020,306,177,6,489
EARLY,9/19/2020,308,180,6,494
EARLY,9/20/2020,309,180,6,495
EARLY,9/21/2020,311,180,6,497
EARLY,9/22/2020,311,182,6,499
EARLY,9/23/2020,314,182,6,502
EARLY,9/24/2020,314,184,6,504
EARLY,9/25/2020,317,186,6,509
EARLY,9/26/2020,318,187,6,511
EARLY,9/27/2020,318,188,6,512
EARLY,9/28/2020,318,189,6,513
EARLY,9/29/2020,320,191,6,517
EARLY,9/30/2020,321,192,6,519
EARLY,10/1/2020,321,192,6,519
EARLY,10/2/2020,321,193,6,520
EARLY,10/3/2020,322,193,6,521
EARLY,10/4/2020,322,193,6,521
EARLY,10/5/2020,322,193,6,521
EARLY,10/6/2020,322,193,6,521
EARLY,10/7/2020,322,193,6,521
EARLY,10/8/2020,324,193,6,523
EARLY,10/9/2020,324,193,6,523
EARLY,10/10/2020,325,194,6,525
EARLY,10/11/2020,325,194,6,525
EARLY,10/12/2020,325,194,6,525
EARLY,10/13/2020,326,197,6,529
EARLY,10/14/2020,326,197,6,529
EARLY,10/15/2020,326,197,6,529
EARLY,10/16/2020,327,198,6,531
EARLY,10/17/2020,327,198,6,531
EARLY,10/18/2020,328,198,6,532
EARLY,10/19/2020,328,198,6,532
EARLY,10/20/2020,328,198,6,532
ECHOLS,1/1/2020,0,0,0,0
ECHOLS,1/2/2020,0,0,0,0
ECHOLS,1/3/2020,0,0,0,0
ECHOLS,1/4/2020,0,0,0,0
ECHOLS,1/5/2020,0,0,0,0
ECHOLS,1/6/2020,0,0,0,0
ECHOLS,1/7/2020,0,0,0,0
ECHOLS,1/8/2020,0,0,0,0
ECHOLS,1/9/2020,0,0,0,0
ECHOLS,1/10/2020,0,0,0,0
ECHOLS,1/11/2020,0,0,0,0
ECHOLS,1/12/2020,0,0,0,0
ECHOLS,1/13/2020,0,0,0,0
ECHOLS,1/14/2020,0,0,0,0
ECHOLS,1/15/2020,0,0,0,0
ECHOLS,1/16/2020,0,0,0,0
ECHOLS,1/17/2020,0,0,0,0
ECHOLS,1/18/2020,0,0,0,0
ECHOLS,1/19/2020,0,0,0,0
ECHOLS,1/20/2020,0,0,0,0
ECHOLS,1/21/2020,0,0,0,0
ECHOLS,1/22/2020,0,0,0,0
ECHOLS,1/23/2020,0,0,0,0
ECHOLS,1/24/2020,0,0,0,0
ECHOLS,1/25/2020,0,0,0,0
ECHOLS,1/26/2020,0,0,0,0
ECHOLS,1/27/2020,0,0,0,0
ECHOLS,1/28/2020,0,0,0,0
ECHOLS,1/29/2020,0,0,0,0
ECHOLS,1/30/2020,0,0,0,0
ECHOLS,1/31/2020,0,0,0,0
ECHOLS,2/1/2020,0,0,0,0
ECHOLS,2/2/2020,0,0,0,0
ECHOLS,2/3/2020,0,0,0,0
ECHOLS,2/4/2020,0,0,0,0
ECHOLS,2/5/2020,0,0,0,0
ECHOLS,2/6/2020,0,0,0,0
ECHOLS,2/7/2020,0,0,0,0
ECHOLS,2/8/2020,0,0,0,0
ECHOLS,2/9/2020,0,0,0,0
ECHOLS,2/10/2020,0,0,0,0
ECHOLS,2/11/2020,0,0,0,0
ECHOLS,2/12/2020,0,0,0,0
ECHOLS,2/13/2020,0,0,0,0
ECHOLS,2/14/2020,0,0,0,0
ECHOLS,2/15/2020,0,0,0,0
ECHOLS,2/16/2020,0,0,0,0
ECHOLS,2/17/2020,0,0,0,0
ECHOLS,2/18/2020,0,0,0,0
ECHOLS,2/19/2020,0,0,0,0
ECHOLS,2/20/2020,0,0,0,0
ECHOLS,2/21/2020,0,0,0,0
ECHOLS,2/22/2020,0,0,0,0
ECHOLS,2/23/2020,0,0,0,0
ECHOLS,2/24/2020,0,0,0,0
ECHOLS,2/25/2020,0,0,0,0
ECHOLS,2/26/2020,0,0,0,0
ECHOLS,2/27/2020,0,0,0,0
ECHOLS,2/28/2020,0,0,0,0
ECHOLS,2/29/2020,0,0,0,0
ECHOLS,3/1/2020,0,0,0,0
ECHOLS,3/2/2020,0,0,0,0
ECHOLS,3/3/2020,0,0,0,0
ECHOLS,3/4/2020,0,0,0,0
ECHOLS,3/5/2020,0,0,0,0
ECHOLS,3/6/2020,0,0,0,0
ECHOLS,3/7/2020,0,0,0,0
ECHOLS,3/8/2020,0,0,0,0
ECHOLS,3/9/2020,0,0,0,0
ECHOLS,3/10/2020,0,0,0,0
ECHOLS,3/11/2020,0,0,0,0
ECHOLS,3/12/2020,0,0,0,0
ECHOLS,3/13/2020,0,0,0,0
ECHOLS,3/14/2020,0,0,0,0
ECHOLS,3/15/2020,0,0,0,0
ECHOLS,3/16/2020,0,0,0,0
ECHOLS,3/17/2020,0,0,0,0
ECHOLS,3/18/2020,0,0,0,0
ECHOLS,3/19/2020,0,0,0,0
ECHOLS,3/20/2020,0,0,0,0
ECHOLS,3/21/2020,1,0,0,1
ECHOLS,3/22/2020,1,0,0,1
ECHOLS,3/23/2020,1,0,0,1
ECHOLS,3/24/2020,1,0,0,1
ECHOLS,3/25/2020,1,0,0,1
ECHOLS,3/26/2020,1,0,0,1
ECHOLS,3/27/2020,1,0,0,1
ECHOLS,3/28/2020,1,0,0,1
ECHOLS,3/29/2020,1,0,0,1
ECHOLS,3/30/2020,1,0,0,1
ECHOLS,3/31/2020,1,0,0,1
ECHOLS,4/1/2020,1,0,0,1
ECHOLS,4/2/2020,1,0,0,1
ECHOLS,4/3/2020,1,0,0,1
ECHOLS,4/4/2020,1,0,0,1
ECHOLS,4/5/2020,1,0,0,1
ECHOLS,4/6/2020,2,0,0,2
ECHOLS,4/7/2020,2,0,0,2
ECHOLS,4/8/2020,2,0,0,2
ECHOLS,4/9/2020,2,0,0,2
ECHOLS,4/10/2020,2,0,0,2
ECHOLS,4/11/2020,2,0,0,2
ECHOLS,4/12/2020,2,0,0,2
ECHOLS,4/13/2020,4,1,0,5
ECHOLS,4/14/2020,4,2,0,6
ECHOLS,4/15/2020,4,2,0,6
ECHOLS,4/16/2020,4,2,0,6
ECHOLS,4/17/2020,4,2,0,6
ECHOLS,4/18/2020,4,2,0,6
ECHOLS,4/19/2020,4,2,0,6
ECHOLS,4/20/2020,4,2,0,6
ECHOLS,4/21/2020,4,2,0,6
ECHOLS,4/22/2020,4,2,0,6
ECHOLS,4/23/2020,4,2,0,6
ECHOLS,4/24/2020,4,2,0,6
ECHOLS,4/25/2020,4,2,0,6
ECHOLS,4/26/2020,4,2,0,6
ECHOLS,4/27/2020,4,2,0,6
ECHOLS,4/28/2020,4,2,0,6
ECHOLS,4/29/2020,4,2,0,6
ECHOLS,4/30/2020,4,2,0,6
ECHOLS,5/1/2020,4,6,0,10
ECHOLS,5/2/2020,4,6,0,10
ECHOLS,5/3/2020,4,8,0,12
ECHOLS,5/4/2020,4,9,0,13
ECHOLS,5/5/2020,4,11,0,15
ECHOLS,5/6/2020,4,13,0,17
ECHOLS,5/7/2020,4,15,0,19
ECHOLS,5/8/2020,6,16,0,22
ECHOLS,5/9/2020,6,16,0,22
ECHOLS,5/10/2020,6,22,0,28
ECHOLS,5/11/2020,9,26,0,35
ECHOLS,5/12/2020,9,39,0,48
ECHOLS,5/13/2020,11,42,1,54
ECHOLS,5/14/2020,12,48,1,61
ECHOLS,5/15/2020,15,66,1,82
ECHOLS,5/16/2020,15,68,1,84
ECHOLS,5/17/2020,16,68,1,85
ECHOLS,5/18/2020,17,75,2,94
ECHOLS,5/19/2020,20,77,2,99
ECHOLS,5/20/2020,22,80,2,104
ECHOLS,5/21/2020,24,84,2,110
ECHOLS,5/22/2020,24,86,2,112
ECHOLS,5/23/2020,24,86,2,112
ECHOLS,5/24/2020,24,87,2,113
ECHOLS,5/25/2020,25,89,2,116
ECHOLS,5/26/2020,26,92,2,120
ECHOLS,5/27/2020,26,92,2,120
ECHOLS,5/28/2020,28,92,2,122
ECHOLS,5/29/2020,28,92,2,122
ECHOLS,5/30/2020,29,92,2,123
ECHOLS,5/31/2020,30,93,2,125
ECHOLS,6/1/2020,30,98,2,130
ECHOLS,6/2/2020,31,101,2,134
ECHOLS,6/3/2020,32,109,2,143
ECHOLS,6/4/2020,32,110,2,144
ECHOLS,6/5/2020,32,111,2,145
ECHOLS,6/6/2020,32,111,2,145
ECHOLS,6/7/2020,33,113,2,148
ECHOLS,6/8/2020,35,114,2,151
ECHOLS,6/9/2020,35,114,2,151
ECHOLS,6/10/2020,37,115,2,154
ECHOLS,6/11/2020,38,117,2,157
ECHOLS,6/12/2020,39,118,2,159
ECHOLS,6/13/2020,40,120,2,162
ECHOLS,6/14/2020,40,120,2,162
ECHOLS,6/15/2020,40,123,2,165
ECHOLS,6/16/2020,41,128,2,171
ECHOLS,6/17/2020,41,129,2,172
ECHOLS,6/18/2020,42,132,2,176
ECHOLS,6/19/2020,43,132,2,177
ECHOLS,6/20/2020,43,132,2,177
ECHOLS,6/21/2020,43,132,2,177
ECHOLS,6/22/2020,43,132,2,177
ECHOLS,6/23/2020,44,132,2,178
ECHOLS,6/24/2020,45,134,2,181
ECHOLS,6/25/2020,45,134,2,181
ECHOLS,6/26/2020,47,134,2,183
ECHOLS,6/27/2020,47,134,2,183
ECHOLS,6/28/2020,49,134,2,185
ECHOLS,6/29/2020,50,134,2,186
ECHOLS,6/30/2020,50,134,2,186
ECHOLS,7/1/2020,52,134,2,188
ECHOLS,7/2/2020,52,135,2,189
ECHOLS,7/3/2020,52,135,2,189
ECHOLS,7/4/2020,53,135,2,190
ECHOLS,7/5/2020,53,135,2,190
ECHOLS,7/6/2020,53,137,2,192
ECHOLS,7/7/2020,54,138,2,194
ECHOLS,7/8/2020,54,139,2,195
ECHOLS,7/9/2020,55,139,2,196
ECHOLS,7/10/2020,56,141,2,199
ECHOLS,7/11/2020,56,143,2,201
ECHOLS,7/12/2020,56,144,2,202
ECHOLS,7/13/2020,57,145,2,204
ECHOLS,7/14/2020,57,145,2,204
ECHOLS,7/15/2020,59,149,2,210
ECHOLS,7/16/2020,60,151,2,213
ECHOLS,7/17/2020,60,151,2,213
ECHOLS,7/18/2020,60,151,2,213
ECHOLS,7/19/2020,60,151,2,213
ECHOLS,7/20/2020,61,151,2,214
ECHOLS,7/21/2020,61,151,2,214
ECHOLS,7/22/2020,61,151,2,214
ECHOLS,7/23/2020,61,151,2,214
ECHOLS,7/24/2020,61,151,2,214
ECHOLS,7/25/2020,62,151,2,215
ECHOLS,7/26/2020,63,151,2,216
ECHOLS,7/27/2020,63,151,2,216
ECHOLS,7/28/2020,63,151,2,216
ECHOLS,7/29/2020,64,152,2,218
ECHOLS,7/30/2020,64,152,2,218
ECHOLS,7/31/2020,65,152,2,219
ECHOLS,8/1/2020,65,153,2,220
ECHOLS,8/2/2020,66,153,2,221
ECHOLS,8/3/2020,66,153,2,221
ECHOLS,8/4/2020,66,153,2,221
ECHOLS,8/5/2020,66,153,2,221
ECHOLS,8/6/2020,66,153,2,221
ECHOLS,8/7/2020,67,154,2,223
ECHOLS,8/8/2020,67,155,2,224
ECHOLS,8/9/2020,67,155,2,224
ECHOLS,8/10/2020,67,155,2,224
ECHOLS,8/11/2020,69,155,2,226
ECHOLS,8/12/2020,69,156,2,227
ECHOLS,8/13/2020,69,156,2,227
ECHOLS,8/14/2020,69,156,2,227
ECHOLS,8/15/2020,69,156,2,227
ECHOLS,8/16/2020,69,156,2,227
ECHOLS,8/17/2020,70,156,2,228
ECHOLS,8/18/2020,70,156,2,228
ECHOLS,8/19/2020,70,156,2,228
ECHOLS,8/20/2020,71,156,2,229
ECHOLS,8/21/2020,71,156,2,229
ECHOLS,8/22/2020,71,156,2,229
ECHOLS,8/23/2020,71,156,2,229
ECHOLS,8/24/2020,72,156,2,230
ECHOLS,8/25/2020,74,158,2,234
ECHOLS,8/26/2020,74,161,2,237
ECHOLS,8/27/2020,74,161,2,237
ECHOLS,8/28/2020,74,161,2,237
ECHOLS,8/29/2020,74,161,2,237
ECHOLS,8/30/2020,74,161,2,237
ECHOLS,8/31/2020,74,161,2,237
ECHOLS,9/1/2020,74,161,2,237
ECHOLS,9/2/2020,74,161,2,237
ECHOLS,9/3/2020,74,161,2,237
ECHOLS,9/4/2020,74,161,2,237
ECHOLS,9/5/2020,74,161,2,237
ECHOLS,9/6/2020,74,161,2,237
ECHOLS,9/7/2020,74,161,2,237
ECHOLS,9/8/2020,74,161,2,237
ECHOLS,9/9/2020,74,161,2,237
ECHOLS,9/10/2020,74,161,2,237
ECHOLS,9/11/2020,74,161,2,237
ECHOLS,9/12/2020,74,161,2,237
ECHOLS,9/13/2020,74,161,2,237
ECHOLS,9/14/2020,74,161,2,237
ECHOLS,9/15/2020,74,161,2,237
ECHOLS,9/16/2020,74,162,2,238
ECHOLS,9/17/2020,74,163,2,239
ECHOLS,9/18/2020,74,163,2,239
ECHOLS,9/19/2020,74,163,2,239
ECHOLS,9/20/2020,74,163,2,239
ECHOLS,9/21/2020,74,163,2,239
ECHOLS,9/22/2020,74,163,2,239
ECHOLS,9/23/2020,74,163,2,239
ECHOLS,9/24/2020,74,163,2,239
ECHOLS,9/25/2020,74,163,2,239
ECHOLS,9/26/2020,74,163,2,239
ECHOLS,9/27/2020,74,163,2,239
ECHOLS,9/28/2020,75,163,2,240
ECHOLS,9/29/2020,75,163,2,240
ECHOLS,9/30/2020,76,164,2,242
ECHOLS,10/1/2020,76,164,2,242
ECHOLS,10/2/2020,76,164,2,242
ECHOLS,10/3/2020,76,164,2,242
ECHOLS,10/4/2020,76,164,2,242
ECHOLS,10/5/2020,76,164,2,242
ECHOLS,10/6/2020,76,164,2,242
ECHOLS,10/7/2020,76,164,2,242
ECHOLS,10/8/2020,76,164,2,242
ECHOLS,10/9/2020,76,164,2,242
ECHOLS,10/10/2020,76,164,2,242
ECHOLS,10/11/2020,77,164,2,243
ECHOLS,10/12/2020,77,164,2,243
ECHOLS,10/13/2020,77,164,2,243
ECHOLS,10/14/2020,77,164,2,243
ECHOLS,10/15/2020,77,164,2,243
ECHOLS,10/16/2020,77,164,2,243
ECHOLS,10/17/2020,77,164,2,243
ECHOLS,10/18/2020,77,164,2,243
ECHOLS,10/19/2020,77,164,2,243
ECHOLS,10/20/2020,77,164,2,243
EMANUEL,1/1/2020,0,0,0,0
EMANUEL,1/2/2020,0,0,0,0
EMANUEL,1/3/2020,0,0,0,0
EMANUEL,1/4/2020,0,0,0,0
EMANUEL,1/5/2020,0,0,0,0
EMANUEL,1/6/2020,0,0,0,0
EMANUEL,1/7/2020,0,0,0,0
EMANUEL,1/8/2020,0,0,0,0
EMANUEL,1/9/2020,0,0,0,0
EMANUEL,1/10/2020,0,0,0,0
EMANUEL,1/11/2020,0,0,0,0
EMANUEL,1/12/2020,0,0,0,0
EMANUEL,1/13/2020,0,0,0,0
EMANUEL,1/14/2020,0,0,0,0
EMANUEL,1/15/2020,0,0,0,0
EMANUEL,1/16/2020,0,0,0,0
EMANUEL,1/17/2020,0,0,0,0
EMANUEL,1/18/2020,0,0,0,0
GORDON,9/11/2020,903,836,22,1761
GLASCOCK,2/12/2020,0,0,0,0
GORDON,9/12/2020,909,839,22,1770
GLASCOCK,2/13/2020,0,0,0,0
GORDON,9/13/2020,913,840,22,1775
GLASCOCK,2/14/2020,0,0,0,0
GORDON,9/14/2020,916,842,23,1781
GLASCOCK,2/15/2020,0,0,0,0
GORDON,9/15/2020,925,845,23,1793
GLASCOCK,2/16/2020,0,0,0,0
GORDON,9/16/2020,938,852,23,1813
GLASCOCK,2/17/2020,0,0,0,0
GORDON,9/17/2020,940,856,23,1819
GLASCOCK,2/18/2020,0,0,0,0
GORDON,9/18/2020,947,858,23,1828
GLASCOCK,2/19/2020,0,0,0,0
EVANS,5/4/2020,4,2,0,6
GORDON,9/19/2020,951,858,23,1832
GLASCOCK,2/20/2020,0,0,0,0
EVANS,5/5/2020,4,2,0,6
EVANS,5/6/2020,4,2,0,6
EVANS,5/7/2020,4,2,0,6
EVANS,5/8/2020,4,2,0,6
EVANS,5/9/2020,4,2,0,6
EVANS,5/10/2020,4,2,0,6
EVANS,5/11/2020,4,2,0,6
EVANS,5/12/2020,4,2,0,6
EVANS,5/13/2020,4,2,0,6
EVANS,5/14/2020,4,2,0,6
EVANS,5/15/2020,4,2,0,6
EVANS,5/16/2020,5,2,0,7
EVANS,5/17/2020,5,2,0,7
EVANS,5/18/2020,5,2,0,7
EVANS,5/19/2020,5,2,0,7
EVANS,5/20/2020,5,2,0,7
EVANS,5/21/2020,5,2,0,7
EVANS,5/22/2020,5,2,0,7
EVANS,5/23/2020,5,2,0,7
EVANS,5/24/2020,5,2,0,7
EVANS,5/25/2020,5,2,0,7
EVANS,5/26/2020,6,2,0,8
EVANS,5/27/2020,6,2,0,8
EVANS,5/28/2020,6,2,0,8
EVANS,5/29/2020,6,2,0,8
EVANS,5/30/2020,6,2,0,8
EVANS,5/31/2020,6,2,0,8
EVANS,6/1/2020,6,2,0,8
EVANS,6/2/2020,6,2,0,8
EVANS,6/3/2020,6,2,0,8
EVANS,6/4/2020,6,2,0,8
EVANS,6/5/2020,6,2,0,8
EVANS,6/6/2020,6,2,0,8
EVANS,6/7/2020,6,3,0,9
EVANS,6/8/2020,7,3,0,10
EVANS,6/9/2020,7,3,0,10
EVANS,6/10/2020,7,5,0,12
EVANS,6/11/2020,7,6,0,13
EVANS,6/12/2020,7,7,0,14
EVANS,6/13/2020,8,7,0,15
EVANS,6/14/2020,8,8,0,16
EVANS,6/15/2020,8,9,0,17
EVANS,6/16/2020,10,9,0,19
EVANS,6/17/2020,11,12,0,23
EVANS,6/18/2020,12,12,0,24
EVANS,6/19/2020,12,12,0,24
EVANS,6/20/2020,12,13,0,25
EVANS,6/21/2020,12,13,0,25
EVANS,6/22/2020,13,16,0,29
EVANS,6/23/2020,13,16,0,29
EVANS,6/24/2020,15,16,0,31
EVANS,6/25/2020,15,17,0,32
EVANS,6/26/2020,16,17,0,33
EVANS,6/27/2020,16,17,0,33
EVANS,6/28/2020,17,18,0,35
EVANS,6/29/2020,21,20,0,41
EVANS,6/30/2020,22,21,0,43
EVANS,7/1/2020,24,23,0,47
EVANS,7/2/2020,25,24,0,49
EVANS,7/3/2020,27,26,0,53
EVANS,7/4/2020,28,26,0,54
EVANS,7/5/2020,33,29,0,62
EVANS,7/6/2020,38,31,0,69
EVANS,7/7/2020,41,33,0,74
EVANS,7/8/2020,44,38,0,82
EVANS,7/9/2020,48,40,0,88
EVANS,7/10/2020,51,43,0,94
EVANS,7/11/2020,52,44,0,96
EVANS,7/12/2020,55,46,0,101
EVANS,7/13/2020,61,48,1,110
EVANS,7/14/2020,68,54,1,123
EVANS,7/15/2020,80,60,2,142
EVANS,7/16/2020,90,65,2,157
EVANS,7/17/2020,94,67,7,168
EVANS,7/18/2020,96,69,7,172
EVANS,7/19/2020,98,71,7,176
EVANS,7/20/2020,106,77,7,190
EVANS,7/21/2020,114,80,12,206
EVANS,7/22/2020,118,85,12,215
EVANS,7/23/2020,120,87,12,219
EVANS,7/24/2020,125,92,12,229
EVANS,7/25/2020,129,95,12,236
EVANS,7/26/2020,132,96,12,240
EVANS,7/27/2020,139,96,12,247
EVANS,7/28/2020,140,102,13,255
EVANS,7/29/2020,141,104,14,259
EVANS,7/30/2020,145,110,16,271
EVANS,7/31/2020,147,111,17,275
EVANS,8/1/2020,148,114,17,279
EVANS,8/2/2020,151,116,17,284
EVANS,8/3/2020,155,117,17,289
EVANS,8/4/2020,156,121,18,295
EVANS,8/5/2020,161,122,19,302
EVANS,8/6/2020,170,125,19,314
EVANS,8/7/2020,177,126,19,322
EVANS,8/8/2020,180,128,19,327
EVANS,8/9/2020,184,128,19,331
EVANS,8/10/2020,188,131,19,338
EVANS,8/11/2020,192,136,19,347
EVANS,8/12/2020,195,139,19,353
EVANS,8/13/2020,195,141,19,355
EVANS,8/14/2020,197,143,19,359
EVANS,8/15/2020,197,143,19,359
EVANS,8/16/2020,197,143,19,359
EVANS,8/17/2020,199,144,20,363
EVANS,8/18/2020,200,144,20,364
EVANS,8/19/2020,204,145,20,369
EVANS,8/20/2020,205,146,21,372
EVANS,8/21/2020,206,147,21,374
EVANS,8/22/2020,207,147,22,376
EVANS,8/23/2020,207,148,22,377
EVANS,8/24/2020,209,150,22,381
EVANS,8/25/2020,211,152,23,386
EVANS,8/26/2020,212,153,23,388
EVANS,8/27/2020,212,153,23,388
EVANS,8/28/2020,212,153,25,390
EVANS,8/29/2020,213,154,25,392
EVANS,8/30/2020,213,154,25,392
EVANS,8/31/2020,213,156,25,394
EVANS,9/1/2020,213,156,25,394
EVANS,9/2/2020,213,158,26,397
EVANS,9/3/2020,213,160,26,399
EVANS,9/4/2020,217,161,26,404
EVANS,9/5/2020,219,162,26,407
EVANS,9/6/2020,220,162,26,408
EVANS,9/7/2020,220,163,26,409
EVANS,9/8/2020,223,166,26,415
EVANS,9/9/2020,223,168,26,417
EVANS,9/10/2020,226,170,26,422
EVANS,9/11/2020,226,170,26,422
EVANS,9/12/2020,226,170,26,422
EVANS,9/13/2020,227,170,26,423
EVANS,9/14/2020,227,171,26,424
EVANS,9/15/2020,227,172,26,425
EVANS,9/16/2020,228,172,26,426
EVANS,9/17/2020,229,172,26,427
EVANS,9/18/2020,231,172,26,429
EVANS,9/19/2020,232,172,26,430
EVANS,9/20/2020,232,172,26,430
EVANS,9/21/2020,233,174,26,433
EVANS,9/22/2020,236,174,26,436
EVANS,9/23/2020,236,176,26,438
EVANS,9/24/2020,238,176,26,440
EVANS,9/25/2020,239,176,26,441
EVANS,9/26/2020,239,177,26,442
EVANS,9/27/2020,239,177,26,442
EVANS,9/28/2020,240,179,26,445
EVANS,9/29/2020,240,179,26,445
EVANS,9/30/2020,240,179,26,445
EVANS,10/1/2020,241,179,26,446
EVANS,10/2/2020,241,179,26,446
EVANS,10/3/2020,241,180,26,447
EVANS,10/4/2020,241,180,26,447
EVANS,10/5/2020,242,181,26,449
EVANS,10/6/2020,242,183,26,451
EVANS,10/7/2020,243,183,26,452
EVANS,10/8/2020,245,184,26,455
EVANS,10/9/2020,246,185,26,457
EVANS,10/10/2020,247,185,26,458
EVANS,10/11/2020,248,186,26,460
EVANS,10/12/2020,249,186,26,461
EVANS,10/13/2020,250,191,26,467
EVANS,10/14/2020,250,191,26,467
EVANS,10/15/2020,251,191,26,468
EVANS,10/16/2020,252,191,26,469
EVANS,10/17/2020,253,192,26,471
EVANS,10/18/2020,253,192,26,471
EVANS,10/19/2020,253,192,26,471
EVANS,10/20/2020,253,192,26,471
FORSYTH,1/1/2020,0,0,0,0
FORSYTH,1/2/2020,0,0,0,0
FORSYTH,1/3/2020,0,0,0,0
FORSYTH,1/4/2020,0,0,0,0
FORSYTH,1/5/2020,0,0,0,0
FORSYTH,1/6/2020,0,0,0,0
FORSYTH,1/7/2020,0,0,0,0
FORSYTH,1/8/2020,0,0,0,0
FORSYTH,1/9/2020,0,0,0,0
FORSYTH,1/10/2020,0,0,0,0
FORSYTH,1/11/2020,0,0,0,0
FORSYTH,1/12/2020,0,0,0,0
FORSYTH,1/13/2020,0,0,0,0
FORSYTH,1/14/2020,0,0,0,0
FORSYTH,1/15/2020,0,0,0,0
FORSYTH,1/16/2020,0,0,0,0
FORSYTH,1/17/2020,0,0,0,0
FORSYTH,1/18/2020,0,0,0,0
FORSYTH,1/19/2020,0,0,0,0
FORSYTH,1/20/2020,0,0,0,0
FORSYTH,1/21/2020,1,0,0,1
FORSYTH,1/22/2020,1,0,0,1
FORSYTH,1/23/2020,1,0,0,1
FORSYTH,1/24/2020,1,0,0,1
FORSYTH,1/25/2020,1,0,0,1
FORSYTH,1/26/2020,1,0,0,1
FORSYTH,1/27/2020,1,0,0,1
FORSYTH,1/28/2020,1,0,0,1
FORSYTH,1/29/2020,1,0,0,1
FORSYTH,1/30/2020,1,0,0,1
FORSYTH,1/31/2020,1,0,0,1
FORSYTH,2/1/2020,1,0,0,1
FORSYTH,2/2/2020,1,0,0,1
FORSYTH,2/3/2020,2,0,0,2
FORSYTH,2/4/2020,2,0,0,2
FORSYTH,2/5/2020,2,0,0,2
FORSYTH,2/6/2020,2,0,0,2
FORSYTH,2/7/2020,2,0,0,2
FORSYTH,2/8/2020,2,0,0,2
FORSYTH,2/9/2020,2,0,0,2
FORSYTH,2/10/2020,2,0,0,2
FORSYTH,2/11/2020,2,0,0,2
FORSYTH,2/12/2020,2,0,0,2
FORSYTH,2/13/2020,2,0,0,2
FORSYTH,2/14/2020,2,0,0,2
FORSYTH,2/15/2020,2,0,0,2
FORSYTH,2/16/2020,2,0,0,2
FORSYTH,2/17/2020,2,0,0,2
FORSYTH,2/18/2020,2,0,0,2
FORSYTH,2/19/2020,2,0,0,2
FORSYTH,2/20/2020,2,0,0,2
FORSYTH,2/21/2020,2,0,0,2
FORSYTH,2/22/2020,2,0,0,2
FORSYTH,2/23/2020,2,0,0,2
FORSYTH,2/24/2020,2,0,0,2
FORSYTH,2/25/2020,2,0,0,2
FORSYTH,2/26/2020,2,0,0,2
FORSYTH,2/27/2020,2,0,0,2
FORSYTH,2/28/2020,2,1,0,3
FORSYTH,2/29/2020,2,1,0,3
FORSYTH,3/1/2020,2,1,0,3
FORSYTH,3/2/2020,2,1,0,3
FORSYTH,3/3/2020,3,1,0,4
FORSYTH,3/4/2020,3,2,0,5
FORSYTH,3/5/2020,3,2,0,5
FORSYTH,3/6/2020,3,2,0,5
FORSYTH,3/7/2020,3,2,0,5
FORSYTH,3/8/2020,3,2,0,5
FORSYTH,3/9/2020,3,4,0,7
FORSYTH,3/10/2020,6,5,0,11
FORSYTH,3/11/2020,7,5,0,12
FORSYTH,3/12/2020,9,8,0,17
FORSYTH,3/13/2020,11,12,0,23
FORSYTH,3/14/2020,14,12,0,26
FORSYTH,3/15/2020,14,17,0,31
FORSYTH,3/16/2020,17,19,0,36
FORSYTH,3/17/2020,18,24,0,42
FORSYTH,3/18/2020,22,26,0,48
FORSYTH,3/19/2020,25,29,0,54
FORSYTH,3/20/2020,31,34,0,65
FORSYTH,3/21/2020,32,35,0,67
FORSYTH,3/22/2020,34,39,0,73
FORSYTH,3/23/2020,36,44,0,80
FORSYTH,3/24/2020,42,49,0,91
FORSYTH,3/25/2020,46,50,1,97
FORSYTH,3/26/2020,49,55,1,105
FORSYTH,3/27/2020,52,57,1,110
FORSYTH,3/28/2020,55,61,1,117
FORSYTH,3/29/2020,57,63,1,121
FORSYTH,3/30/2020,64,65,1,130
FORSYTH,3/31/2020,69,67,1,137
FORSYTH,4/1/2020,73,73,1,147
FORSYTH,4/2/2020,79,75,1,155
FORSYTH,4/3/2020,82,76,1,159
FORSYTH,4/4/2020,83,79,1,163
FORSYTH,4/5/2020,87,81,1,169
FORSYTH,4/6/2020,91,86,1,178
FORSYTH,4/7/2020,94,90,1,185
FORSYTH,4/8/2020,104,95,1,200
FORSYTH,4/9/2020,109,99,1,209
FORSYTH,4/10/2020,113,105,1,219
FORSYTH,4/11/2020,116,109,1,226
FORSYTH,4/12/2020,116,111,1,228
FORSYTH,4/13/2020,125,119,1,245
FORSYTH,4/14/2020,129,122,1,252
FORSYTH,4/15/2020,132,125,1,258
FORSYTH,4/16/2020,137,128,1,266
FORSYTH,4/17/2020,142,133,1,276
FORSYTH,4/18/2020,145,139,1,285
FORSYTH,4/19/2020,146,143,1,290
FORSYTH,4/20/2020,149,152,1,302
FORSYTH,4/21/2020,155,156,1,312
FORSYTH,4/22/2020,160,158,1,319
FORSYTH,4/23/2020,170,165,1,336
FORSYTH,4/24/2020,175,166,1,342
FORSYTH,4/25/2020,179,166,1,346
FORSYTH,4/26/2020,182,167,1,350
FORSYTH,4/27/2020,191,170,1,362
FORSYTH,4/28/2020,197,174,1,372
FORSYTH,4/29/2020,201,176,1,378
FORSYTH,4/30/2020,203,179,1,383
FORSYTH,5/1/2020,205,181,1,387
FORSYTH,5/2/2020,208,184,1,393
FORSYTH,5/3/2020,209,186,1,396
FORSYTH,5/4/2020,212,190,1,403
FORSYTH,5/5/2020,215,195,1,411
FORSYTH,5/6/2020,220,197,1,418
FORSYTH,5/7/2020,223,199,1,423
FORSYTH,5/8/2020,229,202,1,432
FORSYTH,5/9/2020,229,202,1,432
FORSYTH,5/10/2020,229,204,1,434
FORSYTH,5/11/2020,236,213,1,450
FORSYTH,5/12/2020,243,218,1,462
FORSYTH,5/13/2020,245,218,1,464
FORSYTH,5/14/2020,247,221,1,469
FORSYTH,5/15/2020,247,232,1,480
FORSYTH,5/16/2020,250,235,1,486
FORSYTH,5/17/2020,254,240,1,495
FORSYTH,5/18/2020,260,251,1,512
FORSYTH,5/19/2020,261,254,1,516
FORSYTH,5/20/2020,267,260,1,528
FORSYTH,5/21/2020,270,264,1,535
FORSYTH,5/22/2020,271,268,1,540
FORSYTH,5/23/2020,276,271,1,548
FORSYTH,5/24/2020,276,272,1,549
FORSYTH,5/25/2020,279,273,1,553
FORSYTH,5/26/2020,284,277,1,562
FORSYTH,5/27/2020,289,280,1,570
FORSYTH,5/28/2020,290,282,1,573
FORSYTH,5/29/2020,291,282,1,574
FORSYTH,5/30/2020,296,287,1,584
FORSYTH,5/31/2020,296,288,1,585
FORSYTH,6/1/2020,300,296,1,597
FORSYTH,6/2/2020,307,298,1,606
FORSYTH,6/3/2020,314,304,1,619
FORSYTH,6/4/2020,321,308,1,630
FORSYTH,6/5/2020,324,311,1,636
FORSYTH,6/6/2020,327,315,1,643
FORSYTH,6/7/2020,331,320,1,652
FORSYTH,6/8/2020,334,323,1,658
FORSYTH,6/9/2020,339,326,1,666
FORSYTH,6/10/2020,347,328,1,676
FORSYTH,6/11/2020,357,328,1,686
FORSYTH,6/12/2020,364,333,2,699
FORSYTH,6/13/2020,369,336,2,707
FORSYTH,6/14/2020,377,343,2,722
FORSYTH,6/15/2020,388,357,2,747
FORSYTH,6/16/2020,401,363,3,767
FORSYTH,6/17/2020,413,366,3,782
FORSYTH,6/18/2020,421,378,4,803
FORSYTH,6/19/2020,435,394,4,833
FORSYTH,6/20/2020,442,405,4,851
FORSYTH,6/21/2020,451,417,4,872
FORSYTH,6/22/2020,471,433,4,908
FORSYTH,6/23/2020,485,448,4,937
FORSYTH,6/24/2020,509,466,4,979
FORSYTH,6/25/2020,518,483,5,1006
FORSYTH,6/26/2020,530,493,8,1031
FORSYTH,6/27/2020,540,504,8,1052
FORSYTH,6/28/2020,551,518,8,1077
FORSYTH,6/29/2020,574,541,8,1123
FORSYTH,6/30/2020,595,555,9,1159
FORSYTH,7/1/2020,632,577,9,1218
FORSYTH,7/2/2020,660,595,15,1270
FORSYTH,7/3/2020,683,612,16,1311
FORSYTH,7/4/2020,698,629,16,1343
FORSYTH,7/5/2020,724,651,17,1392
FORSYTH,7/6/2020,758,683,20,1461
FORSYTH,7/7/2020,790,709,21,1520
FORSYTH,7/8/2020,824,757,22,1603
FORSYTH,7/9/2020,865,783,23,1671
FORSYTH,7/10/2020,904,823,24,1751
FORSYTH,7/11/2020,927,841,24,1792
FORSYTH,7/12/2020,953,863,26,1842
FORSYTH,7/13/2020,991,900,30,1921
FORSYTH,7/14/2020,1016,923,32,1971
FORSYTH,7/15/2020,1063,953,34,2050
FORSYTH,7/16/2020,1100,986,35,2121
FORSYTH,7/17/2020,1120,1004,35,2159
FORSYTH,7/18/2020,1137,1033,35,2205
FORSYTH,7/19/2020,1155,1045,35,2235
FORSYTH,7/20/2020,1181,1082,37,2300
FORSYTH,7/21/2020,1207,1106,40,2353
FORSYTH,7/22/2020,1231,1141,45,2417
FORSYTH,7/23/2020,1266,1162,46,2474
FORSYTH,7/24/2020,1289,1186,46,2521
FORSYTH,7/25/2020,1303,1197,47,2547
FORSYTH,7/26/2020,1321,1210,47,2578
FORSYTH,7/27/2020,1344,1234,49,2627
FORSYTH,7/28/2020,1367,1253,49,2669
FORSYTH,7/29/2020,1395,1278,51,2724
FORSYTH,7/30/2020,1420,1297,51,2768
FORSYTH,7/31/2020,1436,1316,52,2804
FORSYTH,8/1/2020,1458,1327,52,2837
FORSYTH,8/2/2020,1476,1342,52,2870
FORSYTH,8/3/2020,1500,1374,52,2926
FORSYTH,8/4/2020,1524,1394,53,2971
FORSYTH,8/5/2020,1552,1417,55,3024
FORSYTH,8/6/2020,1570,1433,56,3059
FORSYTH,8/7/2020,1585,1442,57,3084
FORSYTH,8/8/2020,1595,1461,57,3113
FORSYTH,8/9/2020,1613,1472,57,3142
FORSYTH,8/10/2020,1627,1491,58,3176
FORSYTH,8/11/2020,1647,1511,58,3216
FORSYTH,8/12/2020,1657,1528,58,3243
FORSYTH,8/13/2020,1666,1541,58,3265
FORSYTH,8/14/2020,1681,1555,58,3294
FORSYTH,8/15/2020,1688,1564,58,3310
FORSYTH,8/16/2020,1700,1575,58,3333
FORSYTH,8/17/2020,1713,1598,58,3369
GLYNN,5/28/2020,77,62,1,140
FORSYTH,8/18/2020,1726,1618,58,3402
GORDON,9/20/2020,953,860,23,1836
GORDON,9/21/2020,965,865,23,1853
GORDON,9/22/2020,971,869,23,1863
GLASCOCK,2/21/2020,0,0,0,0
GLYNN,5/29/2020,79,67,1,147
FORSYTH,8/19/2020,1745,1638,58,3441
GORDON,9/23/2020,972,874,24,1870
GLASCOCK,2/22/2020,0,0,0,0
GLYNN,5/30/2020,85,74,1,160
FORSYTH,8/20/2020,1767,1650,58,3475
GORDON,9/24/2020,977,877,24,1878
GLASCOCK,2/23/2020,0,0,0,0
GLYNN,5/31/2020,85,75,1,161
FORSYTH,8/21/2020,1783,1668,58,3509
GORDON,9/25/2020,980,881,24,1885
GLASCOCK,2/24/2020,0,0,0,0
GLYNN,6/1/2020,86,79,1,166
FORSYTH,8/22/2020,1795,1681,59,3535
GORDON,9/26/2020,984,887,24,1895
GLASCOCK,2/25/2020,0,0,0,0
GLYNN,6/2/2020,88,85,1,174
GLYNN,6/3/2020,90,90,1,181
GLYNN,6/4/2020,92,91,1,184
GLYNN,6/5/2020,95,93,1,189
GLYNN,6/6/2020,96,96,1,193
GLYNN,6/7/2020,101,97,1,199
GLYNN,6/8/2020,106,102,1,209
GLYNN,6/9/2020,114,109,1,224
GLYNN,6/10/2020,122,113,1,236
GLYNN,6/11/2020,131,119,1,251
GLYNN,6/12/2020,138,124,1,263
GLYNN,6/13/2020,148,130,1,279
GLYNN,6/14/2020,153,139,1,293
GLYNN,6/15/2020,173,155,1,329
GLYNN,6/16/2020,191,183,1,375
GLYNN,6/17/2020,207,204,1,412
GLYNN,6/18/2020,234,239,1,474
GLYNN,6/19/2020,262,259,1,522
GLYNN,6/20/2020,293,283,2,578
GLYNN,6/21/2020,318,296,2,616
GLYNN,6/22/2020,365,343,3,711
GLYNN,6/23/2020,404,386,4,794
GLYNN,6/24/2020,447,426,6,879
GLYNN,6/25/2020,477,454,6,937
GLYNN,6/26/2020,523,501,7,1031
GLYNN,6/27/2020,551,521,8,1080
GLYNN,6/28/2020,559,531,8,1098
GLYNN,6/29/2020,597,586,10,1193
GLYNN,6/30/2020,634,615,12,1261
GLYNN,7/1/2020,669,660,12,1341
GLYNN,7/2/2020,707,687,12,1406
GLYNN,7/3/2020,727,712,12,1451
GLYNN,7/4/2020,748,725,12,1485
GLYNN,7/5/2020,768,740,12,1520
GLYNN,7/6/2020,802,763,13,1578
GLYNN,7/7/2020,858,800,13,1671
GLYNN,7/8/2020,886,821,13,1720
GLYNN,7/9/2020,902,840,13,1755
GLYNN,7/10/2020,926,863,13,1802
GLYNN,7/11/2020,944,879,13,1836
GLYNN,7/12/2020,966,893,13,1872
GLYNN,7/13/2020,994,920,13,1927
GLYNN,7/14/2020,1029,938,13,1980
GLYNN,7/15/2020,1060,958,13,2031
GLYNN,7/16/2020,1074,981,13,2068
GLYNN,7/17/2020,1089,998,13,2100
GLYNN,7/18/2020,1113,1010,13,2136
GLYNN,7/19/2020,1128,1019,13,2160
GLYNN,7/20/2020,1146,1038,13,2197
GLYNN,7/21/2020,1167,1047,13,2227
GLYNN,7/22/2020,1182,1058,13,2253
GLYNN,7/23/2020,1194,1069,13,2276
GLYNN,7/24/2020,1209,1083,13,2305
GLYNN,7/25/2020,1221,1096,13,2330
GLYNN,7/26/2020,1235,1106,13,2354
GLYNN,7/27/2020,1246,1121,14,2381
GLYNN,7/28/2020,1267,1142,14,2423
GLYNN,7/29/2020,1279,1152,14,2445
GLYNN,7/30/2020,1297,1161,14,2472
GLYNN,7/31/2020,1318,1175,14,2507
GLYNN,8/1/2020,1331,1184,14,2529
GLYNN,8/2/2020,1344,1193,14,2551
GLYNN,8/3/2020,1356,1206,14,2576
GLYNN,8/4/2020,1376,1219,14,2609
GLYNN,8/5/2020,1391,1241,14,2646
GLYNN,8/6/2020,1406,1252,14,2672
GLYNN,8/7/2020,1416,1261,14,2691
GLYNN,8/8/2020,1424,1266,14,2704
GLYNN,8/9/2020,1430,1271,14,2715
GLYNN,8/10/2020,1443,1282,14,2739
GLYNN,8/11/2020,1448,1291,14,2753
GLYNN,8/12/2020,1455,1303,14,2772
GLYNN,8/13/2020,1471,1306,14,2791
GLYNN,8/14/2020,1484,1317,14,2815
GLYNN,8/15/2020,1490,1323,14,2827
GLYNN,8/16/2020,1495,1329,14,2838
GLYNN,8/17/2020,1506,1338,14,2858
GLYNN,8/18/2020,1522,1347,14,2883
GLYNN,8/19/2020,1530,1355,14,2899
GLYNN,8/20/2020,1539,1363,14,2916
GLYNN,8/21/2020,1554,1373,14,2941
GLYNN,8/22/2020,1564,1382,14,2960
GLYNN,8/23/2020,1572,1389,14,2975
GLYNN,8/24/2020,1586,1398,14,2998
GLYNN,8/25/2020,1611,1413,15,3039
GLYNN,8/26/2020,1625,1425,15,3065
GLYNN,8/27/2020,1650,1437,15,3102
GLYNN,8/28/2020,1663,1447,15,3125
GLYNN,8/29/2020,1669,1453,15,3137
GLYNN,8/30/2020,1676,1464,15,3155
GLYNN,8/31/2020,1691,1477,15,3183
GLYNN,9/1/2020,1705,1488,15,3208
GLYNN,9/2/2020,1724,1496,15,3235
GLYNN,9/3/2020,1737,1504,15,3256
GLYNN,9/4/2020,1748,1514,15,3277
GLYNN,9/5/2020,1757,1524,15,3296
GLYNN,9/6/2020,1761,1532,15,3308
GLYNN,9/7/2020,1769,1539,15,3323
GLYNN,9/8/2020,1781,1547,15,3343
GLYNN,9/9/2020,1791,1550,15,3356
GLYNN,9/10/2020,1795,1554,15,3364
GLYNN,9/11/2020,1801,1554,15,3370
GLYNN,9/12/2020,1803,1557,15,3375
GLYNN,9/13/2020,1812,1561,15,3388
GLYNN,9/14/2020,1822,1570,15,3407
GLYNN,9/15/2020,1830,1574,15,3419
GLYNN,9/16/2020,1832,1576,15,3423
GLYNN,9/17/2020,1840,1580,15,3435
GLYNN,9/18/2020,1843,1582,15,3440
GLYNN,9/19/2020,1847,1583,15,3445
GLYNN,9/20/2020,1849,1588,15,3452
GLYNN,9/21/2020,1857,1589,15,3461
GLYNN,9/22/2020,1860,1591,15,3466
GLYNN,9/23/2020,1864,1595,15,3474
GLYNN,9/24/2020,1867,1598,15,3480
GLYNN,9/25/2020,1873,1602,15,3490
GLYNN,9/26/2020,1881,1605,15,3501
GLYNN,9/27/2020,1883,1608,15,3506
GLYNN,9/28/2020,1893,1613,15,3521
GLYNN,9/29/2020,1896,1616,15,3527
GLYNN,9/30/2020,1901,1616,15,3532
GLYNN,10/1/2020,1904,1619,15,3538
GLYNN,10/2/2020,1909,1620,15,3544
GLYNN,10/3/2020,1911,1622,15,3548
GLYNN,10/4/2020,1914,1623,15,3552
GLYNN,10/5/2020,1916,1626,15,3557
GLYNN,10/6/2020,1919,1627,15,3561
GLYNN,10/7/2020,1923,1628,15,3566
GLYNN,10/8/2020,1928,1635,15,3578
GLYNN,10/9/2020,1934,1640,15,3589
GLYNN,10/10/2020,1941,1643,15,3599
GLYNN,10/11/2020,1944,1644,15,3603
GLYNN,10/12/2020,1952,1647,15,3614
GLYNN,10/13/2020,1953,1652,15,3620
GLYNN,10/14/2020,1958,1654,15,3627
GLYNN,10/15/2020,1962,1659,15,3636
GLYNN,10/16/2020,1964,1661,15,3640
GLYNN,10/17/2020,1964,1661,15,3640
GLYNN,10/18/2020,1964,1661,15,3640
GLYNN,10/19/2020,1964,1661,15,3640
GLYNN,10/20/2020,1964,1661,15,3640
GORDON,1/1/2020,0,0,0,0
GORDON,1/2/2020,0,0,0,0
GORDON,1/3/2020,0,0,0,0
GORDON,1/4/2020,0,0,0,0
GORDON,1/5/2020,0,0,0,0
GORDON,1/6/2020,0,0,0,0
GORDON,1/7/2020,0,0,0,0
GORDON,1/8/2020,0,0,0,0
GORDON,1/9/2020,0,0,0,0
GORDON,1/10/2020,0,0,0,0
GORDON,1/11/2020,0,0,0,0
GORDON,1/12/2020,0,0,0,0
GORDON,1/13/2020,0,0,0,0
GORDON,1/14/2020,0,0,0,0
GORDON,1/15/2020,0,0,0,0
GORDON,1/16/2020,0,0,0,0
GORDON,1/17/2020,0,0,0,0
GORDON,1/18/2020,0,0,0,0
GORDON,1/19/2020,0,0,0,0
GORDON,1/20/2020,0,0,0,0
GORDON,1/21/2020,0,0,0,0
GORDON,1/22/2020,0,0,0,0
GORDON,1/23/2020,0,0,0,0
GORDON,1/24/2020,0,0,0,0
GORDON,1/25/2020,0,0,0,0
GORDON,1/26/2020,0,0,0,0
GORDON,1/27/2020,0,0,0,0
GORDON,1/28/2020,0,0,0,0
GORDON,1/29/2020,0,0,0,0
GORDON,1/30/2020,0,0,0,0
GORDON,1/31/2020,0,0,0,0
GORDON,2/1/2020,0,0,0,0
GORDON,2/2/2020,0,0,0,0
GORDON,2/3/2020,0,0,0,0
GORDON,2/4/2020,0,0,0,0
GORDON,2/5/2020,0,0,0,0
GORDON,2/6/2020,0,0,0,0
GORDON,2/7/2020,0,0,0,0
GORDON,2/8/2020,0,0,0,0
GORDON,2/9/2020,0,0,0,0
GORDON,2/10/2020,0,0,0,0
GORDON,2/11/2020,0,0,0,0
GORDON,2/12/2020,0,0,0,0
GORDON,2/13/2020,0,0,0,0
GORDON,2/14/2020,0,0,0,0
GORDON,2/15/2020,0,0,0,0
GORDON,2/16/2020,0,0,0,0
GORDON,2/17/2020,0,0,0,0
GORDON,2/18/2020,0,0,0,0
GORDON,2/19/2020,0,0,0,0
GORDON,2/20/2020,0,0,0,0
GORDON,2/21/2020,0,0,0,0
GORDON,2/22/2020,0,0,0,0
GORDON,2/23/2020,0,0,0,0
GORDON,2/24/2020,0,0,0,0
GORDON,2/25/2020,0,0,0,0
GORDON,2/26/2020,0,0,0,0
GORDON,2/27/2020,0,0,0,0
GORDON,2/28/2020,1,0,0,1
GORDON,2/29/2020,1,0,0,1
GORDON,3/1/2020,2,1,0,3
GORDON,3/2/2020,2,1,0,3
GORDON,3/3/2020,3,1,0,4
GORDON,3/4/2020,4,1,0,5
GORDON,3/5/2020,4,1,0,5
GORDON,3/6/2020,4,3,0,7
GORDON,3/7/2020,4,3,0,7
GORDON,3/8/2020,4,3,0,7
GORDON,3/9/2020,4,3,0,7
GORDON,3/10/2020,4,4,0,8
GORDON,3/11/2020,4,5,0,9
GORDON,3/12/2020,5,7,0,12
GORDON,3/13/2020,5,7,0,12
GORDON,3/14/2020,5,8,0,13
GORDON,3/15/2020,6,8,0,14
GORDON,3/16/2020,7,8,0,15
GORDON,3/17/2020,8,10,0,18
GORDON,3/18/2020,8,11,0,19
GORDON,3/19/2020,9,12,0,21
GORDON,3/20/2020,9,14,0,23
GORDON,3/21/2020,9,15,0,24
GORDON,3/22/2020,9,15,0,24
GORDON,3/23/2020,9,16,0,25
GORDON,3/24/2020,9,17,0,26
GORDON,3/25/2020,9,17,0,26
GORDON,3/26/2020,9,17,0,26
GORDON,3/27/2020,10,17,0,27
GORDON,3/28/2020,10,17,0,27
GORDON,3/29/2020,10,17,0,27
GORDON,3/30/2020,11,18,0,29
GORDON,3/31/2020,12,18,0,30
GORDON,4/1/2020,13,19,0,32
GORDON,4/2/2020,13,20,0,33
GORDON,4/3/2020,13,20,0,33
GORDON,4/4/2020,14,21,0,35
GORDON,4/5/2020,14,22,0,36
GORDON,4/6/2020,15,23,0,38
GORDON,4/7/2020,16,23,0,39
GORDON,4/8/2020,25,25,0,50
GORDON,4/9/2020,27,25,0,52
GORDON,4/10/2020,31,25,0,56
GORDON,4/11/2020,32,25,0,57
GORDON,4/12/2020,33,26,0,59
GORDON,4/13/2020,33,27,0,60
GORDON,4/14/2020,35,29,0,64
GORDON,4/15/2020,38,30,0,68
GORDON,4/16/2020,40,30,0,70
GORDON,4/17/2020,44,32,0,76
GORDON,4/18/2020,45,34,0,79
GORDON,4/19/2020,45,34,0,79
GORDON,4/20/2020,46,34,0,80
GORDON,4/21/2020,48,36,0,84
GORDON,4/22/2020,50,37,0,87
GORDON,4/23/2020,53,37,0,90
GORDON,4/24/2020,55,40,0,95
GORDON,4/25/2020,55,40,1,96
GORDON,4/26/2020,56,41,1,98
GORDON,4/27/2020,70,46,1,117
GORDON,4/28/2020,71,47,1,119
GORDON,4/29/2020,72,49,1,122
GORDON,4/30/2020,73,50,1,124
GORDON,5/1/2020,73,50,1,124
GORDON,5/2/2020,73,50,1,124
GORDON,5/3/2020,75,50,1,126
GORDON,5/4/2020,75,52,1,128
GORDON,5/5/2020,75,52,1,128
GORDON,5/6/2020,75,52,1,128
GORDON,5/7/2020,75,53,1,129
GORDON,5/8/2020,77,54,1,132
GORDON,5/9/2020,77,55,1,133
GORDON,5/10/2020,77,56,1,134
GORDON,5/11/2020,77,57,1,135
GORDON,5/12/2020,79,57,1,137
GORDON,5/13/2020,80,58,1,139
GORDON,5/14/2020,80,59,1,140
GORDON,5/15/2020,80,60,1,141
GORDON,5/16/2020,81,60,1,142
GORDON,5/17/2020,81,61,1,143
GORDON,5/18/2020,81,62,1,144
GORDON,5/19/2020,82,62,1,145
GORDON,5/20/2020,82,62,1,145
GORDON,5/21/2020,82,64,1,147
GORDON,5/22/2020,84,64,1,149
GORDON,5/23/2020,85,64,1,150
GORDON,5/24/2020,85,69,1,155
GORDON,5/25/2020,87,71,1,159
GORDON,5/26/2020,89,73,1,163
GORDON,5/27/2020,94,76,1,171
GORDON,5/28/2020,100,83,1,184
GORDON,5/29/2020,102,86,1,189
GORDON,5/30/2020,104,88,1,193
GORDON,5/31/2020,105,90,1,196
GORDON,6/1/2020,112,94,1,207
GORDON,6/2/2020,120,97,1,218
GORDON,6/3/2020,124,99,1,224
GORDON,6/4/2020,127,109,1,237
GORDON,6/5/2020,131,114,1,246
GORDON,6/6/2020,135,118,1,254
GORDON,6/7/2020,136,121,1,258
GORDON,6/8/2020,143,124,1,268
GORDON,6/9/2020,145,127,1,273
GORDON,6/10/2020,152,130,1,283
GORDON,6/11/2020,154,133,1,288
GORDON,6/12/2020,157,135,1,293
GORDON,6/13/2020,160,136,1,297
GORDON,6/14/2020,162,138,1,301
GORDON,6/15/2020,167,142,1,310
GORDON,6/16/2020,168,147,1,316
GORDON,6/17/2020,173,154,2,329
GORDON,6/18/2020,178,157,4,339
GORDON,6/19/2020,181,159,4,344
GORDON,6/20/2020,188,160,4,352
GORDON,6/21/2020,193,164,4,361
GORDON,6/22/2020,199,168,4,371
GORDON,6/23/2020,208,178,4,390
GORDON,6/24/2020,215,188,6,409
GORDON,6/25/2020,223,195,6,424
GORDON,6/26/2020,233,209,6,448
GORDON,6/27/2020,239,214,7,460
GORDON,6/28/2020,244,218,7,469
GORDON,6/29/2020,253,231,8,492
GORDON,6/30/2020,262,242,8,512
GORDON,7/1/2020,275,251,10,536
GORDON,7/2/2020,286,262,11,559
GORDON,7/3/2020,290,270,11,571
GORDON,7/4/2020,292,275,11,578
GORDON,7/5/2020,299,280,11,590
GORDON,7/6/2020,309,307,11,627
GORDON,7/7/2020,324,317,11,652
GORDON,7/8/2020,347,323,12,682
GORDON,7/9/2020,361,332,12,705
GORDON,7/10/2020,369,343,12,724
GORDON,7/11/2020,376,349,12,737
GORDON,7/12/2020,383,355,12,750
GORDON,7/13/2020,399,370,12,781
GORDON,7/14/2020,407,381,12,800
GORDON,7/15/2020,416,391,12,819
GORDON,7/16/2020,432,402,12,846
GORDON,7/17/2020,447,413,12,872
GORDON,7/18/2020,465,422,12,899
GORDON,7/19/2020,472,425,12,909
GORDON,7/20/2020,488,438,13,939
GORDON,7/21/2020,507,454,13,974
GORDON,7/22/2020,519,469,15,1003
GORDON,7/23/2020,531,478,15,1024
GORDON,7/24/2020,541,486,15,1042
GORDON,7/25/2020,553,496,15,1064
GORDON,7/26/2020,562,497,15,1074
GORDON,7/27/2020,580,510,15,1105
GORDON,7/28/2020,600,522,15,1137
GORDON,7/29/2020,615,533,15,1163
GORDON,7/30/2020,625,544,15,1184
GORDON,7/31/2020,636,555,15,1206
GORDON,8/1/2020,639,559,15,1213
GORDON,8/2/2020,646,566,15,1227
GORDON,8/3/2020,657,578,15,1250
GORDON,8/4/2020,669,606,15,1290
GORDON,8/5/2020,672,621,15,1308
GORDON,8/6/2020,676,626,16,1318
GORDON,8/7/2020,682,637,16,1335
GORDON,8/8/2020,687,642,17,1346
GORDON,8/9/2020,689,650,17,1356
GORDON,8/10/2020,698,659,17,1374
GORDON,8/11/2020,708,663,17,1388
GORDON,8/12/2020,716,670,17,1403
GORDON,8/13/2020,726,678,17,1421
GORDON,8/14/2020,732,685,17,1434
GORDON,8/15/2020,740,688,17,1445
GORDON,8/16/2020,748,694,17,1459
GORDON,8/17/2020,757,705,17,1479
GORDON,8/18/2020,761,712,17,1490
GORDON,8/19/2020,766,716,17,1499
GORDON,8/20/2020,769,718,17,1504
GORDON,8/21/2020,773,724,17,1514
GORDON,8/22/2020,777,725,17,1519
GORDON,8/23/2020,782,727,17,1526
GORDON,8/24/2020,786,733,17,1536
GORDON,8/25/2020,793,742,17,1552
GORDON,8/26/2020,801,746,17,1564
GORDON,8/27/2020,810,754,17,1581
GORDON,8/28/2020,817,760,17,1594
GORDON,8/29/2020,822,765,17,1604
GORDON,8/30/2020,823,770,18,1611
GORDON,8/31/2020,832,775,18,1625
GORDON,9/1/2020,840,781,18,1639
GORDON,9/2/2020,843,783,18,1644
GORDON,9/3/2020,849,793,19,1661
GORDON,9/4/2020,856,797,19,1672
GORDON,9/5/2020,863,802,19,1684
GORDON,9/6/2020,868,807,19,1694
GORDON,9/7/2020,873,812,19,1704
GORDON,9/8/2020,880,821,21,1722
GORDON,9/9/2020,888,824,21,1733
GORDON,9/10/2020,899,831,22,1752
GLASCOCK,2/26/2020,0,0,0,0
GORDON,9/27/2020,990,888,25,1903
GORDON,9/28/2020,992,891,25,1908
FORSYTH,8/23/2020,1807,1694,59,3560
GLASCOCK,2/27/2020,0,0,0,0
GORDON,9/29/2020,998,896,25,1919
FORSYTH,8/24/2020,1831,1709,59,3599
FORSYTH,8/25/2020,1849,1723,59,3631
FORSYTH,8/26/2020,1868,1735,59,3662
FORSYTH,8/27/2020,1893,1746,60,3699
FORSYTH,8/28/2020,1912,1758,60,3730
FORSYTH,8/29/2020,1927,1765,60,3752
FORSYTH,8/30/2020,1936,1777,60,3773
FORSYTH,8/31/2020,1953,1797,60,3810
FORSYTH,9/1/2020,1972,1812,60,3844
FORSYTH,9/2/2020,1992,1824,60,3876
FORSYTH,9/3/2020,2008,1843,60,3911
FORSYTH,9/4/2020,2020,1856,60,3936
FORSYTH,9/5/2020,2035,1863,60,3958
FORSYTH,9/6/2020,2042,1872,60,3974
FORSYTH,9/7/2020,2049,1883,60,3992
FORSYTH,9/8/2020,2061,1901,60,4022
FORSYTH,9/9/2020,2078,1915,60,4053
FORSYTH,9/10/2020,2088,1923,61,4072
FORSYTH,9/11/2020,2094,1939,61,4094
FORSYTH,9/12/2020,2101,1949,61,4111
FORSYTH,9/13/2020,2109,1958,61,4128
FORSYTH,9/14/2020,2114,1967,61,4142
FORSYTH,9/15/2020,2119,1974,61,4154
FORSYTH,9/16/2020,2131,1983,61,4175
FORSYTH,9/17/2020,2135,1990,61,4186
FORSYTH,9/18/2020,2140,2000,61,4201
FORSYTH,9/19/2020,2146,2006,61,4213
FORSYTH,9/20/2020,2154,2011,61,4226
FORSYTH,9/21/2020,2161,2018,61,4240
FORSYTH,9/22/2020,2166,2022,61,4249
FORSYTH,9/23/2020,2171,2034,61,4266
FORSYTH,9/24/2020,2176,2046,61,4283
FORSYTH,9/25/2020,2183,2052,61,4296
FORSYTH,9/26/2020,2193,2056,61,4310
FORSYTH,9/27/2020,2197,2067,62,4326
FORSYTH,9/28/2020,2206,2075,62,4343
FORSYTH,9/29/2020,2217,2079,62,4358
FORSYTH,9/30/2020,2226,2087,62,4375
FORSYTH,10/1/2020,2239,2096,62,4397
FORSYTH,10/2/2020,2250,2106,63,4419
FORSYTH,10/3/2020,2259,2107,63,4429
FORSYTH,10/4/2020,2265,2114,63,4442
FORSYTH,10/5/2020,2269,2119,64,4452
FORSYTH,10/6/2020,2272,2125,64,4461
FORSYTH,10/7/2020,2281,2133,65,4479
FORSYTH,10/8/2020,2284,2142,65,4491
FORSYTH,10/9/2020,2291,2149,65,4505
FORSYTH,10/10/2020,2295,2153,66,4514
FORSYTH,10/11/2020,2299,2156,66,4521
FORSYTH,10/12/2020,2303,2165,68,4536
FORSYTH,10/13/2020,2304,2171,68,4543
FORSYTH,10/14/2020,2311,2173,68,4552
FORSYTH,10/15/2020,2314,2179,68,4561
FORSYTH,10/16/2020,2317,2183,68,4568
FORSYTH,10/17/2020,2321,2185,68,4574
FORSYTH,10/18/2020,2321,2186,68,4575
FORSYTH,10/19/2020,2321,2186,68,4575
FORSYTH,10/20/2020,2321,2186,68,4575
GILMER,1/1/2020,0,0,0,0
GILMER,1/2/2020,0,0,0,0
GILMER,1/3/2020,0,0,0,0
GILMER,1/4/2020,0,0,0,0
GILMER,1/5/2020,0,0,0,0
GILMER,1/6/2020,0,0,0,0
GILMER,1/7/2020,0,0,0,0
GILMER,1/8/2020,0,0,0,0
GILMER,1/9/2020,0,0,0,0
GILMER,1/10/2020,0,0,0,0
GILMER,1/11/2020,0,0,0,0
GILMER,1/12/2020,0,0,0,0
GILMER,1/13/2020,0,0,0,0
GILMER,1/14/2020,0,0,0,0
GILMER,1/15/2020,0,0,0,0
GILMER,1/16/2020,0,0,0,0
GILMER,1/17/2020,0,0,0,0
GILMER,1/18/2020,0,0,0,0
GILMER,1/19/2020,0,0,0,0
GILMER,1/20/2020,0,0,0,0
GILMER,1/21/2020,0,0,0,0
GILMER,1/22/2020,0,0,0,0
GILMER,1/23/2020,0,0,0,0
GILMER,1/24/2020,0,0,0,0
GILMER,1/25/2020,0,0,0,0
GILMER,1/26/2020,0,0,0,0
GILMER,1/27/2020,0,0,0,0
GILMER,1/28/2020,0,0,0,0
GILMER,1/29/2020,0,0,0,0
GILMER,1/30/2020,0,0,0,0
GILMER,1/31/2020,0,0,0,0
GILMER,2/1/2020,0,0,0,0
GILMER,2/2/2020,0,0,0,0
GILMER,2/3/2020,0,0,0,0
GILMER,2/4/2020,0,0,0,0
GILMER,2/5/2020,0,0,0,0
GILMER,2/6/2020,0,0,0,0
GILMER,2/7/2020,0,0,0,0
GILMER,2/8/2020,0,0,0,0
GILMER,2/9/2020,0,0,0,0
GILMER,2/10/2020,0,0,0,0
GILMER,2/11/2020,0,0,0,0
GILMER,2/12/2020,0,0,0,0
GILMER,2/13/2020,0,0,0,0
GILMER,2/14/2020,0,1,0,1
GILMER,2/15/2020,0,1,0,1
GILMER,2/16/2020,0,1,0,1
GILMER,2/17/2020,0,1,0,1
GILMER,2/18/2020,0,1,0,1
GILMER,2/19/2020,0,1,0,1
GILMER,2/20/2020,0,1,0,1
GILMER,2/21/2020,0,1,0,1
GILMER,2/22/2020,0,1,0,1
GILMER,2/23/2020,0,1,0,1
GILMER,2/24/2020,0,1,0,1
GILMER,2/25/2020,0,1,0,1
GILMER,2/26/2020,0,1,0,1
GILMER,2/27/2020,0,1,0,1
GILMER,2/28/2020,0,1,0,1
GILMER,2/29/2020,0,1,0,1
GILMER,3/1/2020,0,1,0,1
GILMER,3/2/2020,0,1,0,1
GILMER,3/3/2020,0,1,0,1
GILMER,3/4/2020,0,2,0,2
GILMER,3/5/2020,0,2,0,2
GILMER,3/6/2020,0,2,0,2
GILMER,3/7/2020,0,2,0,2
GILMER,3/8/2020,0,2,0,2
GILMER,3/9/2020,0,2,0,2
GILMER,3/10/2020,0,2,0,2
GILMER,3/11/2020,0,2,0,2
GILMER,3/12/2020,0,2,0,2
GILMER,3/13/2020,0,2,0,2
GILMER,3/14/2020,0,2,0,2
GILMER,3/15/2020,0,2,0,2
GILMER,3/16/2020,0,2,0,2
GILMER,3/17/2020,0,3,0,3
GILMER,3/18/2020,0,3,0,3
GILMER,3/19/2020,0,3,0,3
GILMER,3/20/2020,0,3,0,3
GILMER,3/21/2020,0,3,0,3
GILMER,3/22/2020,0,3,0,3
GILMER,3/23/2020,0,3,0,3
GILMER,3/24/2020,1,3,0,4
GILMER,3/25/2020,1,3,0,4
GILMER,3/26/2020,1,3,0,4
GILMER,3/27/2020,1,4,0,5
GILMER,3/28/2020,1,4,0,5
GILMER,3/29/2020,1,4,0,5
GILMER,3/30/2020,1,4,0,5
GILMER,3/31/2020,1,4,0,5
GILMER,4/1/2020,1,5,0,6
GILMER,4/2/2020,2,5,0,7
GILMER,4/3/2020,2,5,0,7
GILMER,4/4/2020,2,5,0,7
GILMER,4/5/2020,3,6,0,9
GILMER,4/6/2020,3,7,0,10
GILMER,4/7/2020,4,7,0,11
GILMER,4/8/2020,4,7,0,11
GILMER,4/9/2020,5,7,0,12
GILMER,4/10/2020,5,9,0,14
GILMER,4/11/2020,6,10,0,16
GILMER,4/12/2020,10,11,0,21
GILMER,4/13/2020,11,14,0,25
GILMER,4/14/2020,13,15,0,28
GILMER,4/15/2020,15,17,0,32
GILMER,4/16/2020,16,21,0,37
GILMER,4/17/2020,19,25,0,44
GILMER,4/18/2020,24,27,0,51
GILMER,4/19/2020,25,29,0,54
GILMER,4/20/2020,32,30,0,62
GILMER,4/21/2020,36,35,0,71
GILMER,4/22/2020,39,37,0,76
GILMER,4/23/2020,40,38,0,78
GILMER,4/24/2020,42,39,0,81
GILMER,4/25/2020,45,39,0,84
GILMER,4/26/2020,47,39,0,86
GILMER,4/27/2020,48,40,0,88
GILMER,4/28/2020,53,42,0,95
GILMER,4/29/2020,53,44,0,97
GILMER,4/30/2020,55,46,0,101
GILMER,5/1/2020,58,48,0,106
GILMER,5/2/2020,59,49,0,108
GILMER,5/3/2020,60,50,0,110
GILMER,5/4/2020,61,52,0,113
GILMER,5/5/2020,61,53,0,114
GILMER,5/6/2020,61,54,0,115
GILMER,5/7/2020,65,55,0,120
GILMER,5/8/2020,65,56,0,121
GILMER,5/9/2020,66,57,0,123
GILMER,5/10/2020,67,58,0,125
GILMER,5/11/2020,68,58,0,126
GILMER,5/12/2020,68,59,0,127
GILMER,5/13/2020,69,59,0,128
GILMER,5/14/2020,71,59,0,130
GILMER,5/15/2020,73,59,0,132
GILMER,5/16/2020,77,59,0,136
GILMER,5/17/2020,77,59,0,136
GILMER,5/18/2020,77,62,0,139
GILMER,5/19/2020,80,66,0,146
GILMER,5/20/2020,82,67,0,149
GILMER,5/21/2020,82,70,0,152
GILMER,5/22/2020,84,71,0,155
GILMER,5/23/2020,85,71,0,156
GILMER,5/24/2020,85,72,0,157
GILMER,5/25/2020,85,73,0,158
GILMER,5/26/2020,86,74,0,160
GILMER,5/27/2020,86,74,0,160
GILMER,5/28/2020,86,77,0,163
GILMER,5/29/2020,87,77,0,164
GILMER,5/30/2020,87,79,0,166
GILMER,5/31/2020,87,79,0,166
GILMER,6/1/2020,87,80,0,167
GILMER,6/2/2020,88,80,0,168
GILMER,6/3/2020,89,81,0,170
GILMER,6/4/2020,89,81,0,170
GILMER,6/5/2020,90,81,0,171
GILMER,6/6/2020,92,82,0,174
GILMER,6/7/2020,92,82,0,174
GILMER,6/8/2020,94,82,0,176
GILMER,6/9/2020,95,82,0,177
GILMER,6/10/2020,95,83,0,178
GILMER,6/11/2020,97,83,0,180
GILMER,6/12/2020,97,83,0,180
GILMER,6/13/2020,97,83,0,180
GILMER,6/14/2020,97,83,0,180
GILMER,6/15/2020,102,83,0,185
GILMER,6/16/2020,104,83,0,187
GILMER,6/17/2020,106,84,0,190
GILMER,6/18/2020,106,84,0,190
GILMER,6/19/2020,106,85,0,191
GILMER,6/20/2020,106,85,0,191
GILMER,6/21/2020,106,85,0,191
GILMER,6/22/2020,106,89,0,195
GILMER,6/23/2020,107,89,0,196
GILMER,6/24/2020,107,90,0,197
GILMER,6/25/2020,108,91,0,199
GILMER,6/26/2020,111,94,0,205
GILMER,6/27/2020,114,95,0,209
GILMER,6/28/2020,115,96,0,211
GILMER,6/29/2020,118,97,0,215
GILMER,6/30/2020,123,99,0,222
GILMER,7/1/2020,123,102,0,225
GILMER,7/2/2020,125,104,0,229
GILMER,7/3/2020,130,107,0,237
GILMER,7/4/2020,137,114,0,251
GILMER,7/5/2020,142,118,0,260
GILMER,7/6/2020,159,133,0,292
GILMER,7/7/2020,166,147,0,313
GILMER,7/8/2020,178,159,0,337
GILMER,7/9/2020,192,163,0,355
GILMER,7/10/2020,203,171,0,374
GILMER,7/11/2020,205,175,0,380
GILMER,7/12/2020,211,176,0,387
GILMER,7/13/2020,217,186,0,403
GILMER,7/14/2020,224,194,0,418
GILMER,7/15/2020,232,202,0,434
GILMER,7/16/2020,236,206,1,443
GILMER,7/17/2020,242,207,1,450
GILMER,7/18/2020,248,212,1,461
GILMER,7/19/2020,251,214,1,466
GILMER,7/20/2020,257,223,1,481
GILMER,7/21/2020,263,227,4,494
GILMER,7/22/2020,268,232,4,504
GILMER,7/23/2020,269,236,4,509
GILMER,7/24/2020,273,240,6,519
GILMER,7/25/2020,278,243,6,527
GILMER,7/26/2020,280,246,6,532
GILMER,7/27/2020,286,250,6,542
GILMER,7/28/2020,292,254,6,552
GILMER,7/29/2020,300,261,6,567
GILMER,7/30/2020,308,263,7,578
GILMER,7/31/2020,317,272,8,597
GILMER,8/1/2020,324,272,8,604
GILMER,8/2/2020,328,275,8,611
GILMER,8/3/2020,334,281,9,624
GILMER,8/4/2020,336,284,11,631
GILMER,8/5/2020,341,290,13,644
GILMER,8/6/2020,347,292,13,652
GILMER,8/7/2020,348,294,17,659
GILMER,8/8/2020,349,295,18,662
GILMER,8/9/2020,351,296,18,665
GILMER,8/10/2020,354,300,18,672
GILMER,8/11/2020,356,302,18,676
GILMER,8/12/2020,361,310,20,691
GILMER,8/13/2020,364,310,20,694
GILMER,8/14/2020,366,311,23,700
GILMER,8/15/2020,366,312,24,702
GILMER,8/16/2020,369,314,24,707
GILMER,8/17/2020,370,317,26,713
GILMER,8/18/2020,375,318,26,719
GILMER,8/19/2020,379,321,26,726
GILMER,8/20/2020,380,322,26,728
GILMER,8/21/2020,384,326,26,736
GILMER,8/22/2020,384,329,26,739
GILMER,8/23/2020,388,329,26,743
GILMER,8/24/2020,389,331,28,748
GILMER,8/25/2020,392,331,28,751
GILMER,8/26/2020,395,333,29,757
GILMER,8/27/2020,395,333,29,757
GILMER,8/28/2020,397,333,31,761
GILMER,8/29/2020,397,335,31,763
GILMER,8/30/2020,398,335,31,764
GILMER,8/31/2020,400,337,32,769
GILMER,9/1/2020,404,337,32,773
GILMER,9/2/2020,406,339,33,778
GILMER,9/3/2020,407,341,33,781
GILMER,9/4/2020,407,342,33,782
GILMER,9/5/2020,409,342,33,784
GILMER,9/6/2020,411,343,33,787
GILMER,9/7/2020,412,344,33,789
GILMER,9/8/2020,414,345,33,792
GILMER,9/9/2020,414,346,33,793
GILMER,9/10/2020,415,346,33,794
GILMER,9/11/2020,416,347,34,797
GILMER,9/12/2020,416,347,34,797
GILMER,9/13/2020,417,347,34,798
GILMER,9/14/2020,418,347,35,800
GILMER,9/15/2020,418,349,35,802
GILMER,9/16/2020,419,351,35,805
GILMER,9/17/2020,420,351,35,806
GILMER,9/18/2020,422,352,35,809
GILMER,9/19/2020,422,352,35,809
GILMER,9/20/2020,425,353,35,813
GILMER,9/21/2020,431,357,35,823
GILMER,9/22/2020,433,357,35,825
GILMER,9/23/2020,433,358,35,826
GILMER,9/24/2020,433,360,35,828
GILMER,9/25/2020,436,366,35,837
GILMER,9/26/2020,436,367,35,838
GILMER,9/27/2020,438,368,35,841
GILMER,9/28/2020,441,371,35,847
GILMER,9/29/2020,452,375,35,862
GILMER,9/30/2020,458,375,35,868
GILMER,10/1/2020,464,378,35,877
GILMER,10/2/2020,470,384,36,890
GILMER,10/3/2020,475,386,36,897
GILMER,10/4/2020,478,387,36,901
GILMER,10/5/2020,482,390,36,908
GILMER,10/6/2020,492,393,36,921
GILMER,10/7/2020,495,396,36,927
GILMER,10/8/2020,500,397,36,933
GILMER,10/9/2020,507,398,36,941
GILMER,10/10/2020,513,398,36,947
GILMER,10/11/2020,515,401,36,952
GILMER,10/12/2020,523,401,36,960
GILMER,10/13/2020,530,406,36,972
GILMER,10/14/2020,531,407,36,974
GILMER,10/15/2020,534,409,36,979
GILMER,10/16/2020,534,414,36,984
GILMER,10/17/2020,534,414,36,984
GILMER,10/18/2020,534,414,36,984
GILMER,10/19/2020,534,414,36,984
GILMER,10/20/2020,534,414,36,984
GLASCOCK,1/1/2020,0,0,0,0
GLASCOCK,1/2/2020,0,0,0,0
GLASCOCK,1/3/2020,0,0,0,0
GLASCOCK,1/4/2020,0,0,0,0
GLASCOCK,1/5/2020,0,0,0,0
GLASCOCK,1/6/2020,0,0,0,0
GLASCOCK,1/7/2020,0,0,0,0
GLASCOCK,1/8/2020,0,0,0,0
GLASCOCK,1/9/2020,0,0,0,0
GLASCOCK,1/10/2020,0,0,0,0
GLASCOCK,1/11/2020,0,0,0,0
GLASCOCK,1/12/2020,0,0,0,0
GLASCOCK,1/13/2020,0,0,0,0
GLASCOCK,1/14/2020,0,0,0,0
GLASCOCK,1/15/2020,0,0,0,0
GLASCOCK,1/16/2020,0,0,0,0
GLASCOCK,1/17/2020,0,0,0,0
GLASCOCK,1/18/2020,0,0,0,0
GLASCOCK,1/19/2020,0,0,0,0
GLASCOCK,1/20/2020,0,0,0,0
GLASCOCK,1/21/2020,0,0,0,0
GLASCOCK,1/22/2020,0,0,0,0
GLASCOCK,1/23/2020,0,0,0,0
GLASCOCK,1/24/2020,0,0,0,0
GLASCOCK,1/25/2020,0,0,0,0
GLASCOCK,1/26/2020,0,0,0,0
GLASCOCK,1/27/2020,0,0,0,0
GLASCOCK,1/28/2020,0,0,0,0
GLASCOCK,1/29/2020,0,0,0,0
GLASCOCK,1/30/2020,0,0,0,0
GLASCOCK,1/31/2020,0,0,0,0
GLASCOCK,2/1/2020,0,0,0,0
GLASCOCK,2/2/2020,0,0,0,0
GLASCOCK,2/3/2020,0,0,0,0
GLASCOCK,2/4/2020,0,0,0,0
GLASCOCK,2/5/2020,0,0,0,0
GLASCOCK,2/6/2020,0,0,0,0
GLASCOCK,2/7/2020,0,0,0,0
GLASCOCK,2/8/2020,0,0,0,0
GLASCOCK,2/9/2020,0,0,0,0
GLASCOCK,2/10/2020,0,0,0,0
GLASCOCK,2/11/2020,0,0,0,0
GLASCOCK,2/28/2020,0,0,0,0
GLASCOCK,2/29/2020,0,0,0,0
GORDON,9/30/2020,999,900,25,1924
GLASCOCK,3/1/2020,0,0,0,0
GLASCOCK,3/2/2020,0,0,0,0
GORDON,10/1/2020,1003,908,25,1936
GLASCOCK,3/3/2020,0,0,0,0
GORDON,10/2/2020,1011,912,26,1949
GLASCOCK,3/4/2020,0,0,0,0
GORDON,10/3/2020,1015,916,26,1957
GLASCOCK,3/5/2020,0,0,0,0
GLASCOCK,3/6/2020,0,0,0,0
GORDON,10/4/2020,1020,916,26,1962
GORDON,10/5/2020,1024,919,26,1969
GLASCOCK,3/7/2020,0,0,0,0
GORDON,10/6/2020,1031,929,26,1986
GORDON,10/7/2020,1035,936,26,1997
GORDON,10/8/2020,1045,949,26,2020
GORDON,10/9/2020,1056,967,26,2049
GORDON,10/10/2020,1062,970,26,2058
GORDON,10/11/2020,1068,973,26,2067
GORDON,10/12/2020,1083,990,26,2099
GORDON,10/13/2020,1095,1002,26,2123
GORDON,10/14/2020,1114,1008,26,2148
GORDON,10/15/2020,1122,1016,26,2164
GORDON,10/16/2020,1132,1026,26,2184
GORDON,10/17/2020,1138,1031,26,2195
GORDON,10/18/2020,1138,1032,26,2196
GORDON,10/19/2020,1138,1032,26,2196
GORDON,10/20/2020,1138,1032,26,2196
GRADY,1/1/2020,0,0,0,0
GRADY,1/2/2020,0,0,0,0
GRADY,1/3/2020,0,0,0,0
GRADY,1/4/2020,0,0,0,0
GRADY,1/5/2020,0,0,0,0
GRADY,1/6/2020,0,0,0,0
GRADY,1/7/2020,0,0,0,0
GRADY,1/8/2020,0,0,0,0
GRADY,1/9/2020,0,0,0,0
GRADY,1/10/2020,0,0,0,0
GRADY,1/11/2020,0,0,0,0
GRADY,1/12/2020,0,0,0,0
GRADY,1/13/2020,0,0,0,0
GRADY,1/14/2020,0,0,0,0
GRADY,1/15/2020,0,0,0,0
GRADY,1/16/2020,0,0,0,0
GRADY,1/17/2020,0,0,0,0
GRADY,1/18/2020,0,0,0,0
GRADY,1/19/2020,0,0,0,0
GRADY,1/20/2020,0,0,0,0
GRADY,1/21/2020,0,0,0,0
GRADY,1/22/2020,0,0,0,0
GRADY,1/23/2020,0,0,0,0
GRADY,1/24/2020,0,0,0,0
GRADY,1/25/2020,0,0,0,0
GRADY,1/26/2020,0,0,0,0
GRADY,1/27/2020,0,0,0,0
GRADY,1/28/2020,0,0,0,0
GRADY,1/29/2020,0,0,0,0
GRADY,1/30/2020,0,0,0,0
GRADY,1/31/2020,0,0,0,0
GRADY,2/1/2020,0,0,0,0
GRADY,2/2/2020,0,0,0,0
GRADY,2/3/2020,0,0,0,0
GRADY,2/4/2020,0,0,0,0
GRADY,2/5/2020,0,0,0,0
GRADY,2/6/2020,0,0,0,0
GRADY,2/7/2020,0,0,0,0
GRADY,2/8/2020,0,0,0,0
GRADY,2/9/2020,0,0,0,0
GRADY,2/10/2020,0,0,0,0
GRADY,2/11/2020,0,0,0,0
GRADY,2/12/2020,0,0,0,0
GRADY,2/13/2020,0,0,0,0
GRADY,2/14/2020,0,0,0,0
GRADY,2/15/2020,0,0,0,0
GRADY,2/16/2020,0,0,0,0
GRADY,2/17/2020,0,0,0,0
GRADY,2/18/2020,0,0,0,0
GRADY,2/19/2020,0,0,0,0
GRADY,2/20/2020,0,0,0,0
GRADY,2/21/2020,0,0,0,0
GRADY,2/22/2020,0,0,0,0
GRADY,2/23/2020,0,0,0,0
GRADY,2/24/2020,0,0,0,0
GRADY,2/25/2020,0,0,0,0
GRADY,2/26/2020,0,0,0,0
GRADY,2/27/2020,0,0,0,0
GRADY,2/28/2020,0,0,0,0
GRADY,2/29/2020,0,0,0,0
GRADY,3/1/2020,0,0,0,0
GRADY,3/2/2020,0,0,0,0
GRADY,3/3/2020,0,0,0,0
GRADY,3/4/2020,0,0,0,0
GRADY,3/5/2020,0,0,0,0
GRADY,3/6/2020,0,0,0,0
GRADY,3/7/2020,0,0,0,0
GRADY,3/8/2020,0,0,0,0
GRADY,3/9/2020,0,0,0,0
GRADY,3/10/2020,0,0,0,0
GRADY,3/11/2020,0,0,0,0
GRADY,3/12/2020,0,0,0,0
GRADY,3/13/2020,0,0,0,0
GRADY,3/14/2020,0,0,0,0
GRADY,3/15/2020,0,0,0,0
GRADY,3/16/2020,0,0,0,0
GRADY,3/17/2020,0,1,0,1
GRADY,3/18/2020,0,1,0,1
GRADY,3/19/2020,0,1,0,1
GRADY,3/20/2020,1,2,0,3
GRADY,3/21/2020,1,2,0,3
GRADY,3/22/2020,1,2,0,3
GRADY,3/23/2020,1,2,0,3
GRADY,3/24/2020,1,2,0,3
GRADY,3/25/2020,1,2,0,3
GRADY,3/26/2020,1,2,0,3
GRADY,3/27/2020,1,3,0,4
GRADY,3/28/2020,1,3,0,4
GRADY,3/29/2020,2,4,0,6
GRADY,3/30/2020,3,6,0,9
GRADY,3/31/2020,3,7,0,10
GRADY,4/1/2020,6,7,0,13
GRADY,4/2/2020,7,7,0,14
GRADY,4/3/2020,9,8,0,17
GRADY,4/4/2020,10,9,0,19
GRADY,4/5/2020,11,9,0,20
GRADY,4/6/2020,14,9,0,23
GRADY,4/7/2020,17,10,0,27
GRADY,4/8/2020,17,11,0,28
GRADY,4/9/2020,22,15,1,38
GRADY,4/10/2020,24,15,1,40
GRADY,4/11/2020,24,16,1,41
GRADY,4/12/2020,25,16,1,42
GRADY,4/13/2020,28,16,1,45
GRADY,4/14/2020,31,17,1,49
GRADY,4/15/2020,33,18,1,52
GRADY,4/16/2020,35,19,1,55
GRADY,4/17/2020,37,20,2,59
GRADY,4/18/2020,38,20,2,60
GRADY,4/19/2020,39,20,2,61
GRADY,4/20/2020,39,22,2,63
GRADY,4/21/2020,41,23,2,66
GRADY,4/22/2020,43,23,2,68
GRADY,4/23/2020,44,23,2,69
GRADY,4/24/2020,46,25,2,73
GRADY,4/25/2020,46,25,2,73
GRADY,4/26/2020,46,25,2,73
GRADY,4/27/2020,46,28,2,76
GRADY,4/28/2020,49,28,2,79
GRADY,4/29/2020,50,28,2,80
GRADY,4/30/2020,50,28,2,80
GRADY,5/1/2020,51,28,2,81
GRADY,5/2/2020,51,30,2,83
GRADY,5/3/2020,52,32,2,86
GRADY,5/4/2020,52,32,2,86
GRADY,5/5/2020,53,32,2,87
GRADY,5/6/2020,53,33,2,88
GRADY,5/7/2020,55,35,2,92
GRADY,5/8/2020,56,35,2,93
GRADY,5/9/2020,56,35,2,93
GRADY,5/10/2020,56,35,2,93
GRADY,5/11/2020,56,35,2,93
GRADY,5/12/2020,56,36,2,94
GRADY,5/13/2020,56,36,2,94
GRADY,5/14/2020,56,37,2,95
GRADY,5/15/2020,57,38,2,97
GRADY,5/16/2020,57,39,2,98
GRADY,5/17/2020,57,40,2,99
GRADY,5/18/2020,57,41,2,100
GRADY,5/19/2020,57,42,2,101
GRADY,5/20/2020,57,43,2,102
GRADY,5/21/2020,58,43,2,103
GRADY,5/22/2020,59,44,2,105
GRADY,5/23/2020,61,44,2,107
GRADY,5/24/2020,62,45,2,109
GRADY,5/25/2020,63,45,2,110
GRADY,5/26/2020,64,47,2,113
GRADY,5/27/2020,66,47,2,115
GRADY,5/28/2020,67,49,2,118
GRADY,5/29/2020,69,49,2,120
GRADY,5/30/2020,69,49,2,120
GRADY,5/31/2020,70,50,2,122
GRADY,6/1/2020,72,52,2,126
GRADY,6/2/2020,74,52,2,128
GRADY,6/3/2020,75,52,2,129
GRADY,6/4/2020,76,53,2,131
GRADY,6/5/2020,76,55,2,133
GRADY,6/6/2020,76,55,2,133
GRADY,6/7/2020,79,55,2,136
GRADY,6/8/2020,80,55,2,137
GRADY,6/9/2020,81,55,2,138
GRADY,6/10/2020,81,59,2,142
GRADY,6/11/2020,82,62,2,146
GRADY,6/12/2020,83,64,2,149
GRADY,6/13/2020,87,66,2,155
GRADY,6/14/2020,90,67,2,159
GRADY,6/15/2020,92,67,2,161
GRADY,6/16/2020,93,70,2,165
GRADY,6/17/2020,95,72,2,169
GRADY,6/18/2020,99,75,6,180
GRADY,6/19/2020,101,75,10,186
GRADY,6/20/2020,104,77,10,191
GRADY,6/21/2020,105,81,10,196
GRADY,6/22/2020,106,85,10,201
GRADY,6/23/2020,110,88,10,208
GRADY,6/24/2020,112,94,10,216
GRADY,6/25/2020,115,96,10,221
GRADY,6/26/2020,117,99,10,226
GRADY,6/27/2020,120,105,10,235
GRADY,6/28/2020,121,107,10,238
GRADY,6/29/2020,121,108,10,239
GRADY,6/30/2020,122,108,10,240
GRADY,7/1/2020,125,112,10,247
GRADY,7/2/2020,129,113,10,252
GRADY,7/3/2020,130,117,10,257
GRADY,7/4/2020,135,118,10,263
GRADY,7/5/2020,137,119,10,266
GRADY,7/6/2020,140,122,10,272
GRADY,7/7/2020,144,122,10,276
GRADY,7/8/2020,147,124,10,281
GRADY,7/9/2020,151,125,10,286
GRADY,7/10/2020,156,133,10,299
GRADY,7/11/2020,160,135,10,305
GRADY,7/12/2020,164,138,10,312
GRADY,7/13/2020,170,140,10,320
GRADY,7/14/2020,179,140,10,329
GRADY,7/15/2020,187,145,10,342
GRADY,7/16/2020,190,147,10,347
GRADY,7/17/2020,192,155,10,357
GRADY,7/18/2020,193,158,10,361
GRADY,7/19/2020,195,160,10,365
GRADY,7/20/2020,198,167,10,375
GRADY,7/21/2020,206,170,10,386
GRADY,7/22/2020,209,173,10,392
GRADY,7/23/2020,213,175,10,398
GRADY,7/24/2020,217,179,10,406
GRADY,7/25/2020,221,181,10,412
GRADY,7/26/2020,223,183,10,416
GRADY,7/27/2020,228,185,10,423
GRADY,7/28/2020,234,187,10,431
GRADY,7/29/2020,240,194,10,444
GRADY,7/30/2020,243,196,10,449
GRADY,7/31/2020,244,201,10,455
GRADY,8/1/2020,248,206,10,464
GRADY,8/2/2020,251,208,10,469
GRADY,8/3/2020,252,211,10,473
GRADY,8/4/2020,255,218,10,483
GRADY,8/5/2020,261,219,10,490
GRADY,8/6/2020,275,223,18,516
GRADY,8/7/2020,279,230,18,527
GRADY,8/8/2020,282,232,18,532
GRADY,8/9/2020,284,234,18,536
GRADY,8/10/2020,285,238,18,541
GRADY,8/11/2020,291,240,18,549
GRADY,8/12/2020,294,245,18,557
GRADY,8/13/2020,300,247,18,565
GRADY,8/14/2020,309,252,25,586
GRADY,8/15/2020,311,252,25,588
GRADY,8/16/2020,314,252,25,591
GRADY,8/17/2020,317,257,25,599
GRADY,8/18/2020,324,260,25,609
GRADY,8/19/2020,327,263,25,615
GRADY,8/20/2020,329,264,25,618
GRADY,8/21/2020,335,268,25,628
GRADY,8/22/2020,337,270,25,632
GRADY,8/23/2020,338,273,25,636
GRADY,8/24/2020,340,275,25,640
GRADY,8/25/2020,343,279,25,647
GRADY,8/26/2020,348,281,25,654
GRADY,8/27/2020,351,285,25,661
GRADY,8/28/2020,354,286,25,665
GRADY,8/29/2020,355,288,25,668
GRADY,8/30/2020,358,288,25,671
GRADY,8/31/2020,361,295,25,681
GRADY,9/1/2020,366,296,25,687
GRADY,9/2/2020,369,297,25,691
GRADY,9/3/2020,371,297,25,693
GRADY,9/4/2020,375,299,25,699
GRADY,9/5/2020,378,299,25,702
GRADY,9/6/2020,378,300,25,703
GRADY,9/7/2020,381,305,25,711
GRADY,9/8/2020,386,308,25,719
GRADY,9/9/2020,390,310,25,725
GRADY,9/10/2020,391,313,25,729
GRADY,9/11/2020,396,316,25,737
GRADY,9/12/2020,398,319,25,742
GRADY,9/13/2020,398,321,25,744
GRADY,9/14/2020,399,323,25,747
GRADY,9/15/2020,402,326,25,753
GRADY,9/16/2020,402,329,25,756
GRADY,9/17/2020,405,330,25,760
GRADY,9/18/2020,406,332,25,763
GRADY,9/19/2020,407,332,25,764
GRADY,9/20/2020,407,333,25,765
GRADY,9/21/2020,408,334,25,767
GRADY,9/22/2020,412,337,25,774
GRADY,9/23/2020,414,341,25,780
GRADY,9/24/2020,417,342,25,784
GRADY,9/25/2020,422,348,25,795
GRADY,9/26/2020,425,348,25,798
GRADY,9/27/2020,428,348,25,801
GRADY,9/28/2020,429,348,26,803
GRADY,9/29/2020,433,350,26,809
GRADY,9/30/2020,436,351,26,813
GRADY,10/1/2020,440,352,26,818
GRADY,10/2/2020,442,353,26,821
GRADY,10/3/2020,442,354,26,822
GRADY,10/4/2020,443,355,26,824
GRADY,10/5/2020,446,358,26,830
GRADY,10/6/2020,449,359,26,834
GRADY,10/7/2020,449,359,26,834
GRADY,10/8/2020,450,360,26,836
GRADY,10/9/2020,450,361,26,837
GRADY,10/10/2020,450,362,26,838
GRADY,10/11/2020,450,362,26,838
GRADY,10/12/2020,450,362,26,838
GRADY,10/13/2020,451,363,26,840
GRADY,10/14/2020,453,363,26,842
GRADY,10/15/2020,453,365,26,844
GRADY,10/16/2020,453,365,26,844
GRADY,10/17/2020,453,365,26,844
GRADY,10/18/2020,453,365,26,844
GRADY,10/19/2020,453,365,26,844
GRADY,10/20/2020,453,365,26,844
GWINNETT,1/1/2020,0,0,0,0
GWINNETT,1/2/2020,0,0,0,0
GWINNETT,1/3/2020,0,0,0,0
GWINNETT,1/4/2020,0,0,0,0
GWINNETT,1/5/2020,0,0,0,0
GWINNETT,1/6/2020,0,0,0,0
GWINNETT,1/7/2020,0,0,0,0
GWINNETT,1/8/2020,0,0,0,0
GWINNETT,1/9/2020,0,0,0,0
GWINNETT,1/10/2020,0,0,0,0
GWINNETT,1/11/2020,0,0,0,0
GWINNETT,1/12/2020,0,0,0,0
GWINNETT,1/13/2020,0,0,0,0
GWINNETT,1/14/2020,0,0,0,0
GWINNETT,1/15/2020,0,0,0,0
GWINNETT,1/16/2020,0,0,0,0
GWINNETT,1/17/2020,0,0,0,0
GWINNETT,1/18/2020,0,0,0,0
GWINNETT,1/19/2020,0,0,0,0
GWINNETT,1/20/2020,0,0,0,0
GWINNETT,1/21/2020,0,0,0,0
GWINNETT,1/22/2020,0,0,0,0
GWINNETT,1/23/2020,0,0,0,0
GWINNETT,1/24/2020,0,0,0,0
GWINNETT,1/25/2020,0,0,0,0
GWINNETT,1/26/2020,0,0,0,0
GWINNETT,1/27/2020,0,0,0,0
GWINNETT,1/28/2020,0,0,0,0
GWINNETT,1/29/2020,0,0,0,0
GWINNETT,1/30/2020,0,0,0,0
GWINNETT,1/31/2020,0,0,0,0
GWINNETT,2/1/2020,1,0,0,1
GWINNETT,2/2/2020,1,0,0,1
GWINNETT,2/3/2020,1,0,0,1
GWINNETT,2/4/2020,1,0,0,1
GWINNETT,2/5/2020,1,0,0,1
GWINNETT,2/6/2020,1,0,0,1
GWINNETT,2/7/2020,2,0,0,2
GWINNETT,2/8/2020,2,0,0,2
GWINNETT,2/9/2020,2,0,0,2
GWINNETT,2/10/2020,3,0,0,3
GWINNETT,2/11/2020,3,0,0,3
GWINNETT,2/12/2020,3,0,0,3
GWINNETT,2/13/2020,3,0,0,3
GWINNETT,2/14/2020,3,1,0,4
GWINNETT,2/15/2020,3,1,0,4
GWINNETT,2/16/2020,3,1,0,4
GWINNETT,2/17/2020,3,1,0,4
GWINNETT,2/18/2020,3,1,0,4
GWINNETT,2/19/2020,3,1,0,4
GWINNETT,2/20/2020,4,1,0,5
GWINNETT,2/21/2020,4,1,0,5
GWINNETT,2/22/2020,5,2,0,7
GWINNETT,2/23/2020,5,3,0,8
GWINNETT,2/24/2020,5,4,0,9
GWINNETT,2/25/2020,5,4,0,9
GWINNETT,2/26/2020,5,4,0,9
GWINNETT,2/27/2020,6,4,0,10
GWINNETT,2/28/2020,8,4,0,12
GWINNETT,2/29/2020,8,6,0,14
GWINNETT,3/1/2020,8,8,0,16
GWINNETT,3/2/2020,9,9,0,18
GWINNETT,3/3/2020,10,10,0,20
GWINNETT,3/4/2020,10,12,0,22
GWINNETT,3/5/2020,10,12,0,22
GWINNETT,3/6/2020,12,12,0,24
GLASCOCK,3/8/2020,0,0,0,0
GLASCOCK,3/9/2020,0,0,0,0
GLASCOCK,3/10/2020,0,0,0,0
GLASCOCK,3/11/2020,0,0,0,0
GLASCOCK,3/12/2020,0,0,0,0
GLASCOCK,3/13/2020,0,0,0,0
GLASCOCK,3/14/2020,0,0,0,0
GLASCOCK,3/15/2020,0,0,0,0
GLASCOCK,3/16/2020,0,0,0,0
GLASCOCK,3/17/2020,0,0,0,0
GLASCOCK,3/18/2020,0,0,0,0
GLASCOCK,3/19/2020,0,0,0,0
GLASCOCK,3/20/2020,0,0,0,0
GLASCOCK,3/21/2020,0,0,0,0
GLASCOCK,3/22/2020,0,0,0,0
GLASCOCK,3/23/2020,0,0,0,0
GLASCOCK,3/24/2020,0,0,0,0
GLASCOCK,3/25/2020,0,0,0,0
GLASCOCK,3/26/2020,0,0,0,0
GLASCOCK,3/27/2020,0,0,0,0
GLASCOCK,3/28/2020,0,0,0,0
GLASCOCK,3/29/2020,0,0,0,0
GLASCOCK,3/30/2020,0,0,0,0
GLASCOCK,3/31/2020,0,0,0,0
GLASCOCK,4/1/2020,0,0,0,0
GLASCOCK,4/2/2020,0,0,0,0
GLASCOCK,4/3/2020,0,0,0,0
GLASCOCK,4/4/2020,0,0,0,0
GLASCOCK,4/5/2020,0,0,0,0
GLASCOCK,4/6/2020,0,0,0,0
GLASCOCK,4/7/2020,0,0,0,0
GLASCOCK,4/8/2020,0,0,0,0
GLASCOCK,4/9/2020,0,0,0,0
GLASCOCK,4/10/2020,0,0,0,0
GLASCOCK,4/11/2020,0,0,0,0
GLASCOCK,4/12/2020,0,0,0,0
GLASCOCK,4/13/2020,0,0,0,0
GLASCOCK,4/14/2020,0,0,0,0
GLASCOCK,4/15/2020,0,0,0,0
GLASCOCK,4/16/2020,0,0,0,0
GLASCOCK,4/17/2020,0,0,0,0
GLASCOCK,4/18/2020,0,0,0,0
GLASCOCK,4/19/2020,0,0,0,0
GLASCOCK,4/20/2020,0,0,0,0
GLASCOCK,4/21/2020,0,0,0,0
GLASCOCK,4/22/2020,0,0,0,0
GLASCOCK,4/23/2020,0,0,0,0
GLASCOCK,4/24/2020,0,0,0,0
GLASCOCK,4/25/2020,0,0,0,0
GLASCOCK,4/26/2020,0,0,0,0
GLASCOCK,4/27/2020,0,0,0,0
GLASCOCK,4/28/2020,0,0,0,0
GLASCOCK,4/29/2020,1,0,0,1
GLASCOCK,4/30/2020,1,0,0,1
GLASCOCK,5/1/2020,1,0,0,1
GLASCOCK,5/2/2020,1,0,0,1
GLASCOCK,5/3/2020,1,0,0,1
GLASCOCK,5/4/2020,1,0,0,1
GLASCOCK,5/5/2020,1,0,0,1
GLASCOCK,5/6/2020,1,0,0,1
GLASCOCK,5/7/2020,1,0,0,1
GLASCOCK,5/8/2020,1,0,0,1
GLASCOCK,5/9/2020,1,0,0,1
GLASCOCK,5/10/2020,1,0,0,1
GLASCOCK,5/11/2020,1,0,0,1
GLASCOCK,5/12/2020,1,1,0,2
GLASCOCK,5/13/2020,1,1,0,2
GLASCOCK,5/14/2020,1,1,0,2
GLASCOCK,5/15/2020,1,1,0,2
GLASCOCK,5/16/2020,1,1,0,2
GLASCOCK,5/17/2020,1,1,0,2
GLASCOCK,5/18/2020,1,1,0,2
GLASCOCK,5/19/2020,1,1,0,2
GLASCOCK,5/20/2020,1,1,0,2
GLASCOCK,5/21/2020,1,1,0,2
GLASCOCK,5/22/2020,1,1,0,2
GLASCOCK,5/23/2020,1,1,0,2
GLASCOCK,5/24/2020,1,1,0,2
GLASCOCK,5/25/2020,1,1,0,2
GLASCOCK,5/26/2020,1,1,0,2
GLASCOCK,5/27/2020,1,1,0,2
GLASCOCK,5/28/2020,1,1,0,2
GLASCOCK,5/29/2020,1,1,0,2
GLASCOCK,5/30/2020,1,1,0,2
GLASCOCK,5/31/2020,1,1,0,2
GLASCOCK,6/1/2020,1,1,0,2
GLASCOCK,6/2/2020,1,1,0,2
GLASCOCK,6/3/2020,1,1,0,2
GLASCOCK,6/4/2020,1,1,0,2
GLASCOCK,6/5/2020,1,1,0,2
GLASCOCK,6/6/2020,1,1,0,2
GLASCOCK,6/7/2020,1,1,0,2
GLASCOCK,6/8/2020,1,1,0,2
GLASCOCK,6/9/2020,1,1,0,2
GLASCOCK,6/10/2020,1,1,0,2
GLASCOCK,6/11/2020,1,2,0,3
GLASCOCK,6/12/2020,1,2,0,3
GLASCOCK,6/13/2020,1,2,0,3
GLASCOCK,6/14/2020,1,2,0,3
GLASCOCK,6/15/2020,1,2,0,3
GLASCOCK,6/16/2020,2,2,1,5
GLASCOCK,6/17/2020,3,2,1,6
GLASCOCK,6/18/2020,4,3,1,8
GLASCOCK,6/19/2020,4,3,1,8
GLASCOCK,6/20/2020,5,3,1,9
GLASCOCK,6/21/2020,5,3,1,9
GLASCOCK,6/22/2020,6,3,1,10
GLASCOCK,6/23/2020,7,4,1,12
GLASCOCK,6/24/2020,7,4,1,12
GLASCOCK,6/25/2020,7,4,1,12
GLASCOCK,6/26/2020,7,4,1,12
GLASCOCK,6/27/2020,7,4,1,12
GLASCOCK,6/28/2020,7,4,1,12
GLASCOCK,6/29/2020,8,4,1,13
GLASCOCK,6/30/2020,9,4,1,14
GLASCOCK,7/1/2020,10,4,1,15
GLASCOCK,7/2/2020,10,4,1,15
GLASCOCK,7/3/2020,10,4,1,15
GLASCOCK,7/4/2020,10,4,1,15
GLASCOCK,7/5/2020,10,4,1,15
GLASCOCK,7/6/2020,11,4,1,16
GLASCOCK,7/7/2020,11,4,1,16
GLASCOCK,7/8/2020,11,4,1,16
GLASCOCK,7/9/2020,11,4,1,16
GLASCOCK,7/10/2020,11,4,1,16
GLASCOCK,7/11/2020,11,4,1,16
GLASCOCK,7/12/2020,11,4,1,16
GLASCOCK,7/13/2020,11,4,1,16
GLASCOCK,7/14/2020,11,5,1,17
GLASCOCK,7/15/2020,12,5,1,18
GLASCOCK,7/16/2020,12,5,1,18
GLASCOCK,7/17/2020,12,5,1,18
GLASCOCK,7/18/2020,12,5,1,18
GLASCOCK,7/19/2020,12,5,1,18
GLASCOCK,7/20/2020,12,6,1,19
GLASCOCK,7/21/2020,12,6,1,19
GLASCOCK,7/22/2020,12,6,1,19
GLASCOCK,7/23/2020,12,6,1,19
GLASCOCK,7/24/2020,12,7,1,20
GLASCOCK,7/25/2020,14,7,1,22
GLASCOCK,7/26/2020,14,7,1,22
GLASCOCK,7/27/2020,14,7,1,22
GLASCOCK,7/28/2020,14,7,1,22
GLASCOCK,7/29/2020,14,7,1,22
GLASCOCK,7/30/2020,14,7,1,22
GLASCOCK,7/31/2020,14,8,1,23
GLASCOCK,8/1/2020,15,8,1,24
GLASCOCK,8/2/2020,15,8,1,24
GLASCOCK,8/3/2020,15,8,1,24
GLASCOCK,8/4/2020,15,10,1,26
GLASCOCK,8/5/2020,15,10,1,26
GLASCOCK,8/6/2020,15,10,1,26
GLASCOCK,8/7/2020,15,11,1,27
GLASCOCK,8/8/2020,15,11,1,27
GLASCOCK,8/9/2020,15,11,1,27
GLASCOCK,8/10/2020,15,11,1,27
GLASCOCK,8/11/2020,16,12,1,29
GLASCOCK,8/12/2020,16,13,1,30
GLASCOCK,8/13/2020,17,13,1,31
GLASCOCK,8/14/2020,17,13,1,31
GLASCOCK,8/15/2020,17,13,1,31
GLASCOCK,8/16/2020,17,13,1,31
GLASCOCK,8/17/2020,18,14,1,33
GLASCOCK,8/18/2020,18,15,1,34
GLASCOCK,8/19/2020,18,16,1,35
GLASCOCK,8/20/2020,18,16,1,35
GLASCOCK,8/21/2020,18,16,1,35
GLASCOCK,8/22/2020,18,16,1,35
GLASCOCK,8/23/2020,18,16,1,35
GLASCOCK,8/24/2020,18,16,1,35
GLASCOCK,8/25/2020,18,16,1,35
GLASCOCK,8/26/2020,18,16,1,35
GLASCOCK,8/27/2020,18,16,1,35
GLASCOCK,8/28/2020,20,16,1,37
GLASCOCK,8/29/2020,20,16,1,37
GLASCOCK,8/30/2020,20,16,1,37
GLASCOCK,8/31/2020,20,17,1,38
GLASCOCK,9/1/2020,20,17,1,38
GLASCOCK,9/2/2020,21,17,1,39
GLASCOCK,9/3/2020,21,17,1,39
GLASCOCK,9/4/2020,21,17,1,39
GLASCOCK,9/5/2020,21,17,1,39
GLASCOCK,9/6/2020,21,17,1,39
GLASCOCK,9/7/2020,21,17,1,39
GLASCOCK,9/8/2020,22,17,1,40
GLASCOCK,9/9/2020,22,17,1,40
GLASCOCK,9/10/2020,22,17,1,40
GLASCOCK,9/11/2020,22,17,1,40
GLASCOCK,9/12/2020,22,17,1,40
GLASCOCK,9/13/2020,22,17,1,40
GLASCOCK,9/14/2020,22,17,1,40
GLASCOCK,9/15/2020,22,17,1,40
GLASCOCK,9/16/2020,22,17,1,40
GLASCOCK,9/17/2020,22,17,1,40
GLASCOCK,9/18/2020,22,17,1,40
GLASCOCK,9/19/2020,22,17,1,40
GLASCOCK,9/20/2020,22,17,1,40
GLASCOCK,9/21/2020,22,17,1,40
GLASCOCK,9/22/2020,22,17,1,40
GLASCOCK,9/23/2020,22,17,1,40
GLASCOCK,9/24/2020,22,17,1,40
GLASCOCK,9/25/2020,22,17,1,40
GLASCOCK,9/26/2020,22,17,1,40
GLASCOCK,9/27/2020,22,17,1,40
GLASCOCK,9/28/2020,22,17,1,40
GLASCOCK,9/29/2020,22,17,1,40
GLASCOCK,9/30/2020,22,17,1,40
GLASCOCK,10/1/2020,22,17,1,40
GLASCOCK,10/2/2020,22,17,1,40
GLASCOCK,10/3/2020,22,17,1,40
GLASCOCK,10/4/2020,22,17,1,40
GLASCOCK,10/5/2020,22,17,1,40
GLASCOCK,10/6/2020,22,17,1,40
GLASCOCK,10/7/2020,22,17,1,40
GLASCOCK,10/8/2020,22,17,1,40
GLASCOCK,10/9/2020,22,17,1,40
GLASCOCK,10/10/2020,22,17,1,40
GLASCOCK,10/11/2020,22,17,1,40
GLASCOCK,10/12/2020,22,17,1,40
GLASCOCK,10/13/2020,22,17,1,40
GLASCOCK,10/14/2020,22,18,1,41
GLASCOCK,10/15/2020,22,19,1,42
GLASCOCK,10/16/2020,23,19,1,43
GLASCOCK,10/17/2020,23,19,1,43
GLASCOCK,10/18/2020,23,19,1,43
GLASCOCK,10/19/2020,23,19,1,43
GLASCOCK,10/20/2020,23,19,1,43
GLYNN,1/1/2020,0,0,0,0
GLYNN,1/2/2020,0,0,0,0
GLYNN,1/3/2020,0,0,0,0
GLYNN,1/4/2020,0,0,0,0
GLYNN,1/5/2020,0,0,0,0
GLYNN,1/6/2020,0,0,0,0
GLYNN,1/7/2020,0,0,0,0
GLYNN,1/8/2020,0,0,0,0
GLYNN,1/9/2020,0,0,0,0
GLYNN,1/10/2020,0,0,0,0
GLYNN,1/11/2020,0,0,0,0
GLYNN,1/12/2020,0,0,0,0
GLYNN,1/13/2020,0,0,0,0
GLYNN,1/14/2020,0,0,0,0
GLYNN,1/15/2020,0,0,0,0
GLYNN,1/16/2020,0,0,0,0
GLYNN,1/17/2020,0,0,0,0
GLYNN,1/18/2020,0,0,0,0
GLYNN,1/19/2020,0,0,0,0
GLYNN,1/20/2020,0,0,0,0
GLYNN,1/21/2020,0,0,0,0
GLYNN,1/22/2020,0,0,0,0
GLYNN,1/23/2020,0,0,0,0
GLYNN,1/24/2020,0,0,0,0
GLYNN,1/25/2020,0,0,0,0
GLYNN,1/26/2020,0,0,0,0
GLYNN,1/27/2020,0,0,0,0
GLYNN,1/28/2020,0,0,0,0
GLYNN,1/29/2020,0,0,0,0
GLYNN,1/30/2020,0,0,0,0
GLYNN,1/31/2020,0,0,0,0
GLYNN,2/1/2020,0,0,0,0
GLYNN,2/2/2020,0,0,0,0
GLYNN,2/3/2020,0,0,0,0
GLYNN,2/4/2020,0,0,0,0
GLYNN,2/5/2020,0,0,0,0
GLYNN,2/6/2020,0,0,0,0
GLYNN,2/7/2020,0,0,0,0
GLYNN,2/8/2020,0,0,0,0
GLYNN,2/9/2020,0,0,0,0
GLYNN,2/10/2020,0,0,0,0
GLYNN,2/11/2020,0,0,0,0
GLYNN,2/12/2020,0,0,0,0
GLYNN,2/13/2020,0,0,0,0
GLYNN,2/14/2020,0,0,0,0
GLYNN,2/15/2020,0,0,0,0
GLYNN,2/16/2020,0,0,0,0
GLYNN,2/17/2020,0,0,0,0
GLYNN,2/18/2020,0,0,0,0
GLYNN,2/19/2020,0,0,0,0
GLYNN,2/20/2020,0,0,0,0
GLYNN,2/21/2020,0,0,0,0
GLYNN,2/22/2020,0,0,0,0
GLYNN,2/23/2020,0,0,0,0
GLYNN,2/24/2020,0,0,0,0
GLYNN,2/25/2020,0,0,0,0
GLYNN,2/26/2020,0,0,0,0
GLYNN,2/27/2020,1,0,0,1
GLYNN,2/28/2020,1,0,0,1
GLYNN,2/29/2020,1,0,0,1
GLYNN,3/1/2020,2,0,0,2
GLYNN,3/2/2020,2,0,0,2
GLYNN,3/3/2020,2,0,0,2
GLYNN,3/4/2020,2,0,0,2
GLYNN,3/5/2020,2,0,0,2
GLYNN,3/6/2020,2,0,0,2
GLYNN,3/7/2020,2,0,0,2
GLYNN,3/8/2020,2,0,0,2
GLYNN,3/9/2020,2,0,0,2
GLYNN,3/10/2020,3,0,0,3
GLYNN,3/11/2020,4,2,0,6
GLYNN,3/12/2020,5,3,0,8
GLYNN,3/13/2020,5,3,0,8
GLYNN,3/14/2020,5,3,0,8
GLYNN,3/15/2020,5,3,0,8
GLYNN,3/16/2020,6,4,0,10
GLYNN,3/17/2020,8,5,0,13
GLYNN,3/18/2020,10,5,0,15
GLYNN,3/19/2020,11,5,0,16
GLYNN,3/20/2020,14,5,0,19
GLYNN,3/21/2020,14,5,0,19
GLYNN,3/22/2020,16,7,0,23
GLYNN,3/23/2020,20,10,0,30
GLYNN,3/24/2020,22,10,0,32
GLYNN,3/25/2020,23,11,0,34
GLYNN,3/26/2020,24,11,0,35
GLYNN,3/27/2020,25,12,0,37
GLYNN,3/28/2020,25,12,0,37
GLYNN,3/29/2020,26,12,0,38
GLYNN,3/30/2020,26,13,0,39
GLYNN,3/31/2020,26,13,0,39
GLYNN,4/1/2020,26,13,0,39
GLYNN,4/2/2020,26,13,0,39
GLYNN,4/3/2020,26,14,0,40
GLYNN,4/4/2020,27,14,0,41
GLYNN,4/5/2020,27,15,0,42
GLYNN,4/6/2020,28,15,0,43
GLYNN,4/7/2020,28,16,0,44
GLYNN,4/8/2020,28,18,0,46
GLYNN,4/9/2020,30,18,0,48
GLYNN,4/10/2020,30,18,0,48
GLYNN,4/11/2020,31,19,0,50
GLYNN,4/12/2020,31,20,0,51
GLYNN,4/13/2020,31,21,0,52
GLYNN,4/14/2020,32,21,0,53
GLYNN,4/15/2020,32,21,0,53
GLYNN,4/16/2020,32,21,0,53
GLYNN,4/17/2020,36,22,0,58
GLYNN,4/18/2020,36,22,0,58
GLYNN,4/19/2020,36,22,0,58
GLYNN,4/20/2020,36,22,0,58
GLYNN,4/21/2020,36,22,0,58
GLYNN,4/22/2020,36,23,0,59
GLYNN,4/23/2020,36,23,0,59
GLYNN,4/24/2020,39,24,0,63
GLYNN,4/25/2020,39,24,0,63
GLYNN,4/26/2020,39,25,0,64
GLYNN,4/27/2020,40,26,0,66
GLYNN,4/28/2020,40,27,0,67
GLYNN,4/29/2020,40,29,0,69
GLYNN,4/30/2020,41,29,0,70
GLYNN,5/1/2020,43,31,0,74
GLYNN,5/2/2020,43,31,0,74
GLYNN,5/3/2020,43,31,0,74
GLYNN,5/4/2020,43,33,0,76
GLYNN,5/5/2020,44,35,0,79
GLYNN,5/6/2020,44,35,0,79
GLYNN,5/7/2020,45,35,0,80
GLYNN,5/8/2020,46,36,0,82
GLYNN,5/9/2020,47,36,1,84
GLYNN,5/10/2020,48,36,1,85
GLYNN,5/11/2020,49,37,1,87
GLYNN,5/12/2020,49,37,1,87
GLYNN,5/13/2020,50,37,1,88
GLYNN,5/14/2020,50,37,1,88
GLYNN,5/15/2020,52,40,1,93
GLYNN,5/16/2020,54,40,1,95
GLYNN,5/17/2020,55,41,1,97
GLYNN,5/18/2020,56,41,1,98
GLYNN,5/19/2020,56,43,1,100
GLYNN,5/20/2020,58,44,1,103
GLYNN,5/21/2020,60,45,1,106
GLYNN,5/22/2020,64,48,1,113
GLYNN,5/23/2020,64,52,1,117
GLYNN,5/24/2020,68,53,1,122
GLYNN,5/25/2020,70,54,1,125
GLYNN,5/26/2020,72,58,1,131
GLYNN,5/27/2020,76,60,1,137
IRWIN,3/31/2020,6,4,0,10
IRWIN,4/1/2020,6,4,0,10
IRWIN,4/2/2020,7,4,0,11
IRWIN,4/3/2020,7,4,0,11
IRWIN,4/4/2020,7,4,0,11
IRWIN,4/5/2020,9,4,0,13
IRWIN,4/6/2020,10,4,0,14
IRWIN,4/7/2020,10,4,0,14
IRWIN,4/8/2020,10,4,0,14
IRWIN,4/9/2020,10,4,0,14
IRWIN,4/10/2020,10,4,0,14
IRWIN,4/11/2020,10,4,0,14
IRWIN,4/12/2020,10,4,0,14
IRWIN,4/13/2020,10,4,0,14
IRWIN,4/14/2020,10,4,0,14
IRWIN,4/15/2020,10,4,0,14
IRWIN,4/16/2020,11,4,0,15
IRWIN,4/17/2020,11,5,0,16
IRWIN,4/18/2020,11,5,0,16
IRWIN,4/19/2020,11,5,0,16
IRWIN,4/20/2020,11,5,0,16
IRWIN,4/21/2020,11,5,0,16
IRWIN,4/22/2020,11,5,0,16
IRWIN,4/23/2020,11,5,0,16
IRWIN,4/24/2020,11,6,0,17
IRWIN,4/25/2020,11,6,0,17
IRWIN,4/26/2020,11,6,0,17
IRWIN,4/27/2020,11,7,0,18
IRWIN,4/28/2020,11,7,0,18
IRWIN,4/29/2020,11,8,0,19
IRWIN,4/30/2020,11,8,0,19
IRWIN,5/1/2020,13,8,0,21
IRWIN,5/2/2020,13,8,0,21
IRWIN,5/3/2020,14,9,0,23
IRWIN,5/4/2020,14,9,0,23
IRWIN,5/5/2020,14,9,0,23
IRWIN,5/6/2020,14,10,0,24
IRWIN,5/7/2020,14,10,0,24
IRWIN,5/8/2020,14,10,0,24
IRWIN,5/9/2020,14,11,0,25
IRWIN,5/10/2020,14,12,0,26
IRWIN,5/11/2020,14,12,0,26
IRWIN,5/12/2020,14,13,0,27
IRWIN,5/13/2020,14,13,0,27
IRWIN,5/14/2020,14,13,0,27
IRWIN,5/15/2020,14,13,0,27
IRWIN,5/16/2020,14,13,0,27
IRWIN,5/17/2020,14,13,0,27
IRWIN,5/18/2020,14,14,0,28
IRWIN,5/19/2020,14,14,0,28
IRWIN,5/20/2020,14,14,0,28
IRWIN,5/21/2020,14,14,0,28
IRWIN,5/22/2020,14,16,0,30
IRWIN,5/23/2020,14,16,0,30
IRWIN,5/24/2020,14,16,0,30
IRWIN,5/25/2020,14,16,0,30
IRWIN,5/26/2020,15,17,0,32
IRWIN,5/27/2020,15,17,0,32
IRWIN,5/28/2020,16,19,0,35
IRWIN,5/29/2020,16,19,0,35
IRWIN,5/30/2020,16,19,0,35
IRWIN,5/31/2020,16,19,0,35
IRWIN,6/1/2020,17,19,0,36
IRWIN,6/2/2020,18,20,0,38
IRWIN,6/3/2020,18,21,0,39
IRWIN,6/4/2020,18,22,0,40
IRWIN,6/5/2020,18,23,0,41
IRWIN,6/6/2020,18,23,0,41
IRWIN,6/7/2020,18,23,0,41
IRWIN,6/8/2020,19,24,0,43
IRWIN,6/9/2020,19,24,0,43
IRWIN,6/10/2020,19,24,0,43
IRWIN,6/11/2020,19,26,0,45
IRWIN,6/12/2020,19,26,0,45
IRWIN,6/13/2020,19,27,0,46
IRWIN,6/14/2020,19,27,0,46
IRWIN,6/15/2020,19,28,0,47
IRWIN,6/16/2020,20,28,0,48
IRWIN,6/17/2020,20,29,0,49
IRWIN,6/18/2020,20,31,1,52
IRWIN,6/19/2020,20,31,1,52
IRWIN,6/20/2020,20,32,1,53
IRWIN,6/21/2020,23,33,1,57
IRWIN,6/22/2020,23,34,1,58
IRWIN,6/23/2020,28,35,1,64
IRWIN,6/24/2020,31,36,1,68
IRWIN,6/25/2020,32,37,1,70
IRWIN,6/26/2020,33,40,1,74
IRWIN,6/27/2020,33,40,1,74
IRWIN,6/28/2020,35,40,1,76
IRWIN,6/29/2020,38,44,1,83
IRWIN,6/30/2020,40,44,1,85
IRWIN,7/1/2020,43,47,1,91
IRWIN,7/2/2020,43,48,1,92
IRWIN,7/3/2020,44,48,1,93
IRWIN,7/4/2020,47,49,1,97
IRWIN,7/5/2020,49,52,1,102
IRWIN,7/6/2020,50,55,1,106
IRWIN,7/7/2020,54,57,1,112
IRWIN,7/8/2020,54,58,1,113
IRWIN,7/9/2020,56,58,1,115
IRWIN,7/10/2020,57,58,1,116
IRWIN,7/11/2020,57,58,1,116
IRWIN,7/12/2020,58,58,1,117
IRWIN,7/13/2020,60,59,1,120
IRWIN,7/14/2020,60,60,1,121
IRWIN,7/15/2020,63,62,1,126
IRWIN,7/16/2020,64,62,1,127
IRWIN,7/17/2020,68,64,1,133
IRWIN,7/18/2020,68,64,1,133
IRWIN,7/19/2020,69,64,1,134
IRWIN,7/20/2020,71,67,1,139
IRWIN,7/21/2020,75,70,1,146
IRWIN,7/22/2020,79,72,1,152
IRWIN,7/23/2020,80,73,1,154
IRWIN,7/24/2020,82,77,1,160
IRWIN,7/25/2020,83,77,1,161
IRWIN,7/26/2020,83,77,1,161
IRWIN,7/27/2020,84,78,1,163
IRWIN,7/28/2020,85,79,1,165
IRWIN,7/29/2020,88,80,1,169
IRWIN,7/30/2020,89,80,1,170
IRWIN,7/31/2020,89,81,1,171
IRWIN,8/1/2020,89,81,1,171
IRWIN,8/2/2020,89,82,1,172
IRWIN,8/3/2020,90,83,1,174
IRWIN,8/4/2020,91,84,1,176
IRWIN,8/5/2020,94,86,1,181
IRWIN,8/6/2020,94,87,2,183
IRWIN,8/7/2020,94,87,2,183
IRWIN,8/8/2020,94,87,2,183
IRWIN,8/9/2020,94,88,2,184
IRWIN,8/10/2020,96,88,2,186
IRWIN,8/11/2020,96,91,2,189
IRWIN,8/12/2020,97,92,2,191
IRWIN,8/13/2020,101,92,2,195
IRWIN,8/14/2020,101,92,2,195
IRWIN,8/15/2020,102,92,2,196
IRWIN,8/16/2020,102,92,2,196
IRWIN,8/17/2020,105,94,2,201
IRWIN,8/18/2020,105,95,2,202
IRWIN,8/19/2020,107,95,2,204
IRWIN,8/20/2020,108,103,2,213
IRWIN,8/21/2020,109,107,2,218
IRWIN,8/22/2020,110,107,2,219
IRWIN,8/23/2020,112,108,2,222
IRWIN,8/24/2020,117,110,2,229
IRWIN,8/25/2020,120,111,2,233
IRWIN,8/26/2020,123,111,2,236
IRWIN,8/27/2020,125,112,2,239
IRWIN,8/28/2020,126,114,2,242
IRWIN,8/29/2020,126,114,2,242
IRWIN,8/30/2020,127,114,2,243
IRWIN,8/31/2020,127,114,2,243
IRWIN,9/1/2020,127,116,2,245
IRWIN,9/2/2020,129,118,2,249
IRWIN,9/3/2020,131,121,2,254
IRWIN,9/4/2020,134,124,2,260
IRWIN,9/5/2020,134,125,2,261
IRWIN,9/6/2020,134,125,2,261
IRWIN,9/7/2020,134,125,2,261
IRWIN,9/8/2020,135,125,2,262
IRWIN,9/9/2020,135,125,2,262
IRWIN,9/10/2020,136,126,2,264
IRWIN,9/11/2020,141,133,2,276
IRWIN,9/12/2020,141,134,2,277
IRWIN,9/13/2020,143,134,2,279
IRWIN,9/14/2020,144,135,3,282
IRWIN,9/15/2020,146,137,3,286
IRWIN,9/16/2020,146,141,3,290
IRWIN,9/17/2020,146,147,3,296
IRWIN,9/18/2020,146,147,3,296
IRWIN,9/19/2020,146,148,3,297
IRWIN,9/20/2020,148,149,3,300
IRWIN,9/21/2020,148,150,3,301
IRWIN,9/22/2020,150,151,3,304
IRWIN,9/23/2020,150,152,3,305
IRWIN,9/24/2020,151,152,3,306
IRWIN,9/25/2020,151,154,3,308
IRWIN,9/26/2020,153,155,3,311
IRWIN,9/27/2020,156,158,3,317
IRWIN,9/28/2020,159,158,3,320
IRWIN,9/29/2020,161,159,3,323
IRWIN,9/30/2020,163,159,3,325
IRWIN,10/1/2020,165,160,3,328
IRWIN,10/2/2020,166,161,3,330
IRWIN,10/3/2020,167,161,3,331
IRWIN,10/4/2020,171,161,3,335
IRWIN,10/5/2020,171,161,3,335
IRWIN,10/6/2020,171,161,3,335
IRWIN,10/7/2020,171,161,3,335
IRWIN,10/8/2020,173,163,3,339
IRWIN,10/9/2020,174,164,3,341
IRWIN,10/10/2020,174,164,3,341
IRWIN,10/11/2020,174,165,3,342
IRWIN,10/12/2020,174,165,3,342
IRWIN,10/13/2020,176,167,3,346
IRWIN,10/14/2020,176,169,3,348
IRWIN,10/15/2020,176,170,3,349
IRWIN,10/16/2020,176,170,3,349
IRWIN,10/17/2020,176,170,3,349
IRWIN,10/18/2020,176,170,3,349
IRWIN,10/19/2020,176,170,3,349
IRWIN,10/20/2020,176,170,3,349
JENKINS,1/1/2020,0,0,0,0
JENKINS,1/2/2020,0,0,0,0
JENKINS,1/3/2020,0,0,0,0
JENKINS,1/4/2020,0,0,0,0
JENKINS,1/5/2020,0,0,0,0
JENKINS,1/6/2020,0,0,0,0
JENKINS,1/7/2020,0,0,0,0
JENKINS,1/8/2020,0,0,0,0
JENKINS,1/9/2020,0,0,0,0
JENKINS,1/10/2020,0,0,0,0
JENKINS,1/11/2020,0,0,0,0
JENKINS,1/12/2020,0,0,0,0
JENKINS,1/13/2020,0,0,0,0
JENKINS,1/14/2020,0,0,0,0
JENKINS,1/15/2020,0,0,0,0
JENKINS,1/16/2020,0,0,0,0
JENKINS,1/17/2020,0,0,0,0
JENKINS,1/18/2020,0,0,0,0
JENKINS,1/19/2020,0,0,0,0
JENKINS,1/20/2020,0,0,0,0
JENKINS,1/21/2020,0,0,0,0
JENKINS,1/22/2020,0,0,0,0
JENKINS,1/23/2020,0,0,0,0
JENKINS,1/24/2020,0,0,0,0
JENKINS,1/25/2020,0,0,0,0
JENKINS,1/26/2020,0,0,0,0
JENKINS,1/27/2020,0,0,0,0
JENKINS,1/28/2020,0,0,0,0
JENKINS,1/29/2020,0,0,0,0
JENKINS,1/30/2020,0,0,0,0
JENKINS,1/31/2020,0,0,0,0
JENKINS,2/1/2020,0,0,0,0
JENKINS,2/2/2020,0,0,0,0
JENKINS,2/3/2020,0,0,0,0
JENKINS,2/4/2020,0,0,0,0
JENKINS,2/5/2020,0,0,0,0
JENKINS,2/6/2020,0,0,0,0
JENKINS,2/7/2020,0,0,0,0
JENKINS,2/8/2020,0,0,0,0
JENKINS,2/9/2020,0,0,0,0
JENKINS,2/10/2020,0,0,0,0
JENKINS,2/11/2020,0,0,0,0
JENKINS,2/12/2020,0,0,0,0
JENKINS,2/13/2020,0,0,0,0
JENKINS,2/14/2020,0,0,0,0
JENKINS,2/15/2020,0,0,0,0
JENKINS,2/16/2020,0,0,0,0
JENKINS,2/17/2020,0,0,0,0
JENKINS,2/18/2020,0,0,0,0
JENKINS,2/19/2020,0,0,0,0
JENKINS,2/20/2020,0,0,0,0
JENKINS,2/21/2020,0,0,0,0
JENKINS,2/22/2020,0,0,0,0
JENKINS,2/23/2020,0,0,0,0
JENKINS,2/24/2020,0,0,0,0
JENKINS,2/25/2020,0,0,0,0
JENKINS,2/26/2020,0,0,0,0
JENKINS,2/27/2020,0,0,0,0
JENKINS,2/28/2020,0,0,0,0
JENKINS,2/29/2020,0,0,0,0
JENKINS,3/1/2020,0,0,0,0
JENKINS,3/2/2020,0,0,0,0
JENKINS,3/3/2020,0,0,0,0
JENKINS,3/4/2020,0,0,0,0
JENKINS,3/5/2020,0,0,0,0
JENKINS,3/6/2020,0,0,0,0
JENKINS,3/7/2020,0,0,0,0
JENKINS,3/8/2020,0,0,0,0
JENKINS,3/9/2020,0,0,0,0
JENKINS,3/10/2020,0,0,0,0
JENKINS,3/11/2020,0,0,0,0
JENKINS,3/12/2020,0,0,0,0
JENKINS,3/13/2020,1,0,0,1
JENKINS,3/14/2020,1,0,0,1
JENKINS,3/15/2020,1,0,0,1
JENKINS,3/16/2020,1,0,0,1
JENKINS,3/17/2020,1,0,0,1
JENKINS,3/18/2020,2,0,0,2
JENKINS,3/19/2020,2,0,0,2
JENKINS,3/20/2020,2,0,0,2
JENKINS,3/21/2020,3,0,0,3
JENKINS,3/22/2020,3,0,0,3
JENKINS,3/23/2020,3,0,0,3
JENKINS,3/24/2020,3,0,0,3
JENKINS,3/25/2020,3,1,0,4
JENKINS,3/26/2020,3,2,0,5
JENKINS,3/27/2020,4,4,0,8
JENKINS,3/28/2020,4,4,0,8
JENKINS,3/29/2020,4,4,0,8
JENKINS,3/30/2020,5,4,0,9
JENKINS,3/31/2020,5,4,0,9
JENKINS,4/1/2020,5,4,0,9
JENKINS,4/2/2020,5,4,0,9
JENKINS,4/3/2020,5,4,0,9
JENKINS,4/4/2020,5,4,0,9
JENKINS,4/5/2020,5,4,0,9
JENKINS,4/6/2020,7,4,0,11
JENKINS,4/7/2020,7,4,0,11
JENKINS,4/8/2020,7,4,0,11
JENKINS,4/9/2020,9,4,0,13
JENKINS,4/10/2020,9,4,0,13
JENKINS,4/11/2020,9,4,0,13
JENKINS,4/12/2020,10,4,0,14
JENKINS,4/13/2020,11,5,0,16
JENKINS,4/14/2020,11,6,0,17
JENKINS,4/15/2020,11,6,0,17
JENKINS,4/16/2020,11,6,0,17
JENKINS,4/17/2020,11,6,0,17
JENKINS,4/18/2020,11,6,0,17
JENKINS,4/19/2020,12,6,0,18
JENKINS,4/20/2020,13,6,0,19
JENKINS,4/21/2020,13,7,0,20
JENKINS,4/22/2020,13,7,0,20
JENKINS,4/23/2020,13,7,0,20
JENKINS,4/24/2020,13,7,0,20
JENKINS,4/25/2020,13,7,0,20
JENKINS,4/26/2020,13,7,0,20
JENKINS,4/27/2020,13,7,0,20
JENKINS,4/28/2020,13,7,0,20
JENKINS,4/29/2020,13,7,0,20
JENKINS,4/30/2020,13,7,0,20
JENKINS,5/1/2020,13,7,0,20
JENKINS,5/2/2020,13,7,0,20
JENKINS,5/3/2020,13,7,0,20
JENKINS,5/4/2020,13,7,0,20
JENKINS,5/5/2020,13,7,0,20
JENKINS,5/6/2020,13,7,0,20
JENKINS,5/7/2020,13,7,0,20
JENKINS,5/8/2020,13,8,0,21
JENKINS,5/9/2020,13,8,0,21
JENKINS,5/10/2020,13,8,0,21
JENKINS,5/11/2020,13,8,0,21
JENKINS,5/12/2020,13,8,0,21
JENKINS,5/13/2020,13,8,0,21
JENKINS,5/14/2020,13,8,0,21
JENKINS,5/15/2020,13,8,0,21
JENKINS,5/16/2020,13,8,0,21
JENKINS,5/17/2020,13,8,0,21
JENKINS,5/18/2020,13,8,0,21
JENKINS,5/19/2020,13,8,0,21
JENKINS,5/20/2020,13,8,0,21
JENKINS,5/21/2020,14,9,0,23
JENKINS,5/22/2020,18,9,0,27
JENKINS,5/23/2020,19,9,0,28
JENKINS,5/24/2020,19,9,0,28
JENKINS,5/25/2020,19,9,0,28
JENKINS,5/26/2020,21,9,0,30
JENKINS,5/27/2020,22,9,0,31
JENKINS,5/28/2020,22,10,0,32
JENKINS,5/29/2020,25,11,0,36
JENKINS,5/30/2020,26,11,0,37
JENKINS,5/31/2020,29,12,0,41
JENKINS,6/1/2020,29,12,0,41
JENKINS,6/2/2020,31,12,0,43
JENKINS,6/3/2020,36,15,0,51
JENKINS,6/4/2020,37,16,0,53
JENKINS,6/5/2020,38,16,0,54
JENKINS,6/6/2020,38,16,0,54
JENKINS,6/7/2020,44,17,0,61
JENKINS,6/8/2020,44,17,0,61
JENKINS,6/9/2020,54,21,0,75
JENKINS,6/10/2020,56,24,0,80
JENKINS,6/11/2020,57,25,0,82
JENKINS,6/12/2020,57,27,0,84
JENKINS,6/13/2020,59,29,0,88
JENKINS,6/14/2020,60,29,0,89
JENKINS,6/15/2020,61,29,0,90
JENKINS,6/16/2020,62,29,0,91
JENKINS,6/17/2020,67,33,0,100
JENKINS,6/18/2020,70,36,0,106
JENKINS,6/19/2020,72,38,0,110
JENKINS,6/20/2020,72,39,0,111
JENKINS,6/21/2020,73,41,0,114
JENKINS,6/22/2020,76,42,0,118
JENKINS,6/23/2020,85,42,0,127
JENKINS,6/24/2020,86,44,0,130
JENKINS,6/25/2020,87,44,0,131
JENKINS,6/26/2020,87,44,0,131
JENKINS,6/27/2020,89,48,0,137
JENKINS,6/28/2020,90,48,0,138
JENKINS,6/29/2020,91,50,0,141
JENKINS,6/30/2020,92,50,0,142
JENKINS,7/1/2020,92,50,0,142
JENKINS,7/2/2020,95,55,0,150
JENKINS,7/3/2020,95,58,0,153
JENKINS,7/4/2020,96,58,0,154
JENKINS,7/5/2020,99,61,0,160
JENKINS,7/6/2020,102,65,0,167
JENKINS,7/7/2020,105,66,0,171
JENKINS,7/8/2020,111,71,0,182
JENKINS,7/9/2020,115,71,0,186
JENKINS,7/10/2020,117,73,0,190
JENKINS,7/11/2020,118,73,0,191
JENKINS,7/12/2020,119,73,0,192
JENKINS,7/13/2020,124,75,0,199
JENKINS,7/14/2020,124,77,0,201
HARALSON,10/5/2020,273,263,18,554
JENKINS,7/15/2020,125,77,0,202
HABERSHAM,6/21/2020,383,308,7,698
GWINNETT,3/7/2020,17,15,0,32
HARALSON,10/6/2020,278,264,18,560
JENKINS,7/16/2020,128,79,0,207
GWINNETT,3/8/2020,19,17,0,36
HABERSHAM,6/22/2020,387,311,7,705
HARALSON,10/7/2020,279,266,18,563
JENKINS,7/17/2020,131,79,0,210
GWINNETT,3/9/2020,22,19,0,41
HABERSHAM,6/23/2020,390,312,7,709
HARALSON,10/8/2020,280,269,18,567
HARALSON,10/9/2020,283,270,18,571
HARALSON,10/10/2020,286,271,18,575
HARALSON,10/11/2020,286,272,18,576
HARALSON,10/12/2020,290,274,18,582
HARALSON,10/13/2020,293,276,18,587
HARALSON,10/14/2020,298,278,18,594
HARALSON,10/15/2020,298,279,18,595
HARALSON,10/16/2020,303,282,18,603
HARALSON,10/17/2020,304,282,18,604
HARALSON,10/18/2020,304,282,18,604
HARALSON,10/19/2020,304,282,18,604
HARALSON,10/20/2020,304,282,18,604
HEARD,1/1/2020,0,0,0,0
HEARD,1/2/2020,0,0,0,0
HEARD,1/3/2020,0,0,0,0
HEARD,1/4/2020,0,0,0,0
HEARD,1/5/2020,0,0,0,0
HEARD,1/6/2020,0,0,0,0
HEARD,1/7/2020,0,0,0,0
HEARD,1/8/2020,0,0,0,0
HEARD,1/9/2020,0,0,0,0
HEARD,1/10/2020,0,0,0,0
HEARD,1/11/2020,0,0,0,0
HEARD,1/12/2020,0,0,0,0
HEARD,1/13/2020,0,0,0,0
HEARD,1/14/2020,0,0,0,0
HEARD,1/15/2020,0,0,0,0
HEARD,1/16/2020,0,0,0,0
HEARD,1/17/2020,0,0,0,0
HEARD,1/18/2020,0,0,0,0
HEARD,1/19/2020,0,0,0,0
HEARD,1/20/2020,0,0,0,0
HEARD,1/21/2020,0,0,0,0
HEARD,1/22/2020,0,0,0,0
HEARD,1/23/2020,0,0,0,0
HEARD,1/24/2020,0,0,0,0
HEARD,1/25/2020,0,0,0,0
HEARD,1/26/2020,0,0,0,0
HEARD,1/27/2020,0,0,0,0
HEARD,1/28/2020,0,0,0,0
HEARD,1/29/2020,0,0,0,0
HEARD,1/30/2020,0,0,0,0
HEARD,1/31/2020,0,0,0,0
HEARD,2/1/2020,0,0,0,0
HEARD,2/2/2020,0,0,0,0
HEARD,2/3/2020,0,0,0,0
HEARD,2/4/2020,0,0,0,0
HEARD,2/5/2020,0,0,0,0
HEARD,2/6/2020,0,0,0,0
HEARD,2/7/2020,0,0,0,0
HEARD,2/8/2020,0,0,0,0
HEARD,2/9/2020,0,0,0,0
HEARD,2/10/2020,0,0,0,0
HEARD,2/11/2020,0,0,0,0
HEARD,2/12/2020,0,0,0,0
HEARD,2/13/2020,0,0,0,0
HEARD,2/14/2020,0,0,0,0
HEARD,2/15/2020,0,0,0,0
HEARD,2/16/2020,0,0,0,0
HEARD,2/17/2020,0,0,0,0
HEARD,2/18/2020,0,0,0,0
HEARD,2/19/2020,0,0,0,0
HEARD,2/20/2020,0,0,0,0
HEARD,2/21/2020,0,0,0,0
HEARD,2/22/2020,0,0,0,0
HEARD,2/23/2020,0,0,0,0
HEARD,2/24/2020,0,0,0,0
HEARD,2/25/2020,0,0,0,0
HEARD,2/26/2020,0,0,0,0
HEARD,2/27/2020,0,0,0,0
HEARD,2/28/2020,0,0,0,0
HEARD,2/29/2020,0,0,0,0
HEARD,3/1/2020,0,0,0,0
HEARD,3/2/2020,0,0,0,0
HEARD,3/3/2020,0,0,0,0
HEARD,3/4/2020,0,0,0,0
HEARD,3/5/2020,0,0,0,0
HEARD,3/6/2020,0,0,0,0
HEARD,3/7/2020,0,0,0,0
HEARD,3/8/2020,0,0,0,0
HEARD,3/9/2020,0,0,0,0
HEARD,3/10/2020,1,0,0,1
HEARD,3/11/2020,1,0,0,1
HEARD,3/12/2020,1,0,0,1
HEARD,3/13/2020,1,0,0,1
HEARD,3/14/2020,1,0,0,1
HEARD,3/15/2020,1,0,0,1
HEARD,3/16/2020,1,0,0,1
HEARD,3/17/2020,1,0,0,1
HEARD,3/18/2020,2,0,0,2
HEARD,3/19/2020,2,0,0,2
HEARD,3/20/2020,2,0,0,2
HEARD,3/21/2020,2,0,0,2
HEARD,3/22/2020,2,0,0,2
HEARD,3/23/2020,2,0,0,2
HEARD,3/24/2020,3,0,0,3
HEARD,3/25/2020,3,0,0,3
HEARD,3/26/2020,3,0,0,3
HEARD,3/27/2020,3,0,0,3
HEARD,3/28/2020,3,0,0,3
HEARD,3/29/2020,3,0,0,3
HEARD,3/30/2020,3,0,0,3
HEARD,3/31/2020,3,0,0,3
HEARD,4/1/2020,3,0,0,3
HEARD,4/2/2020,3,0,0,3
HEARD,4/3/2020,3,0,0,3
HEARD,4/4/2020,3,0,0,3
HEARD,4/5/2020,3,0,0,3
HEARD,4/6/2020,3,0,0,3
HEARD,4/7/2020,3,1,0,4
HEARD,4/8/2020,3,1,0,4
HEARD,4/9/2020,3,1,0,4
HEARD,4/10/2020,3,1,0,4
HEARD,4/11/2020,4,1,0,5
HEARD,4/12/2020,4,1,0,5
HEARD,4/13/2020,4,2,0,6
HEARD,4/14/2020,4,3,0,7
HEARD,4/15/2020,4,3,0,7
HEARD,4/16/2020,4,3,0,7
HEARD,4/17/2020,5,4,0,9
HEARD,4/18/2020,5,4,0,9
HEARD,4/19/2020,5,4,0,9
HEARD,4/20/2020,5,5,0,10
HEARD,4/21/2020,5,5,0,10
HEARD,4/22/2020,5,5,0,10
HEARD,4/23/2020,6,5,0,11
HEARD,4/24/2020,7,5,0,12
HEARD,4/25/2020,8,5,0,13
HEARD,4/26/2020,9,5,0,14
HEARD,4/27/2020,9,5,0,14
HEARD,4/28/2020,9,5,0,14
HEARD,4/29/2020,10,6,0,16
HEARD,4/30/2020,10,6,0,16
HEARD,5/1/2020,10,6,0,16
HEARD,5/2/2020,10,6,0,16
HEARD,5/3/2020,10,6,0,16
HEARD,5/4/2020,10,6,0,16
HEARD,5/5/2020,10,7,0,17
HEARD,5/6/2020,10,7,0,17
HEARD,5/7/2020,10,7,0,17
HEARD,5/8/2020,10,8,0,18
HEARD,5/9/2020,12,8,0,20
HEARD,5/10/2020,12,8,0,20
HEARD,5/11/2020,13,9,0,22
HEARD,5/12/2020,14,9,0,23
HEARD,5/13/2020,14,10,0,24
HEARD,5/14/2020,15,11,0,26
HEARD,5/15/2020,15,11,0,26
HEARD,5/16/2020,16,11,0,27
HEARD,5/17/2020,16,11,0,27
HEARD,5/18/2020,17,13,0,30
HEARD,5/19/2020,18,13,0,31
HEARD,5/20/2020,19,13,0,32
HEARD,5/21/2020,19,13,0,32
HEARD,5/22/2020,20,14,0,34
HEARD,5/23/2020,20,14,0,34
HEARD,5/24/2020,20,14,0,34
HEARD,5/25/2020,20,14,0,34
HEARD,5/26/2020,22,14,0,36
HEARD,5/27/2020,22,15,0,37
HEARD,5/28/2020,23,15,0,38
HEARD,5/29/2020,23,15,0,38
HEARD,5/30/2020,24,15,0,39
HEARD,5/31/2020,24,16,0,40
HEARD,6/1/2020,24,16,0,40
HEARD,6/2/2020,24,16,0,40
HEARD,6/3/2020,24,16,0,40
HEARD,6/4/2020,24,17,0,41
HEARD,6/5/2020,25,18,0,43
HEARD,6/6/2020,26,20,0,46
HEARD,6/7/2020,26,21,0,47
HEARD,6/8/2020,26,21,0,47
HEARD,6/9/2020,27,21,0,48
HEARD,6/10/2020,27,22,0,49
HEARD,6/11/2020,27,23,0,50
HEARD,6/12/2020,29,24,0,53
HEARD,6/13/2020,29,24,0,53
HEARD,6/14/2020,29,24,0,53
HEARD,6/15/2020,31,24,0,55
HEARD,6/16/2020,31,25,0,56
HEARD,6/17/2020,32,25,0,57
HEARD,6/18/2020,33,25,0,58
HEARD,6/19/2020,33,25,0,58
HEARD,6/20/2020,35,25,0,60
HEARD,6/21/2020,36,25,0,61
HEARD,6/22/2020,36,25,0,61
HEARD,6/23/2020,37,25,0,62
HEARD,6/24/2020,37,25,0,62
HEARD,6/25/2020,38,25,0,63
HEARD,6/26/2020,38,26,0,64
HEARD,6/27/2020,40,27,0,67
HEARD,6/28/2020,41,27,0,68
HEARD,6/29/2020,42,30,0,72
HEARD,6/30/2020,46,30,0,76
HEARD,7/1/2020,47,31,0,78
HEARD,7/2/2020,47,31,0,78
HEARD,7/3/2020,51,31,0,82
HEARD,7/4/2020,52,32,0,84
HEARD,7/5/2020,53,33,0,86
HEARD,7/6/2020,56,35,0,91
HEARD,7/7/2020,59,35,0,94
HEARD,7/8/2020,62,36,0,98
HEARD,7/9/2020,66,37,0,103
HEARD,7/10/2020,67,38,0,105
HEARD,7/11/2020,70,38,0,108
HEARD,7/12/2020,70,38,0,108
HEARD,7/13/2020,72,41,0,113
HEARD,7/14/2020,75,43,0,118
HEARD,7/15/2020,76,43,0,119
HEARD,7/16/2020,77,43,0,120
HEARD,7/17/2020,80,44,0,124
HEARD,7/18/2020,80,45,0,125
HEARD,7/19/2020,82,46,0,128
HEARD,7/20/2020,84,46,0,130
HEARD,7/21/2020,84,49,0,133
HEARD,7/22/2020,85,50,0,135
HEARD,7/23/2020,86,53,0,139
HEARD,7/24/2020,86,53,0,139
HEARD,7/25/2020,87,54,0,141
HEARD,7/26/2020,87,55,0,142
HEARD,7/27/2020,87,55,0,142
HEARD,7/28/2020,87,56,0,143
HEARD,7/29/2020,87,56,0,143
HEARD,7/30/2020,88,56,0,144
HEARD,7/31/2020,89,56,0,145
HEARD,8/1/2020,89,56,0,145
HEARD,8/2/2020,89,56,0,145
HEARD,8/3/2020,89,57,0,146
HEARD,8/4/2020,91,58,0,149
HEARD,8/5/2020,91,60,0,151
HEARD,8/6/2020,93,61,0,154
HEARD,8/7/2020,93,61,0,154
HEARD,8/8/2020,93,63,0,156
HEARD,8/9/2020,93,64,0,157
HEARD,8/10/2020,93,64,0,157
HEARD,8/11/2020,93,65,0,158
HEARD,8/12/2020,95,65,0,160
HEARD,8/13/2020,95,65,0,160
HEARD,8/14/2020,95,66,0,161
HEARD,8/15/2020,96,67,0,163
HEARD,8/16/2020,97,67,0,164
HEARD,8/17/2020,98,68,0,166
HEARD,8/18/2020,99,70,0,169
HEARD,8/19/2020,101,71,0,172
HEARD,8/20/2020,101,71,0,172
HEARD,8/21/2020,102,71,0,173
HEARD,8/22/2020,103,72,0,175
HEARD,8/23/2020,103,73,0,176
HEARD,8/24/2020,103,74,0,177
HEARD,8/25/2020,104,74,0,178
HEARD,8/26/2020,105,74,0,179
HEARD,8/27/2020,105,74,0,179
HEARD,8/28/2020,105,75,0,180
HEARD,8/29/2020,105,76,0,181
HEARD,8/30/2020,105,76,0,181
HEARD,8/31/2020,107,76,0,183
HEARD,9/1/2020,107,77,0,184
HEARD,9/2/2020,108,78,0,186
HEARD,9/3/2020,108,78,0,186
HEARD,9/4/2020,109,78,0,187
HEARD,9/5/2020,109,79,0,188
HEARD,9/6/2020,109,79,0,188
HEARD,9/7/2020,109,80,0,189
HEARD,9/8/2020,109,81,0,190
HEARD,9/9/2020,109,81,0,190
HEARD,9/10/2020,109,83,0,192
HEARD,9/11/2020,109,84,0,193
HEARD,9/12/2020,109,84,0,193
HEARD,9/13/2020,110,84,0,194
HEARD,9/14/2020,110,84,0,194
HEARD,9/15/2020,110,84,0,194
HEARD,9/16/2020,110,84,0,194
HEARD,9/17/2020,110,84,0,194
HEARD,9/18/2020,110,84,0,194
HEARD,9/19/2020,110,84,0,194
HEARD,9/20/2020,110,84,0,194
HEARD,9/21/2020,111,85,0,196
HEARD,9/22/2020,111,86,0,197
HEARD,9/23/2020,112,86,0,198
HEARD,9/24/2020,113,86,0,199
HEARD,9/25/2020,113,87,0,200
HEARD,9/26/2020,113,88,0,201
HEARD,9/27/2020,113,88,0,201
HEARD,9/28/2020,114,89,0,203
HEARD,9/29/2020,114,89,0,203
HEARD,9/30/2020,114,90,0,204
HEARD,10/1/2020,114,90,0,204
HEARD,10/2/2020,114,90,0,204
HEARD,10/3/2020,114,91,0,205
HEARD,10/4/2020,114,92,0,206
HEARD,10/5/2020,114,92,0,206
HEARD,10/6/2020,115,92,0,207
HEARD,10/7/2020,115,92,0,207
HEARD,10/8/2020,116,92,0,208
HEARD,10/9/2020,116,92,0,208
HEARD,10/10/2020,117,92,0,209
HEARD,10/11/2020,117,92,0,209
HEARD,10/12/2020,118,92,0,210
HEARD,10/13/2020,118,92,0,210
HEARD,10/14/2020,118,92,0,210
HEARD,10/15/2020,118,92,0,210
HEARD,10/16/2020,120,92,0,212
HEARD,10/17/2020,120,92,0,212
HEARD,10/18/2020,120,92,0,212
HEARD,10/19/2020,120,92,0,212
HEARD,10/20/2020,120,92,0,212
IRWIN,1/1/2020,0,0,0,0
IRWIN,1/2/2020,0,0,0,0
IRWIN,1/3/2020,0,0,0,0
IRWIN,1/4/2020,0,0,0,0
IRWIN,1/5/2020,0,0,0,0
IRWIN,1/6/2020,0,0,0,0
IRWIN,1/7/2020,0,0,0,0
IRWIN,1/8/2020,0,0,0,0
IRWIN,1/9/2020,0,0,0,0
IRWIN,1/10/2020,0,0,0,0
IRWIN,1/11/2020,0,0,0,0
IRWIN,1/12/2020,0,0,0,0
IRWIN,1/13/2020,0,0,0,0
IRWIN,1/14/2020,0,0,0,0
IRWIN,1/15/2020,0,0,0,0
IRWIN,1/16/2020,0,0,0,0
IRWIN,1/17/2020,0,0,0,0
IRWIN,1/18/2020,0,0,0,0
IRWIN,1/19/2020,0,0,0,0
IRWIN,1/20/2020,0,0,0,0
IRWIN,1/21/2020,0,0,0,0
IRWIN,1/22/2020,0,0,0,0
IRWIN,1/23/2020,0,0,0,0
IRWIN,1/24/2020,0,0,0,0
IRWIN,1/25/2020,0,0,0,0
IRWIN,1/26/2020,0,0,0,0
IRWIN,1/27/2020,0,0,0,0
IRWIN,1/28/2020,0,0,0,0
IRWIN,1/29/2020,0,0,0,0
IRWIN,1/30/2020,0,0,0,0
IRWIN,1/31/2020,0,0,0,0
IRWIN,2/1/2020,0,0,0,0
IRWIN,2/2/2020,0,0,0,0
IRWIN,2/3/2020,0,0,0,0
IRWIN,2/4/2020,0,0,0,0
IRWIN,2/5/2020,0,0,0,0
IRWIN,2/6/2020,0,0,0,0
IRWIN,2/7/2020,0,0,0,0
IRWIN,2/8/2020,0,0,0,0
IRWIN,2/9/2020,0,0,0,0
IRWIN,2/10/2020,0,0,0,0
IRWIN,2/11/2020,0,0,0,0
IRWIN,2/12/2020,0,0,0,0
IRWIN,2/13/2020,0,0,0,0
IRWIN,2/14/2020,0,0,0,0
IRWIN,2/15/2020,0,0,0,0
IRWIN,2/16/2020,0,0,0,0
IRWIN,2/17/2020,0,0,0,0
IRWIN,2/18/2020,0,0,0,0
IRWIN,2/19/2020,0,0,0,0
IRWIN,2/20/2020,0,0,0,0
IRWIN,2/21/2020,0,0,0,0
IRWIN,2/22/2020,0,0,0,0
IRWIN,2/23/2020,0,0,0,0
IRWIN,2/24/2020,0,0,0,0
IRWIN,2/25/2020,0,0,0,0
IRWIN,2/26/2020,0,0,0,0
IRWIN,2/27/2020,0,0,0,0
IRWIN,2/28/2020,0,0,0,0
IRWIN,2/29/2020,0,0,0,0
IRWIN,3/1/2020,0,0,0,0
IRWIN,3/2/2020,0,0,0,0
IRWIN,3/3/2020,0,0,0,0
IRWIN,3/4/2020,0,0,0,0
IRWIN,3/5/2020,0,0,0,0
IRWIN,3/6/2020,0,0,0,0
IRWIN,3/7/2020,0,0,0,0
IRWIN,3/8/2020,0,0,0,0
IRWIN,3/9/2020,0,0,0,0
IRWIN,3/10/2020,0,0,0,0
IRWIN,3/11/2020,0,0,0,0
IRWIN,3/12/2020,0,0,0,0
IRWIN,3/13/2020,0,0,0,0
IRWIN,3/14/2020,0,0,0,0
IRWIN,3/15/2020,0,0,0,0
IRWIN,3/16/2020,0,0,0,0
IRWIN,3/17/2020,0,0,0,0
IRWIN,3/18/2020,1,0,0,1
IRWIN,3/19/2020,3,0,0,3
IRWIN,3/20/2020,3,0,0,3
IRWIN,3/21/2020,3,0,0,3
IRWIN,3/22/2020,3,0,0,3
IRWIN,3/23/2020,3,0,0,3
IRWIN,3/24/2020,4,0,0,4
IRWIN,3/25/2020,5,0,0,5
IRWIN,3/26/2020,5,1,0,6
IRWIN,3/27/2020,5,2,0,7
IRWIN,3/28/2020,5,2,0,7
IRWIN,3/29/2020,5,2,0,7
IRWIN,3/30/2020,6,3,0,9
JENKINS,7/18/2020,133,80,0,213
HABERSHAM,6/24/2020,397,317,8,722
GWINNETT,3/10/2020,29,26,0,55
JENKINS,7/19/2020,133,80,0,213
GWINNETT,3/11/2020,30,32,1,63
GWINNETT,3/12/2020,33,42,1,76
GWINNETT,3/13/2020,41,49,1,91
GWINNETT,3/14/2020,49,56,1,106
GWINNETT,3/15/2020,57,60,2,119
GWINNETT,3/16/2020,67,71,2,140
GWINNETT,3/17/2020,85,85,2,172
GWINNETT,3/18/2020,95,104,2,201
GWINNETT,3/19/2020,107,113,2,222
GWINNETT,3/20/2020,120,130,2,252
GWINNETT,3/21/2020,133,143,2,278
GWINNETT,3/22/2020,138,154,2,294
GWINNETT,3/23/2020,157,172,2,331
GWINNETT,3/24/2020,169,181,2,352
GWINNETT,3/25/2020,181,203,2,386
GWINNETT,3/26/2020,206,213,2,421
GWINNETT,3/27/2020,222,219,2,443
GWINNETT,3/28/2020,230,231,2,463
GWINNETT,3/29/2020,241,235,2,478
GWINNETT,3/30/2020,263,255,2,520
GWINNETT,3/31/2020,280,273,2,555
GWINNETT,4/1/2020,302,296,2,600
GWINNETT,4/2/2020,325,317,2,644
GWINNETT,4/3/2020,357,330,2,689
GWINNETT,4/4/2020,375,344,2,721
GWINNETT,4/5/2020,395,356,2,753
GWINNETT,4/6/2020,427,368,3,798
GWINNETT,4/7/2020,451,386,4,841
GWINNETT,4/8/2020,479,404,4,887
GWINNETT,4/9/2020,499,429,4,932
GWINNETT,4/10/2020,528,448,4,980
GWINNETT,4/11/2020,544,460,4,1008
GWINNETT,4/12/2020,562,470,4,1036
GWINNETT,4/13/2020,594,487,5,1086
GWINNETT,4/14/2020,618,512,5,1135
GWINNETT,4/15/2020,644,541,5,1190
GWINNETT,4/16/2020,664,567,5,1236
GWINNETT,4/17/2020,696,600,7,1303
GWINNETT,4/18/2020,725,618,8,1351
GWINNETT,4/19/2020,745,636,8,1389
GWINNETT,4/20/2020,786,677,10,1473
GWINNETT,4/21/2020,839,722,12,1573
GWINNETT,4/22/2020,886,769,14,1669
GWINNETT,4/23/2020,931,805,14,1750
GWINNETT,4/24/2020,965,840,14,1819
GWINNETT,4/25/2020,979,863,14,1856
GWINNETT,4/26/2020,995,881,14,1890
GWINNETT,4/27/2020,1040,916,21,1977
GWINNETT,4/28/2020,1085,967,22,2074
GWINNETT,4/29/2020,1111,999,22,2132
GWINNETT,4/30/2020,1149,1033,22,2204
GWINNETT,5/1/2020,1194,1067,22,2283
GWINNETT,5/2/2020,1221,1087,22,2330
GWINNETT,5/3/2020,1235,1095,23,2353
GWINNETT,5/4/2020,1271,1132,24,2427
GWINNETT,5/5/2020,1304,1164,26,2494
GWINNETT,5/6/2020,1332,1201,30,2563
GWINNETT,5/7/2020,1354,1224,34,2612
GWINNETT,5/8/2020,1383,1264,37,2684
GWINNETT,5/9/2020,1403,1280,40,2723
GWINNETT,5/10/2020,1421,1299,42,2762
GWINNETT,5/11/2020,1457,1323,43,2823
GWINNETT,5/12/2020,1496,1353,46,2895
GWINNETT,5/13/2020,1529,1387,48,2964
GWINNETT,5/14/2020,1574,1424,51,3049
GWINNETT,5/15/2020,1619,1460,52,3131
GWINNETT,5/16/2020,1648,1490,52,3190
GWINNETT,5/17/2020,1672,1513,53,3238
GWINNETT,5/18/2020,1711,1555,53,3319
GWINNETT,5/19/2020,1758,1598,54,3410
GWINNETT,5/20/2020,1810,1653,55,3518
GWINNETT,5/21/2020,1850,1697,56,3603
GWINNETT,5/22/2020,1898,1764,56,3718
GWINNETT,5/23/2020,1942,1805,56,3803
GWINNETT,5/24/2020,1974,1835,58,3867
GWINNETT,5/25/2020,1996,1866,58,3920
GWINNETT,5/26/2020,2063,1913,61,4037
GWINNETT,5/27/2020,2133,1961,61,4155
GWINNETT,5/28/2020,2186,1998,61,4245
GWINNETT,5/29/2020,2236,2048,61,4345
GWINNETT,5/30/2020,2286,2088,62,4436
GWINNETT,5/31/2020,2308,2106,62,4476
GWINNETT,6/1/2020,2371,2180,62,4613
GWINNETT,6/2/2020,2451,2239,64,4754
GWINNETT,6/3/2020,2508,2293,64,4865
GWINNETT,6/4/2020,2574,2344,67,4985
GWINNETT,6/5/2020,2651,2398,68,5117
GWINNETT,6/6/2020,2696,2452,70,5218
GWINNETT,6/7/2020,2728,2485,71,5284
GWINNETT,6/8/2020,2796,2581,72,5449
GWINNETT,6/9/2020,2870,2652,75,5597
GWINNETT,6/10/2020,2952,2728,77,5757
GWINNETT,6/11/2020,3021,2796,83,5900
GWINNETT,6/12/2020,3090,2852,85,6027
GWINNETT,6/13/2020,3178,2930,86,6194
GWINNETT,6/14/2020,3237,2982,87,6306
GWINNETT,6/15/2020,3371,3114,89,6574
GWINNETT,6/16/2020,3468,3215,91,6774
GWINNETT,6/17/2020,3602,3323,94,7019
GWINNETT,6/18/2020,3726,3424,97,7247
GWINNETT,6/19/2020,3871,3523,99,7493
GWINNETT,6/20/2020,3981,3613,105,7699
GWINNETT,6/21/2020,4040,3685,106,7831
GWINNETT,6/22/2020,4232,3884,117,8233
GWINNETT,6/23/2020,4401,4053,123,8577
GWINNETT,6/24/2020,4543,4208,139,8890
GWINNETT,6/25/2020,4739,4374,151,9264
GWINNETT,6/26/2020,4927,4543,169,9639
GWINNETT,6/27/2020,5047,4675,181,9903
GWINNETT,6/28/2020,5141,4760,184,10085
GWINNETT,6/29/2020,5324,4901,205,10430
GWINNETT,6/30/2020,5503,5050,224,10777
GWINNETT,7/1/2020,5715,5232,238,11185
GWINNETT,7/2/2020,5932,5411,254,11597
GWINNETT,7/3/2020,6095,5539,261,11895
GWINNETT,7/4/2020,6183,5610,271,12064
GWINNETT,7/5/2020,6278,5708,273,12259
GWINNETT,7/6/2020,6533,5939,314,12786
GWINNETT,7/7/2020,6761,6184,339,13284
GWINNETT,7/8/2020,6998,6371,350,13719
GWINNETT,7/9/2020,7220,6572,361,14153
GWINNETT,7/10/2020,7451,6756,376,14583
GWINNETT,7/11/2020,7591,6892,386,14869
GWINNETT,7/12/2020,7696,6968,393,15057
GWINNETT,7/13/2020,7944,7156,408,15508
GWINNETT,7/14/2020,8147,7343,437,15927
GWINNETT,7/15/2020,8332,7489,468,16289
GWINNETT,7/16/2020,8555,7672,491,16718
GWINNETT,7/17/2020,8741,7807,496,17044
GWINNETT,7/18/2020,8888,7948,507,17343
GWINNETT,7/19/2020,8952,8008,509,17469
GWINNETT,7/20/2020,9152,8173,519,17844
GWINNETT,7/21/2020,9356,8343,526,18225
GWINNETT,7/22/2020,9529,8487,534,18550
GWINNETT,7/23/2020,9704,8652,545,18901
GWINNETT,7/24/2020,9880,8805,553,19238
GWINNETT,7/25/2020,9990,8914,562,19466
GWINNETT,7/26/2020,10050,8965,563,19578
GWINNETT,7/27/2020,10216,9122,566,19904
GWINNETT,7/28/2020,10366,9264,574,20204
GWINNETT,7/29/2020,10519,9408,584,20511
GWINNETT,7/30/2020,10675,9547,600,20822
GWINNETT,7/31/2020,10805,9660,608,21073
GWINNETT,8/1/2020,10909,9749,616,21274
GWINNETT,8/2/2020,10999,9823,617,21439
GWINNETT,8/3/2020,11151,9957,622,21730
GWINNETT,8/4/2020,11301,10093,631,22025
GWINNETT,8/5/2020,11422,10208,635,22265
GWINNETT,8/6/2020,11558,10326,640,22524
GWINNETT,8/7/2020,11660,10402,645,22707
GWINNETT,8/8/2020,11744,10468,647,22859
GWINNETT,8/9/2020,11803,10528,649,22980
GWINNETT,8/10/2020,11918,10624,651,23193
GWINNETT,8/11/2020,12003,10710,654,23367
GWINNETT,8/12/2020,12112,10791,655,23558
GWINNETT,8/13/2020,12208,10855,656,23719
GWINNETT,8/14/2020,12303,10936,659,23898
GWINNETT,8/15/2020,12366,10990,659,24015
GWINNETT,8/16/2020,12410,11031,660,24101
GWINNETT,8/17/2020,12492,11111,661,24264
GWINNETT,8/18/2020,12574,11188,668,24430
GWINNETT,8/19/2020,12656,11232,670,24558
GWINNETT,8/20/2020,12738,11290,674,24702
GWINNETT,8/21/2020,12804,11357,674,24835
GWINNETT,8/22/2020,12849,11397,674,24920
GWINNETT,8/23/2020,12882,11429,674,24985
GWINNETT,8/24/2020,12965,11498,675,25138
GWINNETT,8/25/2020,13027,11545,678,25250
GWINNETT,8/26/2020,13104,11610,680,25394
GWINNETT,8/27/2020,13172,11656,681,25509
GWINNETT,8/28/2020,13222,11706,682,25610
GWINNETT,8/29/2020,13255,11739,684,25678
GWINNETT,8/30/2020,13293,11777,688,25758
GWINNETT,8/31/2020,13353,11849,688,25890
GWINNETT,9/1/2020,13418,11915,689,26022
GWINNETT,9/2/2020,13482,11971,689,26142
GWINNETT,9/3/2020,13546,12019,690,26255
GWINNETT,9/4/2020,13589,12071,691,26351
GWINNETT,9/5/2020,13622,12110,692,26424
GWINNETT,9/6/2020,13675,12144,692,26511
GWINNETT,9/7/2020,13717,12175,692,26584
GWINNETT,9/8/2020,13777,12224,698,26699
GWINNETT,9/9/2020,13833,12266,698,26797
GWINNETT,9/10/2020,13900,12314,700,26914
GWINNETT,9/11/2020,13949,12357,701,27007
GWINNETT,9/12/2020,13979,12388,705,27072
GWINNETT,9/13/2020,14007,12417,705,27129
GWINNETT,9/14/2020,14056,12480,706,27242
GWINNETT,9/15/2020,14103,12510,708,27321
GWINNETT,9/16/2020,14144,12545,709,27398
GWINNETT,9/17/2020,14186,12579,710,27475
GWINNETT,9/18/2020,14233,12618,711,27562
GWINNETT,9/19/2020,14276,12649,711,27636
GWINNETT,9/20/2020,14305,12668,711,27684
GWINNETT,9/21/2020,14348,12713,713,27774
GWINNETT,9/22/2020,14402,12750,715,27867
GWINNETT,9/23/2020,14462,12794,718,27974
GWINNETT,9/24/2020,14514,12829,718,28061
GWINNETT,9/25/2020,14569,12865,721,28155
GWINNETT,9/26/2020,14611,12896,722,28229
GWINNETT,9/27/2020,14639,12928,724,28291
GWINNETT,9/28/2020,14684,12968,726,28378
GWINNETT,9/29/2020,14732,13001,728,28461
GWINNETT,9/30/2020,14795,13046,732,28573
GWINNETT,10/1/2020,14846,13084,733,28663
GWINNETT,10/2/2020,14896,13130,734,28760
GWINNETT,10/3/2020,14924,13158,734,28816
GWINNETT,10/4/2020,14952,13179,738,28869
GWINNETT,10/5/2020,15001,13233,741,28975
GWINNETT,10/6/2020,15046,13254,742,29042
GWINNETT,10/7/2020,15110,13301,743,29154
GWINNETT,10/8/2020,15169,13343,743,29255
GWINNETT,10/9/2020,15201,13367,743,29311
GWINNETT,10/10/2020,15229,13398,744,29371
GWINNETT,10/11/2020,15255,13420,744,29419
GWINNETT,10/12/2020,15310,13450,745,29505
GWINNETT,10/13/2020,15340,13483,746,29569
GWINNETT,10/14/2020,15371,13515,746,29632
GWINNETT,10/15/2020,15417,13552,746,29715
GWINNETT,10/16/2020,15461,13587,748,29796
GWINNETT,10/17/2020,15490,13606,748,29844
GWINNETT,10/18/2020,15497,13617,748,29862
GWINNETT,10/19/2020,15498,13618,749,29865
GWINNETT,10/20/2020,15499,13618,749,29866
HABERSHAM,1/1/2020,0,0,0,0
HABERSHAM,1/2/2020,0,0,0,0
HABERSHAM,1/3/2020,0,0,0,0
HABERSHAM,1/4/2020,0,0,0,0
HABERSHAM,1/5/2020,0,0,0,0
HABERSHAM,1/6/2020,0,0,0,0
HABERSHAM,1/7/2020,0,0,0,0
HABERSHAM,1/8/2020,0,0,0,0
HABERSHAM,1/9/2020,0,0,0,0
HABERSHAM,1/10/2020,0,0,0,0
HABERSHAM,1/11/2020,0,0,0,0
HABERSHAM,1/12/2020,0,0,0,0
HABERSHAM,1/13/2020,0,0,0,0
HABERSHAM,1/14/2020,0,0,0,0
HABERSHAM,1/15/2020,0,0,0,0
HABERSHAM,1/16/2020,0,0,0,0
HABERSHAM,1/17/2020,0,0,0,0
HABERSHAM,1/18/2020,0,0,0,0
HABERSHAM,1/19/2020,0,0,0,0
HABERSHAM,1/20/2020,0,0,0,0
HABERSHAM,1/21/2020,0,0,0,0
HABERSHAM,1/22/2020,0,0,0,0
HABERSHAM,1/23/2020,0,0,0,0
HABERSHAM,1/24/2020,0,0,0,0
HABERSHAM,1/25/2020,0,0,0,0
HABERSHAM,1/26/2020,0,0,0,0
HABERSHAM,1/27/2020,0,0,0,0
HABERSHAM,1/28/2020,0,0,0,0
HABERSHAM,1/29/2020,0,0,0,0
HABERSHAM,1/30/2020,0,0,0,0
HABERSHAM,1/31/2020,0,0,0,0
HABERSHAM,2/1/2020,0,0,0,0
HABERSHAM,2/2/2020,0,0,0,0
HABERSHAM,2/3/2020,0,0,0,0
HABERSHAM,2/4/2020,0,0,0,0
HABERSHAM,2/5/2020,0,0,0,0
HABERSHAM,2/6/2020,0,0,0,0
HABERSHAM,2/7/2020,0,0,0,0
HABERSHAM,2/8/2020,0,0,0,0
HABERSHAM,2/9/2020,0,0,0,0
HABERSHAM,2/10/2020,0,0,0,0
HABERSHAM,2/11/2020,0,0,0,0
HABERSHAM,2/12/2020,0,0,0,0
HABERSHAM,2/13/2020,0,0,0,0
HABERSHAM,2/14/2020,0,0,0,0
HABERSHAM,2/15/2020,0,0,0,0
HABERSHAM,2/16/2020,0,0,0,0
HABERSHAM,2/17/2020,0,0,0,0
HABERSHAM,2/18/2020,0,0,0,0
HABERSHAM,2/19/2020,0,0,0,0
HABERSHAM,2/20/2020,0,0,0,0
HABERSHAM,2/21/2020,1,0,0,1
HABERSHAM,2/22/2020,1,0,0,1
HABERSHAM,2/23/2020,1,0,0,1
HABERSHAM,2/24/2020,1,0,0,1
HABERSHAM,2/25/2020,1,0,0,1
HABERSHAM,2/26/2020,1,0,0,1
HABERSHAM,2/27/2020,1,0,0,1
HABERSHAM,2/28/2020,1,0,0,1
HABERSHAM,2/29/2020,1,0,0,1
HABERSHAM,3/1/2020,1,0,0,1
HABERSHAM,3/2/2020,1,0,0,1
HABERSHAM,3/3/2020,1,0,0,1
HABERSHAM,3/4/2020,1,0,0,1
HABERSHAM,3/5/2020,1,0,0,1
HABERSHAM,3/6/2020,1,0,0,1
HABERSHAM,3/7/2020,1,0,0,1
HABERSHAM,3/8/2020,1,0,0,1
HABERSHAM,3/9/2020,1,0,0,1
HABERSHAM,3/10/2020,1,0,0,1
HABERSHAM,3/11/2020,1,0,0,1
HABERSHAM,3/12/2020,1,0,0,1
HABERSHAM,3/13/2020,1,0,0,1
HABERSHAM,3/14/2020,1,0,0,1
HABERSHAM,3/15/2020,1,0,0,1
HABERSHAM,3/16/2020,1,0,0,1
HABERSHAM,3/17/2020,2,0,0,2
HABERSHAM,3/18/2020,2,0,0,2
HABERSHAM,3/19/2020,3,0,0,3
HABERSHAM,3/20/2020,3,1,0,4
HABERSHAM,3/21/2020,3,1,0,4
HABERSHAM,3/22/2020,3,1,0,4
HABERSHAM,3/23/2020,3,1,0,4
HABERSHAM,3/24/2020,4,1,0,5
HABERSHAM,3/25/2020,4,2,0,6
HABERSHAM,3/26/2020,4,2,0,6
HABERSHAM,3/27/2020,6,2,0,8
HABERSHAM,3/28/2020,6,4,0,10
HABERSHAM,3/29/2020,6,4,0,10
HABERSHAM,3/30/2020,7,5,0,12
HABERSHAM,3/31/2020,10,5,0,15
HABERSHAM,4/1/2020,11,7,0,18
HABERSHAM,4/2/2020,16,9,0,25
HABERSHAM,4/3/2020,17,10,0,27
HABERSHAM,4/4/2020,20,12,0,32
HABERSHAM,4/5/2020,22,14,0,36
HABERSHAM,4/6/2020,23,16,0,39
HABERSHAM,4/7/2020,24,17,0,41
HABERSHAM,4/8/2020,31,21,0,52
HABERSHAM,4/9/2020,34,25,0,59
HABERSHAM,4/10/2020,37,32,0,69
HABERSHAM,4/11/2020,42,36,0,78
HABERSHAM,4/12/2020,48,40,0,88
HABERSHAM,4/13/2020,57,45,0,102
HABERSHAM,4/14/2020,65,60,0,125
HABERSHAM,4/15/2020,77,69,0,146
HABERSHAM,4/16/2020,94,78,0,172
HABERSHAM,4/17/2020,102,84,0,186
HABERSHAM,4/18/2020,112,86,0,198
HABERSHAM,4/19/2020,125,92,0,217
HABERSHAM,4/20/2020,139,107,0,246
HABERSHAM,4/21/2020,143,112,0,255
HABERSHAM,4/22/2020,156,120,1,277
HABERSHAM,4/23/2020,165,133,2,300
HABERSHAM,4/24/2020,170,139,2,311
HABERSHAM,4/25/2020,177,145,2,324
HABERSHAM,4/26/2020,183,157,3,343
HABERSHAM,4/27/2020,184,164,4,352
HABERSHAM,4/28/2020,189,171,4,364
HABERSHAM,4/29/2020,203,181,4,388
HABERSHAM,4/30/2020,206,188,4,398
HABERSHAM,5/1/2020,211,192,4,407
HABERSHAM,5/2/2020,211,193,4,408
HABERSHAM,5/3/2020,215,194,4,413
HABERSHAM,5/4/2020,216,195,4,415
HABERSHAM,5/5/2020,216,195,4,415
HABERSHAM,5/6/2020,216,195,4,415
HABERSHAM,5/7/2020,216,197,4,417
HABERSHAM,5/8/2020,219,200,4,423
HABERSHAM,5/9/2020,220,200,4,424
HABERSHAM,5/10/2020,225,202,4,431
HABERSHAM,5/11/2020,229,205,4,438
HABERSHAM,5/12/2020,231,205,4,440
HABERSHAM,5/13/2020,266,214,4,484
HABERSHAM,5/14/2020,267,216,4,487
HABERSHAM,5/15/2020,278,219,4,501
HABERSHAM,5/16/2020,281,220,4,505
HABERSHAM,5/17/2020,284,222,4,510
HABERSHAM,5/18/2020,290,224,4,518
HABERSHAM,5/19/2020,292,224,4,520
HABERSHAM,5/20/2020,298,226,4,528
HABERSHAM,5/21/2020,298,232,4,534
HABERSHAM,5/22/2020,302,237,4,543
HABERSHAM,5/23/2020,303,240,4,547
HABERSHAM,5/24/2020,306,241,4,551
HABERSHAM,5/25/2020,308,242,4,554
HABERSHAM,5/26/2020,315,246,4,565
HABERSHAM,5/27/2020,317,246,4,567
HABERSHAM,5/28/2020,320,249,4,573
HABERSHAM,5/29/2020,322,249,4,575
HABERSHAM,5/30/2020,324,249,4,577
HABERSHAM,5/31/2020,324,253,4,581
HABERSHAM,6/1/2020,327,257,4,588
HABERSHAM,6/2/2020,329,259,4,592
HABERSHAM,6/3/2020,333,264,4,601
HABERSHAM,6/4/2020,333,267,4,604
HABERSHAM,6/5/2020,338,271,5,614
HABERSHAM,6/6/2020,341,274,5,620
HABERSHAM,6/7/2020,344,275,5,624
HABERSHAM,6/8/2020,353,281,5,639
HABERSHAM,6/9/2020,356,282,5,643
HABERSHAM,6/10/2020,357,283,5,645
HABERSHAM,6/11/2020,359,284,5,648
HABERSHAM,6/12/2020,360,286,5,651
HABERSHAM,6/13/2020,363,290,5,658
HABERSHAM,6/14/2020,364,294,5,663
HABERSHAM,6/15/2020,368,298,5,671
HABERSHAM,6/16/2020,371,301,5,677
HABERSHAM,6/17/2020,371,304,5,680
HABERSHAM,6/18/2020,372,304,6,682
HABERSHAM,6/19/2020,375,305,7,687
HABERSHAM,6/20/2020,383,307,7,697
JENKINS,7/20/2020,133,81,0,214
JENKINS,7/21/2020,137,81,0,218
JENKINS,7/22/2020,137,82,0,219
JENKINS,7/23/2020,137,83,0,220
JENKINS,7/24/2020,137,85,0,222
JENKINS,7/25/2020,138,86,0,224
JENKINS,7/26/2020,139,86,0,225
JENKINS,7/27/2020,143,89,0,232
JENKINS,7/28/2020,145,89,0,234
JENKINS,7/29/2020,146,90,0,236
HABERSHAM,6/25/2020,404,321,8,733
JENKINS,7/30/2020,147,90,0,237
JENKINS,7/31/2020,148,91,0,239
JENKINS,8/1/2020,150,91,0,241
JENKINS,8/2/2020,150,92,0,242
JENKINS,8/3/2020,151,96,0,247
JENKINS,8/4/2020,152,96,0,248
JENKINS,8/5/2020,154,97,0,251
JENKINS,8/6/2020,161,98,0,259
JENKINS,8/7/2020,163,98,0,261
JENKINS,8/8/2020,167,101,0,268
JENKINS,8/9/2020,169,102,0,271
JENKINS,8/10/2020,172,102,0,274
JENKINS,8/11/2020,173,102,0,275
JENKINS,8/12/2020,176,103,0,279
JENKINS,8/13/2020,176,105,0,281
JENKINS,8/14/2020,176,106,0,282
JENKINS,8/15/2020,176,107,0,283
JENKINS,8/16/2020,177,109,0,286
JENKINS,8/17/2020,179,111,0,290
JENKINS,8/18/2020,179,113,0,292
JENKINS,8/19/2020,180,113,0,293
JENKINS,8/20/2020,182,113,0,295
JENKINS,8/21/2020,186,115,0,301
JENKINS,8/22/2020,187,115,0,302
JENKINS,8/23/2020,189,116,0,305
JENKINS,8/24/2020,191,119,0,310
JENKINS,8/25/2020,194,124,0,318
JENKINS,8/26/2020,198,126,0,324
JENKINS,8/27/2020,201,129,0,330
JENKINS,8/28/2020,206,131,0,337
JENKINS,8/29/2020,207,134,0,341
JENKINS,8/30/2020,209,134,0,343
JENKINS,8/31/2020,212,137,0,349
JENKINS,9/1/2020,212,139,0,351
JENKINS,9/2/2020,214,141,0,355
JENKINS,9/3/2020,218,142,0,360
JENKINS,9/4/2020,218,143,0,361
JENKINS,9/5/2020,219,144,0,363
JENKINS,9/6/2020,219,147,0,366
JENKINS,9/7/2020,220,148,0,368
JENKINS,9/8/2020,224,154,0,378
JENKINS,9/9/2020,226,155,0,381
JENKINS,9/10/2020,227,158,0,385
JENKINS,9/11/2020,229,158,0,387
JENKINS,9/12/2020,232,160,0,392
JENKINS,9/13/2020,232,161,0,393
JENKINS,9/14/2020,235,163,0,398
JENKINS,9/15/2020,237,165,0,402
JENKINS,9/16/2020,239,165,0,404
JENKINS,9/17/2020,240,165,0,405
JENKINS,9/18/2020,241,165,0,406
JENKINS,9/19/2020,242,165,0,407
JENKINS,9/20/2020,243,167,0,410
JENKINS,9/21/2020,245,169,0,414
JENKINS,9/22/2020,254,172,0,426
JENKINS,9/23/2020,258,172,0,430
JENKINS,9/24/2020,261,172,0,433
JENKINS,9/25/2020,265,173,0,438
JENKINS,9/26/2020,267,173,0,440
JENKINS,9/27/2020,267,174,0,441
JENKINS,9/28/2020,267,174,0,441
JENKINS,9/29/2020,267,174,0,441
JENKINS,9/30/2020,267,174,0,441
JENKINS,10/1/2020,268,174,0,442
JENKINS,10/2/2020,269,175,0,444
JENKINS,10/3/2020,269,175,0,444
JENKINS,10/4/2020,269,176,0,445
JENKINS,10/5/2020,271,177,0,448
JENKINS,10/6/2020,280,178,0,458
JENKINS,10/7/2020,280,178,1,459
JENKINS,10/8/2020,281,178,1,460
JENKINS,10/9/2020,281,178,1,460
JENKINS,10/10/2020,281,178,1,460
JENKINS,10/11/2020,281,178,1,460
JENKINS,10/12/2020,282,178,1,461
JENKINS,10/13/2020,282,179,1,462
JENKINS,10/14/2020,282,179,1,462
JENKINS,10/15/2020,282,179,1,462
JENKINS,10/16/2020,282,179,1,462
JENKINS,10/17/2020,282,179,1,462
JENKINS,10/18/2020,282,179,1,462
JENKINS,10/19/2020,282,179,1,462
JENKINS,10/20/2020,282,179,1,462
LANIER,1/1/2020,0,0,0,0
LANIER,1/2/2020,0,0,0,0
LANIER,1/3/2020,0,0,0,0
LANIER,1/4/2020,0,0,0,0
LANIER,1/5/2020,0,0,0,0
LANIER,1/6/2020,0,0,0,0
LANIER,1/7/2020,0,0,0,0
LANIER,1/8/2020,0,0,0,0
LANIER,1/9/2020,0,0,0,0
LANIER,1/10/2020,0,0,0,0
LANIER,1/11/2020,0,0,0,0
LANIER,1/12/2020,0,0,0,0
LANIER,1/13/2020,0,0,0,0
LANIER,1/14/2020,0,0,0,0
LANIER,1/15/2020,0,0,0,0
LANIER,1/16/2020,0,0,0,0
LANIER,1/17/2020,0,0,0,0
LANIER,1/18/2020,0,0,0,0
LANIER,1/19/2020,0,0,0,0
LANIER,1/20/2020,0,0,0,0
LANIER,1/21/2020,0,0,0,0
LANIER,1/22/2020,0,0,0,0
LANIER,1/23/2020,0,0,0,0
LANIER,1/24/2020,0,0,0,0
LANIER,1/25/2020,0,0,0,0
LANIER,1/26/2020,0,0,0,0
LANIER,1/27/2020,0,0,0,0
LANIER,1/28/2020,0,0,0,0
LANIER,1/29/2020,0,0,0,0
LANIER,1/30/2020,0,0,0,0
LANIER,1/31/2020,0,0,0,0
LANIER,2/1/2020,0,0,0,0
LANIER,2/2/2020,0,0,0,0
LANIER,2/3/2020,0,0,0,0
LANIER,2/4/2020,0,0,0,0
LANIER,2/5/2020,0,0,0,0
LANIER,2/6/2020,0,0,0,0
LANIER,2/7/2020,0,0,0,0
LANIER,2/8/2020,0,0,0,0
LANIER,2/9/2020,0,0,0,0
LANIER,2/10/2020,0,0,0,0
LANIER,2/11/2020,0,0,0,0
LANIER,2/12/2020,0,0,0,0
LANIER,2/13/2020,0,0,0,0
LANIER,2/14/2020,0,0,0,0
LANIER,2/15/2020,0,0,0,0
LANIER,2/16/2020,0,0,0,0
LANIER,2/17/2020,0,0,0,0
LANIER,2/18/2020,0,0,0,0
LANIER,2/19/2020,0,0,0,0
LANIER,2/20/2020,0,0,0,0
LANIER,2/21/2020,0,0,0,0
LANIER,2/22/2020,0,0,0,0
LANIER,2/23/2020,0,0,0,0
LANIER,2/24/2020,0,0,0,0
LANIER,2/25/2020,0,0,0,0
LANIER,2/26/2020,0,0,0,0
LANIER,2/27/2020,0,0,0,0
LANIER,2/28/2020,0,0,0,0
LANIER,2/29/2020,0,0,0,0
LANIER,3/1/2020,0,0,0,0
LANIER,3/2/2020,0,0,0,0
LANIER,3/3/2020,0,0,0,0
LANIER,3/4/2020,0,0,0,0
LANIER,3/5/2020,0,0,0,0
LANIER,3/6/2020,0,0,0,0
LANIER,3/7/2020,0,0,0,0
LANIER,3/8/2020,0,0,0,0
LANIER,3/9/2020,0,0,0,0
LANIER,3/10/2020,0,0,0,0
LANIER,3/11/2020,0,0,0,0
LANIER,3/12/2020,0,0,0,0
LANIER,3/13/2020,0,0,0,0
LANIER,3/14/2020,0,0,0,0
LANIER,3/15/2020,0,0,0,0
LANIER,3/16/2020,0,0,0,0
LANIER,3/17/2020,0,0,0,0
LANIER,3/18/2020,0,0,0,0
LANIER,3/19/2020,0,0,0,0
LANIER,3/20/2020,0,0,0,0
LANIER,3/21/2020,0,0,0,0
LANIER,3/22/2020,0,0,0,0
LANIER,3/23/2020,0,0,0,0
LANIER,3/24/2020,0,0,0,0
LANIER,3/25/2020,0,0,0,0
LANIER,3/26/2020,0,0,0,0
LANIER,3/27/2020,0,0,0,0
LANIER,3/28/2020,0,0,0,0
LANIER,3/29/2020,0,1,0,1
LANIER,3/30/2020,0,1,0,1
LANIER,3/31/2020,0,2,0,2
LANIER,4/1/2020,0,2,0,2
LANIER,4/2/2020,0,2,0,2
LANIER,4/3/2020,1,3,0,4
LANIER,4/4/2020,2,4,0,6
LANIER,4/5/2020,2,4,0,6
LANIER,4/6/2020,2,4,0,6
LANIER,4/7/2020,2,5,0,7
LANIER,4/8/2020,2,5,0,7
LANIER,4/9/2020,2,5,0,7
LANIER,4/10/2020,2,5,0,7
LANIER,4/11/2020,2,5,0,7
LANIER,4/12/2020,2,5,0,7
LANIER,4/13/2020,2,5,0,7
LANIER,4/14/2020,2,5,0,7
LANIER,4/15/2020,2,5,0,7
LANIER,4/16/2020,2,5,0,7
LANIER,4/17/2020,2,5,0,7
LANIER,4/18/2020,2,6,0,8
LANIER,4/19/2020,2,6,0,8
LANIER,4/20/2020,2,6,0,8
LANIER,4/21/2020,2,6,0,8
LANIER,4/22/2020,2,6,0,8
LANIER,4/23/2020,2,6,0,8
LANIER,4/24/2020,2,6,0,8
LANIER,4/25/2020,2,6,0,8
LANIER,4/26/2020,2,6,0,8
LANIER,4/27/2020,2,6,0,8
LANIER,4/28/2020,2,6,0,8
LANIER,4/29/2020,2,6,0,8
LANIER,4/30/2020,2,6,0,8
LANIER,5/1/2020,2,6,0,8
LANIER,5/2/2020,2,6,0,8
LANIER,5/3/2020,2,6,0,8
LANIER,5/4/2020,2,6,0,8
LANIER,5/5/2020,2,6,0,8
LANIER,5/6/2020,2,6,0,8
LANIER,5/7/2020,3,6,0,9
LANIER,5/8/2020,4,6,0,10
LANIER,5/9/2020,4,6,0,10
LANIER,5/10/2020,4,6,0,10
LANIER,5/11/2020,4,6,0,10
LANIER,5/12/2020,5,6,0,11
LANIER,5/13/2020,5,6,0,11
LANIER,5/14/2020,5,6,0,11
LANIER,5/15/2020,5,6,0,11
LANIER,5/16/2020,5,6,0,11
LANIER,5/17/2020,5,6,0,11
LANIER,5/18/2020,5,7,0,12
LANIER,5/19/2020,5,7,0,12
LANIER,5/20/2020,5,7,0,12
LANIER,5/21/2020,5,8,0,13
LANIER,5/22/2020,5,8,0,13
LANIER,5/23/2020,5,8,0,13
LANIER,5/24/2020,5,9,0,14
LANIER,5/25/2020,5,9,0,14
LANIER,5/26/2020,7,10,1,18
LANIER,5/27/2020,7,10,1,18
LANIER,5/28/2020,7,10,1,18
LANIER,5/29/2020,7,11,1,19
LANIER,5/30/2020,10,15,1,26
LANIER,5/31/2020,10,15,1,26
LANIER,6/1/2020,10,16,1,27
LANIER,6/2/2020,11,17,1,29
LANIER,6/3/2020,12,20,1,33
LANIER,6/4/2020,12,20,1,33
LANIER,6/5/2020,12,20,1,33
LANIER,6/6/2020,12,20,1,33
LANIER,6/7/2020,13,21,1,35
LANIER,6/8/2020,14,23,1,38
LANIER,6/9/2020,16,80,2,98
LANIER,6/10/2020,17,81,2,100
LANIER,6/11/2020,19,83,2,104
LANIER,6/12/2020,19,84,2,105
LANIER,6/13/2020,19,84,2,105
LANIER,6/14/2020,19,85,2,106
LANIER,6/15/2020,23,86,2,111
LANIER,6/16/2020,24,88,2,114
LANIER,6/17/2020,24,90,3,117
LANIER,6/18/2020,26,90,3,119
LANIER,6/19/2020,26,90,3,119
LANIER,6/20/2020,27,91,3,121
LANIER,6/21/2020,28,91,3,122
LANIER,6/22/2020,32,92,3,127
LANIER,6/23/2020,33,94,3,130
LANIER,6/24/2020,33,94,3,130
LANIER,6/25/2020,35,96,3,134
LANIER,6/26/2020,37,97,3,137
LANIER,6/27/2020,38,97,3,138
LANIER,6/28/2020,38,98,3,139
LANIER,6/29/2020,45,101,3,149
LANIER,6/30/2020,46,103,3,152
LANIER,7/1/2020,47,103,3,153
LANIER,7/2/2020,51,106,3,160
LANIER,7/3/2020,54,107,3,164
LANIER,7/4/2020,54,107,3,164
LANIER,7/5/2020,55,107,3,165
LANIER,7/6/2020,56,108,3,167
LANIER,7/7/2020,58,114,3,175
LANIER,7/8/2020,58,114,3,175
LANIER,7/9/2020,59,116,3,178
LANIER,7/10/2020,59,116,3,178
LANIER,7/11/2020,60,116,3,179
LANIER,7/12/2020,60,116,3,179
LANIER,7/13/2020,60,117,3,180
LANIER,7/14/2020,61,119,3,183
LANIER,7/15/2020,62,120,3,185
LANIER,7/16/2020,64,121,3,188
LANIER,7/17/2020,64,124,3,191
LANIER,7/18/2020,64,125,3,192
LANIER,7/19/2020,64,125,3,192
LANIER,7/20/2020,66,127,3,196
LANIER,7/21/2020,70,128,3,201
LANIER,7/22/2020,72,130,3,205
LANIER,7/23/2020,72,131,3,206
LANIER,7/24/2020,73,134,3,210
LANIER,7/25/2020,74,135,3,212
LANIER,7/26/2020,74,135,3,212
LANIER,7/27/2020,77,135,3,215
LANIER,7/28/2020,78,136,3,217
LANIER,7/29/2020,79,136,3,218
LANIER,7/30/2020,79,138,3,220
LANIER,7/31/2020,80,139,3,222
LANIER,8/1/2020,80,139,3,222
LANIER,8/2/2020,80,139,3,222
LANIER,8/3/2020,80,139,3,222
LANIER,8/4/2020,80,141,3,224
LANIER,8/5/2020,80,142,3,225
LANIER,8/6/2020,82,142,3,227
LANIER,8/7/2020,82,143,3,228
LANIER,8/8/2020,82,143,3,228
LANIER,8/9/2020,82,144,3,229
LANIER,8/10/2020,85,145,3,233
LANIER,8/11/2020,85,146,3,234
LANIER,8/12/2020,86,147,3,236
LANIER,8/13/2020,91,147,4,242
LANIER,8/14/2020,91,148,4,243
LANIER,8/15/2020,92,148,4,244
LANIER,8/16/2020,93,149,4,246
LANIER,8/17/2020,95,150,4,249
LANIER,8/18/2020,96,150,4,250
LANIER,8/19/2020,98,153,4,255
LANIER,8/20/2020,98,153,4,255
LANIER,8/21/2020,98,157,4,259
LANIER,8/22/2020,98,157,4,259
LANIER,8/23/2020,98,158,4,260
LANIER,8/24/2020,98,160,4,262
LANIER,8/25/2020,99,160,4,263
LANIER,8/26/2020,100,162,4,266
LANIER,8/27/2020,100,162,4,266
LANIER,8/28/2020,103,165,4,272
LANIER,8/29/2020,106,166,4,276
LANIER,8/30/2020,109,167,4,280
LANIER,8/31/2020,111,168,4,283
LANIER,9/1/2020,111,169,4,284
LANIER,9/2/2020,111,169,4,284
LANIER,9/3/2020,111,170,4,285
LANIER,9/4/2020,111,170,4,285
LANIER,9/5/2020,111,171,4,286
LANIER,9/6/2020,112,171,4,287
LANIER,9/7/2020,112,173,4,289
LANIER,9/8/2020,114,173,4,291
LANIER,9/9/2020,115,173,4,292
LANIER,9/10/2020,115,175,4,294
LANIER,9/11/2020,116,175,4,295
LANIER,9/12/2020,117,175,4,296
LANIER,9/13/2020,118,175,4,297
LANIER,9/14/2020,118,177,4,299
LANIER,9/15/2020,118,177,4,299
LANIER,9/16/2020,118,178,4,300
LANIER,9/17/2020,118,178,4,300
LANIER,9/18/2020,118,178,4,300
LANIER,9/19/2020,118,178,4,300
LANIER,9/20/2020,118,178,5,301
LANIER,9/21/2020,118,178,5,301
LANIER,9/22/2020,118,178,5,301
LANIER,9/23/2020,118,178,7,303
LANIER,9/24/2020,118,178,7,303
LANIER,9/25/2020,118,178,7,303
LANIER,9/26/2020,118,178,7,303
LANIER,9/27/2020,118,180,7,305
LANIER,9/28/2020,119,180,7,306
LANIER,9/29/2020,119,180,7,306
LANIER,9/30/2020,119,180,7,306
LANIER,10/1/2020,119,180,7,306
LANIER,10/2/2020,120,180,7,307
LANIER,10/3/2020,120,180,7,307
LANIER,10/4/2020,120,180,7,307
LANIER,10/5/2020,120,180,7,307
LANIER,10/6/2020,121,180,7,308
LANIER,10/7/2020,121,180,7,308
LANIER,10/8/2020,122,182,7,311
LANIER,10/9/2020,122,184,7,313
LANIER,10/10/2020,122,184,7,313
LANIER,10/11/2020,122,184,7,313
LANIER,10/12/2020,122,184,7,313
LANIER,10/13/2020,122,185,7,314
LANIER,10/14/2020,122,185,7,314
LANIER,10/15/2020,122,185,7,314
LANIER,10/16/2020,122,185,7,314
LANIER,10/17/2020,122,185,7,314
LANIER,10/18/2020,122,185,7,314
LANIER,10/19/2020,122,185,7,314
LANIER,10/20/2020,122,185,7,314
LAURENS,1/1/2020,0,0,0,0
LAURENS,1/2/2020,0,0,0,0
LAURENS,1/3/2020,0,0,0,0
LAURENS,1/4/2020,0,0,0,0
LAURENS,1/5/2020,0,0,0,0
LAURENS,1/6/2020,0,0,0,0
LAURENS,1/7/2020,0,0,0,0
LAURENS,1/8/2020,0,0,0,0
HABERSHAM,6/26/2020,406,325,10,741
HABERSHAM,6/27/2020,409,333,11,753
HABERSHAM,6/28/2020,410,334,11,755
HABERSHAM,6/29/2020,416,338,11,765
HABERSHAM,6/30/2020,420,343,11,774
HABERSHAM,7/1/2020,427,350,11,788
HABERSHAM,7/2/2020,429,354,11,794
HABERSHAM,7/3/2020,435,355,11,801
HABERSHAM,7/4/2020,437,361,12,810
HABERSHAM,7/5/2020,441,361,12,814
HABERSHAM,7/6/2020,448,367,12,827
HABERSHAM,7/7/2020,454,372,13,839
HABERSHAM,7/8/2020,462,383,13,858
HABERSHAM,7/9/2020,467,390,15,872
HABERSHAM,7/10/2020,476,395,16,887
HABERSHAM,7/11/2020,481,398,16,895
HABERSHAM,7/12/2020,487,403,16,906
HABERSHAM,7/13/2020,499,411,16,926
HABERSHAM,7/14/2020,507,416,16,939
HABERSHAM,7/15/2020,514,418,18,950
HABERSHAM,7/16/2020,520,431,19,970
HABERSHAM,7/17/2020,527,440,19,986
HABERSHAM,7/18/2020,537,446,19,1002
HABERSHAM,7/19/2020,539,454,19,1012
HABERSHAM,7/20/2020,556,468,20,1044
HABERSHAM,7/21/2020,568,473,20,1061
HABERSHAM,7/22/2020,583,482,21,1086
HABERSHAM,7/23/2020,587,495,21,1103
HABERSHAM,7/24/2020,595,505,21,1121
HABERSHAM,7/25/2020,596,510,22,1128
HABERSHAM,7/26/2020,605,513,22,1140
HABERSHAM,7/27/2020,616,518,22,1156
HABERSHAM,7/28/2020,629,522,26,1177
HABERSHAM,7/29/2020,640,525,26,1191
HABERSHAM,7/30/2020,645,531,26,1202
HABERSHAM,7/31/2020,657,537,26,1220
HABERSHAM,8/1/2020,671,546,27,1244
HABERSHAM,8/2/2020,679,549,28,1256
HABERSHAM,8/3/2020,687,556,28,1271
HABERSHAM,8/4/2020,693,566,28,1287
HABERSHAM,8/5/2020,702,574,29,1305
HABERSHAM,8/6/2020,706,581,29,1316
HABERSHAM,8/7/2020,710,583,29,1322
HABERSHAM,8/8/2020,711,586,29,1326
HABERSHAM,8/9/2020,713,589,29,1331
HABERSHAM,8/10/2020,723,592,29,1344
HABERSHAM,8/11/2020,727,600,29,1356
HABERSHAM,8/12/2020,734,604,29,1367
HABERSHAM,8/13/2020,737,609,29,1375
HABERSHAM,8/14/2020,741,610,29,1380
HABERSHAM,8/15/2020,747,613,29,1389
HABERSHAM,8/16/2020,753,613,29,1395
HABERSHAM,8/17/2020,760,620,29,1409
HABERSHAM,8/18/2020,763,625,29,1417
HABERSHAM,8/19/2020,767,627,29,1423
HABERSHAM,8/20/2020,769,629,29,1427
HABERSHAM,8/21/2020,772,634,29,1435
HABERSHAM,8/22/2020,782,635,29,1446
HABERSHAM,8/23/2020,791,636,29,1456
HABERSHAM,8/24/2020,797,637,29,1463
HABERSHAM,8/25/2020,802,639,29,1470
HABERSHAM,8/26/2020,806,646,29,1481
HABERSHAM,8/27/2020,811,650,29,1490
HABERSHAM,8/28/2020,812,657,29,1498
HABERSHAM,8/29/2020,815,663,29,1507
HABERSHAM,8/30/2020,817,665,29,1511
HABERSHAM,8/31/2020,818,667,29,1514
HABERSHAM,9/1/2020,819,671,29,1519
HABERSHAM,9/2/2020,824,677,29,1530
HABERSHAM,9/3/2020,826,678,30,1534
HABERSHAM,9/4/2020,831,679,30,1540
HABERSHAM,9/5/2020,834,682,30,1546
HABERSHAM,9/6/2020,834,682,30,1546
HABERSHAM,9/7/2020,835,683,30,1548
HABERSHAM,9/8/2020,843,690,30,1563
HABERSHAM,9/9/2020,850,694,30,1574
HABERSHAM,9/10/2020,856,703,30,1589
HABERSHAM,9/11/2020,861,707,30,1598
HABERSHAM,9/12/2020,865,716,30,1611
HABERSHAM,9/13/2020,868,717,30,1615
HABERSHAM,9/14/2020,871,719,30,1620
HABERSHAM,9/15/2020,875,724,30,1629
HABERSHAM,9/16/2020,878,726,30,1634
HABERSHAM,9/17/2020,882,730,30,1642
HABERSHAM,9/18/2020,889,736,30,1655
HABERSHAM,9/19/2020,893,740,30,1663
HABERSHAM,9/20/2020,896,744,30,1670
HABERSHAM,9/21/2020,901,748,31,1680
HABERSHAM,9/22/2020,903,752,31,1686
HABERSHAM,9/23/2020,908,756,31,1695
HABERSHAM,9/24/2020,911,761,31,1703
HABERSHAM,9/25/2020,915,765,31,1711
HABERSHAM,9/26/2020,921,769,31,1721
HABERSHAM,9/27/2020,925,774,31,1730
HABERSHAM,9/28/2020,932,780,32,1744
HABERSHAM,9/29/2020,934,782,32,1748
HABERSHAM,9/30/2020,940,786,32,1758
HABERSHAM,10/1/2020,943,790,32,1765
HABERSHAM,10/2/2020,950,796,32,1778
HABERSHAM,10/3/2020,954,797,32,1783
HABERSHAM,10/4/2020,958,801,32,1791
HABERSHAM,10/5/2020,959,806,32,1797
HABERSHAM,10/6/2020,962,808,32,1802
HABERSHAM,10/7/2020,963,811,32,1806
HABERSHAM,10/8/2020,965,815,32,1812
HABERSHAM,10/9/2020,967,817,32,1816
HABERSHAM,10/10/2020,967,818,32,1817
HABERSHAM,10/11/2020,968,820,32,1820
HABERSHAM,10/12/2020,971,820,32,1823
HABERSHAM,10/13/2020,973,822,32,1827
HABERSHAM,10/14/2020,973,825,32,1830
HABERSHAM,10/15/2020,975,827,32,1834
HABERSHAM,10/16/2020,976,827,32,1835
HABERSHAM,10/17/2020,977,828,32,1837
HABERSHAM,10/18/2020,977,828,32,1837
HABERSHAM,10/19/2020,977,829,32,1838
HABERSHAM,10/20/2020,977,829,32,1838
HARALSON,1/1/2020,0,0,0,0
HARALSON,1/2/2020,0,0,0,0
HARALSON,1/3/2020,0,0,0,0
HARALSON,1/4/2020,0,0,0,0
HARALSON,1/5/2020,0,0,0,0
HARALSON,1/6/2020,0,0,0,0
HARALSON,1/7/2020,0,0,0,0
HARALSON,1/8/2020,0,0,0,0
HARALSON,1/9/2020,0,0,0,0
HARALSON,1/10/2020,0,0,0,0
HARALSON,1/11/2020,0,0,0,0
HARALSON,1/12/2020,0,0,0,0
HARALSON,1/13/2020,0,0,0,0
HARALSON,1/14/2020,0,0,0,0
HARALSON,1/15/2020,0,0,0,0
HARALSON,1/16/2020,0,0,0,0
HARALSON,1/17/2020,0,0,0,0
HARALSON,1/18/2020,0,0,0,0
HARALSON,1/19/2020,0,0,0,0
HARALSON,1/20/2020,0,0,0,0
HARALSON,1/21/2020,0,0,0,0
HARALSON,1/22/2020,0,0,0,0
HARALSON,1/23/2020,0,0,0,0
HARALSON,1/24/2020,0,0,0,0
HARALSON,1/25/2020,0,0,0,0
HARALSON,1/26/2020,0,0,0,0
HARALSON,1/27/2020,0,0,0,0
HARALSON,1/28/2020,0,0,0,0
HARALSON,1/29/2020,0,0,0,0
HARALSON,1/30/2020,0,0,0,0
HARALSON,1/31/2020,0,0,0,0
HARALSON,2/1/2020,0,0,0,0
HARALSON,2/2/2020,0,0,0,0
HARALSON,2/3/2020,0,0,0,0
HARALSON,2/4/2020,0,0,0,0
HARALSON,2/5/2020,0,0,0,0
HARALSON,2/6/2020,0,0,0,0
HARALSON,2/7/2020,0,0,0,0
HARALSON,2/8/2020,0,0,0,0
HARALSON,2/9/2020,0,0,0,0
HARALSON,2/10/2020,0,0,0,0
HARALSON,2/11/2020,0,0,0,0
HARALSON,2/12/2020,0,0,0,0
HARALSON,2/13/2020,0,0,0,0
HARALSON,2/14/2020,0,0,0,0
HARALSON,2/15/2020,0,0,0,0
HARALSON,2/16/2020,0,0,0,0
HARALSON,2/17/2020,0,0,0,0
HARALSON,2/18/2020,0,0,0,0
HARALSON,2/19/2020,0,0,0,0
HARALSON,2/20/2020,0,0,0,0
HARALSON,2/21/2020,0,0,0,0
HARALSON,2/22/2020,0,0,0,0
HARALSON,2/23/2020,0,0,0,0
HARALSON,2/24/2020,0,0,0,0
HARALSON,2/25/2020,0,0,0,0
HARALSON,2/26/2020,0,0,0,0
HARALSON,2/27/2020,0,0,0,0
HARALSON,2/28/2020,0,0,0,0
HARALSON,2/29/2020,0,0,0,0
HARALSON,3/1/2020,0,0,0,0
HARALSON,3/2/2020,0,0,0,0
HARALSON,3/3/2020,0,0,0,0
HARALSON,3/4/2020,0,0,0,0
HARALSON,3/5/2020,0,0,0,0
HARALSON,3/6/2020,0,0,0,0
HARALSON,3/7/2020,0,0,0,0
HARALSON,3/8/2020,0,0,0,0
HARALSON,3/9/2020,0,0,0,0
HARALSON,3/10/2020,0,0,0,0
HARALSON,3/11/2020,0,1,0,1
HARALSON,3/12/2020,1,1,0,2
HARALSON,3/13/2020,1,1,0,2
HARALSON,3/14/2020,1,1,0,2
HARALSON,3/15/2020,1,1,0,2
HARALSON,3/16/2020,1,2,0,3
HARALSON,3/17/2020,1,2,0,3
HARALSON,3/18/2020,2,3,0,5
HARALSON,3/19/2020,3,3,0,6
HARALSON,3/20/2020,3,3,0,6
HARALSON,3/21/2020,5,4,0,9
HARALSON,3/22/2020,5,4,0,9
HARALSON,3/23/2020,5,4,0,9
HARALSON,3/24/2020,6,4,0,10
HARALSON,3/25/2020,6,4,0,10
HARALSON,3/26/2020,6,4,0,10
HARALSON,3/27/2020,6,4,0,10
HARALSON,3/28/2020,6,5,0,11
HARALSON,3/29/2020,6,5,0,11
HARALSON,3/30/2020,7,5,0,12
HARALSON,3/31/2020,7,5,0,12
HARALSON,4/1/2020,9,5,0,14
HARALSON,4/2/2020,9,6,0,15
HARALSON,4/3/2020,9,6,0,15
HARALSON,4/4/2020,10,6,0,16
HARALSON,4/5/2020,10,7,0,17
HARALSON,4/6/2020,10,8,0,18
HARALSON,4/7/2020,10,9,0,19
HARALSON,4/8/2020,10,9,0,19
HARALSON,4/9/2020,11,9,0,20
HARALSON,4/10/2020,11,9,0,20
HARALSON,4/11/2020,11,9,0,20
HARALSON,4/12/2020,11,9,0,20
HARALSON,4/13/2020,11,9,0,20
HARALSON,4/14/2020,11,9,0,20
HARALSON,4/15/2020,12,10,0,22
HARALSON,4/16/2020,12,11,0,23
HARALSON,4/17/2020,15,13,0,28
HARALSON,4/18/2020,15,13,0,28
HARALSON,4/19/2020,15,14,0,29
HARALSON,4/20/2020,15,14,0,29
HARALSON,4/21/2020,15,14,0,29
HARALSON,4/22/2020,15,15,0,30
HARALSON,4/23/2020,16,15,0,31
HARALSON,4/24/2020,16,15,0,31
HARALSON,4/25/2020,16,15,0,31
HARALSON,4/26/2020,16,15,0,31
HARALSON,4/27/2020,17,16,0,33
HARALSON,4/28/2020,18,16,0,34
HARALSON,4/29/2020,19,16,0,35
HARALSON,4/30/2020,19,16,0,35
HARALSON,5/1/2020,19,16,0,35
HARALSON,5/2/2020,19,16,0,35
HARALSON,5/3/2020,19,16,0,35
HARALSON,5/4/2020,19,16,0,35
HARALSON,5/5/2020,20,16,0,36
HARALSON,5/6/2020,20,16,0,36
HARALSON,5/7/2020,21,17,0,38
HARALSON,5/8/2020,21,17,0,38
HARALSON,5/9/2020,21,17,0,38
HARALSON,5/10/2020,21,17,0,38
HARALSON,5/11/2020,21,18,0,39
HARALSON,5/12/2020,21,18,0,39
HARALSON,5/13/2020,21,18,0,39
HARALSON,5/14/2020,21,19,0,40
HARALSON,5/15/2020,21,19,0,40
HARALSON,5/16/2020,21,19,0,40
HARALSON,5/17/2020,21,19,0,40
HARALSON,5/18/2020,23,19,0,42
HARALSON,5/19/2020,23,20,0,43
HARALSON,5/20/2020,25,21,0,46
HARALSON,5/21/2020,25,22,0,47
HARALSON,5/22/2020,25,22,0,47
HARALSON,5/23/2020,25,22,0,47
HARALSON,5/24/2020,26,22,0,48
HARALSON,5/25/2020,26,23,0,49
HARALSON,5/26/2020,26,23,0,49
HARALSON,5/27/2020,27,24,0,51
HARALSON,5/28/2020,28,26,0,54
HARALSON,5/29/2020,28,26,1,55
HARALSON,5/30/2020,28,26,1,55
HARALSON,5/31/2020,29,26,1,56
HARALSON,6/1/2020,29,26,1,56
HARALSON,6/2/2020,29,27,1,57
HARALSON,6/3/2020,29,29,1,59
HARALSON,6/4/2020,30,30,1,61
HARALSON,6/5/2020,30,30,1,61
HARALSON,6/6/2020,30,31,1,62
HARALSON,6/7/2020,31,31,1,63
HARALSON,6/8/2020,31,32,1,64
HARALSON,6/9/2020,32,32,1,65
HARALSON,6/10/2020,32,32,1,65
HARALSON,6/11/2020,33,33,1,67
HARALSON,6/12/2020,34,33,1,68
HARALSON,6/13/2020,34,33,1,68
HARALSON,6/14/2020,35,33,1,69
HARALSON,6/15/2020,35,33,1,69
HARALSON,6/16/2020,35,34,1,70
HARALSON,6/17/2020,35,34,1,70
HARALSON,6/18/2020,36,36,1,73
HARALSON,6/19/2020,36,36,1,73
HARALSON,6/20/2020,36,37,1,74
HARALSON,6/21/2020,37,38,1,76
HARALSON,6/22/2020,40,39,1,80
HARALSON,6/23/2020,42,40,1,83
HARALSON,6/24/2020,42,40,2,84
HARALSON,6/25/2020,43,41,2,86
HARALSON,6/26/2020,44,42,2,88
HARALSON,6/27/2020,44,43,2,89
HARALSON,6/28/2020,45,44,2,91
HARALSON,6/29/2020,46,46,3,95
HARALSON,6/30/2020,46,48,3,97
HARALSON,7/1/2020,46,52,3,101
HARALSON,7/2/2020,47,53,3,103
HARALSON,7/3/2020,48,55,3,106
HARALSON,7/4/2020,50,55,3,108
HARALSON,7/5/2020,52,57,3,112
HARALSON,7/6/2020,57,62,3,122
HARALSON,7/7/2020,60,63,4,127
HARALSON,7/8/2020,62,65,4,131
HARALSON,7/9/2020,66,69,5,140
HARALSON,7/10/2020,68,71,5,144
HARALSON,7/11/2020,71,73,5,149
HARALSON,7/12/2020,72,74,5,151
HARALSON,7/13/2020,76,76,5,157
HARALSON,7/14/2020,78,78,5,161
HARALSON,7/15/2020,80,79,5,164
HARALSON,7/16/2020,85,82,5,172
HARALSON,7/17/2020,88,84,5,177
HARALSON,7/18/2020,91,85,5,181
HARALSON,7/19/2020,91,85,5,181
HARALSON,7/20/2020,92,89,6,187
HARALSON,7/21/2020,101,94,6,201
HARALSON,7/22/2020,102,97,6,205
HARALSON,7/23/2020,104,100,6,210
HARALSON,7/24/2020,107,108,6,221
HARALSON,7/25/2020,107,108,6,221
HARALSON,7/26/2020,108,108,6,222
HARALSON,7/27/2020,109,108,6,223
HARALSON,7/28/2020,110,108,6,224
HARALSON,7/29/2020,114,109,6,229
HARALSON,7/30/2020,117,110,7,234
HARALSON,7/31/2020,118,111,7,236
HARALSON,8/1/2020,118,112,7,237
HARALSON,8/2/2020,118,115,7,240
HARALSON,8/3/2020,119,116,7,242
HARALSON,8/4/2020,120,118,7,245
HARALSON,8/5/2020,120,121,7,248
HARALSON,8/6/2020,123,122,7,252
HARALSON,8/7/2020,130,127,7,264
HARALSON,8/8/2020,132,127,8,267
HARALSON,8/9/2020,132,128,8,268
HARALSON,8/10/2020,136,129,9,274
HARALSON,8/11/2020,141,132,9,282
HARALSON,8/12/2020,146,133,9,288
HARALSON,8/13/2020,150,134,9,293
HARALSON,8/14/2020,150,136,9,295
HARALSON,8/15/2020,152,136,9,297
HARALSON,8/16/2020,152,137,9,298
HARALSON,8/17/2020,154,144,9,307
HARALSON,8/18/2020,157,148,11,316
HARALSON,8/19/2020,161,153,12,326
HARALSON,8/20/2020,162,157,12,331
HARALSON,8/21/2020,164,162,13,339
HARALSON,8/22/2020,165,162,13,340
HARALSON,8/23/2020,168,162,13,343
HARALSON,8/24/2020,171,165,13,349
HARALSON,8/25/2020,177,167,13,357
HARALSON,8/26/2020,180,168,13,361
HARALSON,8/27/2020,181,171,13,365
HARALSON,8/28/2020,184,172,14,370
HARALSON,8/29/2020,186,172,14,372
HARALSON,8/30/2020,186,173,14,373
HARALSON,8/31/2020,192,178,14,384
HARALSON,9/1/2020,194,180,14,388
HARALSON,9/2/2020,196,181,14,391
HARALSON,9/3/2020,200,182,14,396
HARALSON,9/4/2020,204,184,14,402
HARALSON,9/5/2020,205,185,14,404
HARALSON,9/6/2020,205,185,14,404
HARALSON,9/7/2020,207,188,14,409
HARALSON,9/8/2020,210,190,14,414
HARALSON,9/9/2020,214,198,14,426
HARALSON,9/10/2020,218,204,14,436
HARALSON,9/11/2020,220,206,14,440
HARALSON,9/12/2020,220,210,14,444
HARALSON,9/13/2020,223,211,14,448
HARALSON,9/14/2020,226,214,14,454
HARALSON,9/15/2020,228,218,14,460
HARALSON,9/16/2020,231,219,14,464
HARALSON,9/17/2020,234,220,14,468
HARALSON,9/18/2020,237,226,14,477
HARALSON,9/19/2020,237,228,14,479
HARALSON,9/20/2020,239,229,14,482
HARALSON,9/21/2020,239,230,14,483
HARALSON,9/22/2020,242,231,14,487
HARALSON,9/23/2020,245,236,15,496
HARALSON,9/24/2020,251,237,15,503
HARALSON,9/25/2020,253,239,16,508
HARALSON,9/26/2020,254,242,16,512
HARALSON,9/27/2020,254,246,16,516
HARALSON,9/28/2020,255,248,16,519
HARALSON,9/29/2020,260,251,18,529
HARALSON,9/30/2020,265,253,18,536
HARALSON,10/1/2020,265,255,18,538
HARALSON,10/2/2020,266,258,18,542
HARALSON,10/3/2020,268,259,18,545
HARALSON,10/4/2020,270,260,18,548
LONG,4/24/2020,2,4,0,6
MUSCOGEE,5/18/2020,324,273,2,599
LONG,4/25/2020,2,4,0,6
MERIWETHER,2/2/2020,0,0,0,0
LONG,4/26/2020,2,4,0,6
MUSCOGEE,5/19/2020,332,276,2,610
LONG,4/27/2020,2,4,0,6
MERIWETHER,2/3/2020,0,0,0,0
MUSCOGEE,5/20/2020,338,283,2,623
LONG,4/28/2020,2,4,0,6
MERIWETHER,2/4/2020,0,0,0,0
MUSCOGEE,5/21/2020,347,290,2,639
LONG,4/29/2020,2,4,0,6
MERIWETHER,2/5/2020,0,0,0,0
MERIWETHER,2/6/2020,0,0,0,0
MERIWETHER,2/7/2020,0,0,0,0
MERIWETHER,2/8/2020,0,0,0,0
MERIWETHER,2/9/2020,0,0,0,0
MERIWETHER,2/10/2020,0,0,0,0
MERIWETHER,2/11/2020,0,0,0,0
MERIWETHER,2/12/2020,0,0,0,0
MERIWETHER,2/13/2020,0,0,0,0
MERIWETHER,2/14/2020,0,0,0,0
MERIWETHER,2/15/2020,0,0,0,0
MERIWETHER,2/16/2020,0,0,0,0
MERIWETHER,2/17/2020,0,0,0,0
MERIWETHER,2/18/2020,0,0,0,0
MERIWETHER,2/19/2020,0,0,0,0
MERIWETHER,2/20/2020,0,0,0,0
MERIWETHER,2/21/2020,0,0,0,0
MERIWETHER,2/22/2020,0,0,0,0
MERIWETHER,2/23/2020,0,0,0,0
MERIWETHER,2/24/2020,0,0,0,0
MERIWETHER,2/25/2020,0,0,0,0
MERIWETHER,2/26/2020,0,0,0,0
MERIWETHER,2/27/2020,0,0,0,0
MERIWETHER,2/28/2020,0,0,0,0
MERIWETHER,2/29/2020,0,0,0,0
MERIWETHER,3/1/2020,0,0,0,0
MERIWETHER,3/2/2020,0,0,0,0
MERIWETHER,3/3/2020,0,0,0,0
MERIWETHER,3/4/2020,0,0,0,0
MERIWETHER,3/5/2020,0,0,0,0
MERIWETHER,3/6/2020,1,0,0,1
MERIWETHER,3/7/2020,2,0,0,2
MERIWETHER,3/8/2020,2,0,0,2
MERIWETHER,3/9/2020,2,1,0,3
MERIWETHER,3/10/2020,2,1,0,3
MERIWETHER,3/11/2020,3,1,0,4
MERIWETHER,3/12/2020,4,1,0,5
MERIWETHER,3/13/2020,4,1,0,5
MERIWETHER,3/14/2020,4,1,0,5
MERIWETHER,3/15/2020,4,1,0,5
MERIWETHER,3/16/2020,4,1,0,5
MERIWETHER,3/17/2020,4,1,0,5
MERIWETHER,3/18/2020,4,1,0,5
MERIWETHER,3/19/2020,4,2,0,6
MERIWETHER,3/20/2020,5,2,0,7
MERIWETHER,3/21/2020,5,3,0,8
MERIWETHER,3/22/2020,6,4,0,10
MERIWETHER,3/23/2020,7,4,0,11
MERIWETHER,3/24/2020,8,5,0,13
MERIWETHER,3/25/2020,8,6,0,14
MERIWETHER,3/26/2020,11,6,0,17
MERIWETHER,3/27/2020,14,6,0,20
MERIWETHER,3/28/2020,15,7,0,22
MERIWETHER,3/29/2020,16,7,0,23
MERIWETHER,3/30/2020,17,8,0,25
MERIWETHER,3/31/2020,17,8,0,25
MERIWETHER,4/1/2020,18,8,0,26
MERIWETHER,4/2/2020,19,9,0,28
MERIWETHER,4/3/2020,20,9,0,29
MERIWETHER,4/4/2020,20,9,0,29
MERIWETHER,4/5/2020,20,9,0,29
MERIWETHER,4/6/2020,20,9,0,29
MERIWETHER,4/7/2020,22,9,0,31
MERIWETHER,4/8/2020,22,9,0,31
MERIWETHER,4/9/2020,23,10,0,33
MERIWETHER,4/10/2020,26,10,0,36
MERIWETHER,4/11/2020,26,10,0,36
MERIWETHER,4/12/2020,26,10,0,36
MERIWETHER,4/13/2020,29,11,0,40
MERIWETHER,4/14/2020,31,12,0,43
MERIWETHER,4/15/2020,31,12,0,43
MERIWETHER,4/16/2020,31,13,0,44
MERIWETHER,4/17/2020,34,13,0,47
MERIWETHER,4/18/2020,37,13,0,50
MERIWETHER,4/19/2020,37,14,0,51
MERIWETHER,4/20/2020,37,14,0,51
MERIWETHER,4/21/2020,38,15,0,53
MERIWETHER,4/22/2020,39,15,0,54
MERIWETHER,4/23/2020,39,16,0,55
MERIWETHER,4/24/2020,39,16,0,55
MERIWETHER,4/25/2020,40,16,0,56
MERIWETHER,4/26/2020,40,16,0,56
MERIWETHER,4/27/2020,41,16,0,57
MERIWETHER,4/28/2020,41,16,0,57
MERIWETHER,4/29/2020,42,16,0,58
MERIWETHER,4/30/2020,44,16,0,60
MERIWETHER,5/1/2020,44,16,0,60
MERIWETHER,5/2/2020,44,16,0,60
MERIWETHER,5/3/2020,45,16,0,61
MERIWETHER,5/4/2020,46,16,0,62
MERIWETHER,5/5/2020,46,17,0,63
MERIWETHER,5/6/2020,49,17,0,66
MERIWETHER,5/7/2020,50,17,0,67
MERIWETHER,5/8/2020,50,17,0,67
MERIWETHER,5/9/2020,50,17,0,67
MERIWETHER,5/10/2020,51,18,0,69
MERIWETHER,5/11/2020,51,19,0,70
MERIWETHER,5/12/2020,51,19,0,70
MERIWETHER,5/13/2020,52,19,0,71
MERIWETHER,5/14/2020,55,20,0,75
MERIWETHER,5/15/2020,56,21,0,77
MERIWETHER,5/16/2020,56,21,0,77
MERIWETHER,5/17/2020,57,21,0,78
MERIWETHER,5/18/2020,58,21,0,79
MERIWETHER,5/19/2020,59,21,0,80
MERIWETHER,5/20/2020,59,21,0,80
MERIWETHER,5/21/2020,60,21,0,81
MERIWETHER,5/22/2020,60,22,0,82
MERIWETHER,5/23/2020,61,22,0,83
MERIWETHER,5/24/2020,62,22,0,84
MERIWETHER,5/25/2020,62,23,0,85
MERIWETHER,5/26/2020,63,23,0,86
MERIWETHER,5/27/2020,66,24,0,90
MERIWETHER,5/28/2020,67,24,0,91
MERIWETHER,5/29/2020,72,25,0,97
MERIWETHER,5/30/2020,75,28,0,103
MERIWETHER,5/31/2020,75,28,0,103
MERIWETHER,6/1/2020,77,30,0,107
MERIWETHER,6/2/2020,81,32,0,113
MERIWETHER,6/3/2020,81,33,1,115
MERIWETHER,6/4/2020,83,34,1,118
MERIWETHER,6/5/2020,86,35,1,122
MERIWETHER,6/6/2020,86,36,1,123
MERIWETHER,6/7/2020,86,36,1,123
MERIWETHER,6/8/2020,87,37,1,125
MERIWETHER,6/9/2020,90,38,1,129
MERIWETHER,6/10/2020,90,41,2,133
MERIWETHER,6/11/2020,91,41,2,134
MERIWETHER,6/12/2020,96,42,2,140
MERIWETHER,6/13/2020,98,42,2,142
MERIWETHER,6/14/2020,99,43,2,144
MERIWETHER,6/15/2020,104,48,2,154
MERIWETHER,6/16/2020,104,54,2,160
MERIWETHER,6/17/2020,108,56,2,166
MERIWETHER,6/18/2020,117,59,2,178
MERIWETHER,6/19/2020,118,59,2,179
MERIWETHER,6/20/2020,120,60,2,182
MERIWETHER,6/21/2020,120,60,2,182
MERIWETHER,6/22/2020,123,62,2,187
MERIWETHER,6/23/2020,124,65,2,191
MERIWETHER,6/24/2020,127,69,2,198
MERIWETHER,6/25/2020,128,70,2,200
MERIWETHER,6/26/2020,136,73,2,211
MERIWETHER,6/27/2020,138,73,2,213
MERIWETHER,6/28/2020,139,73,2,214
MERIWETHER,6/29/2020,147,77,3,227
MERIWETHER,6/30/2020,150,78,3,231
MERIWETHER,7/1/2020,156,83,3,242
MERIWETHER,7/2/2020,162,86,3,251
MERIWETHER,7/3/2020,170,89,3,262
MERIWETHER,7/4/2020,170,89,3,262
MERIWETHER,7/5/2020,173,93,3,269
MERIWETHER,7/6/2020,179,95,3,277
MERIWETHER,7/7/2020,180,99,3,282
MERIWETHER,7/8/2020,184,101,3,288
MERIWETHER,7/9/2020,187,102,4,293
MERIWETHER,7/10/2020,201,103,4,308
MERIWETHER,7/11/2020,203,104,4,311
MERIWETHER,7/12/2020,205,107,4,316
MERIWETHER,7/13/2020,209,107,4,320
MERIWETHER,7/14/2020,213,109,4,326
MERIWETHER,7/15/2020,216,109,4,329
MERIWETHER,7/16/2020,218,115,4,337
MERIWETHER,7/17/2020,221,118,4,343
MERIWETHER,7/18/2020,223,118,4,345
MERIWETHER,7/19/2020,224,120,4,348
MERIWETHER,7/20/2020,227,122,4,353
MERIWETHER,7/21/2020,229,125,4,358
MERIWETHER,7/22/2020,230,129,4,363
MERIWETHER,7/23/2020,233,129,4,366
MERIWETHER,7/24/2020,235,136,4,375
MERIWETHER,7/25/2020,236,138,4,378
MERIWETHER,7/26/2020,238,139,4,381
MERIWETHER,7/27/2020,245,142,4,391
MERIWETHER,7/28/2020,246,143,4,393
MERIWETHER,7/29/2020,250,145,4,399
MERIWETHER,7/30/2020,251,145,4,400
MERIWETHER,7/31/2020,252,147,4,403
MERIWETHER,8/1/2020,255,147,4,406
MERIWETHER,8/2/2020,255,148,4,407
MERIWETHER,8/3/2020,261,150,4,415
MERIWETHER,8/4/2020,264,153,4,421
MERIWETHER,8/5/2020,267,157,4,428
MERIWETHER,8/6/2020,268,160,4,432
MERIWETHER,8/7/2020,271,162,4,437
MERIWETHER,8/8/2020,273,164,4,441
MERIWETHER,8/9/2020,275,164,4,443
MERIWETHER,8/10/2020,278,166,4,448
MERIWETHER,8/11/2020,281,167,4,452
MERIWETHER,8/12/2020,286,169,4,459
MERIWETHER,8/13/2020,289,170,4,463
MERIWETHER,8/14/2020,295,173,4,472
MERIWETHER,8/15/2020,296,174,4,474
MERIWETHER,8/16/2020,297,175,4,476
MERIWETHER,8/17/2020,298,176,4,478
MERIWETHER,8/18/2020,299,178,4,481
MERIWETHER,8/19/2020,303,180,4,487
MERIWETHER,8/20/2020,305,180,4,489
MERIWETHER,8/21/2020,307,181,4,492
MERIWETHER,8/22/2020,307,182,4,493
MERIWETHER,8/23/2020,307,183,4,494
MERIWETHER,8/24/2020,308,184,4,496
MERIWETHER,8/25/2020,309,187,4,500
MERIWETHER,8/26/2020,313,187,4,504
MERIWETHER,8/27/2020,313,187,4,504
MERIWETHER,8/28/2020,317,188,4,509
MERIWETHER,8/29/2020,318,188,4,510
MERIWETHER,8/30/2020,321,188,4,513
MERIWETHER,8/31/2020,325,190,4,519
MERIWETHER,9/1/2020,326,191,4,521
MERIWETHER,9/2/2020,328,192,4,524
MERIWETHER,9/3/2020,330,192,4,526
MERIWETHER,9/4/2020,331,194,4,529
MERIWETHER,9/5/2020,332,195,4,531
MERIWETHER,9/6/2020,332,195,4,531
MERIWETHER,9/7/2020,333,196,4,533
MERIWETHER,9/8/2020,333,197,4,534
MERIWETHER,9/9/2020,333,200,4,537
MERIWETHER,9/10/2020,333,202,4,539
MERIWETHER,9/11/2020,334,203,4,541
MERIWETHER,9/12/2020,336,203,5,544
MERIWETHER,9/13/2020,336,203,5,544
MERIWETHER,9/14/2020,336,204,5,545
MERIWETHER,9/15/2020,336,205,5,546
MERIWETHER,9/16/2020,339,206,5,550
MERIWETHER,9/17/2020,339,207,5,551
MERIWETHER,9/18/2020,340,207,5,552
MERIWETHER,9/19/2020,340,207,5,552
MERIWETHER,9/20/2020,340,207,5,552
MERIWETHER,9/21/2020,340,208,5,553
MERIWETHER,9/22/2020,341,208,5,554
MERIWETHER,9/23/2020,341,208,5,554
MERIWETHER,9/24/2020,342,208,5,555
MERIWETHER,9/25/2020,344,211,5,560
MERIWETHER,9/26/2020,344,211,5,560
MERIWETHER,9/27/2020,345,212,5,562
MERIWETHER,9/28/2020,346,212,5,563
MERIWETHER,9/29/2020,346,212,5,563
MERIWETHER,9/30/2020,346,212,5,563
MERIWETHER,10/1/2020,346,212,5,563
MERIWETHER,10/2/2020,347,213,5,565
MERIWETHER,10/3/2020,347,214,5,566
MERIWETHER,10/4/2020,348,214,5,567
MERIWETHER,10/5/2020,348,214,5,567
MERIWETHER,10/6/2020,348,214,5,567
MERIWETHER,10/7/2020,349,214,5,568
MERIWETHER,10/8/2020,349,214,5,568
MERIWETHER,10/9/2020,350,214,5,569
MERIWETHER,10/10/2020,351,214,5,570
MERIWETHER,10/11/2020,351,214,5,570
MERIWETHER,10/12/2020,353,214,5,572
MERIWETHER,10/13/2020,354,214,5,573
MERIWETHER,10/14/2020,355,214,5,574
MERIWETHER,10/15/2020,355,214,5,574
MERIWETHER,10/16/2020,356,215,5,576
MERIWETHER,10/17/2020,356,216,5,577
MERIWETHER,10/18/2020,356,216,5,577
MERIWETHER,10/19/2020,357,216,5,578
MERIWETHER,10/20/2020,357,216,5,578
MUSCOGEE,1/1/2020,0,0,0,0
MUSCOGEE,1/2/2020,0,0,0,0
MUSCOGEE,1/3/2020,0,0,0,0
MUSCOGEE,1/4/2020,0,0,0,0
MUSCOGEE,1/5/2020,0,0,0,0
MUSCOGEE,1/6/2020,0,0,0,0
MUSCOGEE,1/7/2020,0,0,0,0
MUSCOGEE,1/8/2020,0,0,0,0
MUSCOGEE,1/9/2020,0,0,0,0
MUSCOGEE,1/10/2020,0,0,0,0
MUSCOGEE,1/11/2020,0,0,0,0
MUSCOGEE,1/12/2020,0,0,0,0
MUSCOGEE,1/13/2020,0,0,0,0
MUSCOGEE,1/14/2020,0,0,0,0
MUSCOGEE,1/15/2020,0,0,0,0
MUSCOGEE,1/16/2020,0,0,0,0
MUSCOGEE,1/17/2020,0,0,0,0
MUSCOGEE,1/18/2020,0,0,0,0
MUSCOGEE,1/19/2020,0,0,0,0
MUSCOGEE,1/20/2020,0,0,0,0
MUSCOGEE,1/21/2020,0,0,0,0
MUSCOGEE,1/22/2020,0,0,0,0
MUSCOGEE,1/23/2020,0,0,0,0
MUSCOGEE,1/24/2020,0,0,0,0
MUSCOGEE,1/25/2020,0,0,0,0
MUSCOGEE,1/26/2020,0,0,0,0
MUSCOGEE,1/27/2020,0,0,0,0
MUSCOGEE,1/28/2020,0,0,0,0
MUSCOGEE,1/29/2020,0,0,0,0
MUSCOGEE,1/30/2020,0,0,0,0
MUSCOGEE,1/31/2020,0,0,0,0
MUSCOGEE,2/1/2020,0,0,0,0
MUSCOGEE,2/2/2020,0,0,0,0
MUSCOGEE,2/3/2020,0,0,0,0
MUSCOGEE,2/4/2020,0,0,0,0
MUSCOGEE,2/5/2020,0,0,0,0
MUSCOGEE,2/6/2020,0,0,0,0
MUSCOGEE,2/7/2020,0,0,0,0
MUSCOGEE,2/8/2020,0,0,0,0
MUSCOGEE,2/9/2020,0,0,0,0
MUSCOGEE,2/10/2020,0,0,0,0
MUSCOGEE,2/11/2020,0,0,0,0
MUSCOGEE,2/12/2020,0,0,0,0
MUSCOGEE,2/13/2020,0,0,0,0
MUSCOGEE,2/14/2020,0,0,0,0
MUSCOGEE,2/15/2020,0,0,0,0
MUSCOGEE,2/16/2020,0,0,0,0
MUSCOGEE,2/17/2020,0,0,0,0
MUSCOGEE,2/18/2020,0,0,0,0
MUSCOGEE,2/19/2020,0,0,0,0
MUSCOGEE,2/20/2020,0,0,0,0
MUSCOGEE,2/21/2020,0,0,0,0
MUSCOGEE,2/22/2020,0,0,0,0
MUSCOGEE,2/23/2020,0,0,0,0
MUSCOGEE,2/24/2020,0,0,0,0
MUSCOGEE,2/25/2020,0,0,0,0
MUSCOGEE,2/26/2020,0,0,0,0
MUSCOGEE,2/27/2020,0,0,0,0
MUSCOGEE,2/28/2020,0,0,0,0
MUSCOGEE,2/29/2020,0,0,0,0
MUSCOGEE,3/1/2020,1,0,0,1
MUSCOGEE,3/2/2020,1,0,0,1
MUSCOGEE,3/3/2020,1,0,0,1
MUSCOGEE,3/4/2020,1,0,0,1
MUSCOGEE,3/5/2020,2,0,0,2
MUSCOGEE,3/6/2020,2,0,0,2
MUSCOGEE,3/7/2020,2,0,0,2
MUSCOGEE,3/8/2020,2,1,0,3
MUSCOGEE,3/9/2020,2,1,0,3
MUSCOGEE,3/10/2020,3,3,0,6
MUSCOGEE,3/11/2020,5,4,0,9
MUSCOGEE,3/12/2020,6,4,0,10
MUSCOGEE,3/13/2020,6,6,0,12
MUSCOGEE,3/14/2020,8,6,0,14
MUSCOGEE,3/15/2020,10,8,0,18
MUSCOGEE,3/16/2020,13,9,0,22
MUSCOGEE,3/17/2020,16,11,0,27
MUSCOGEE,3/18/2020,17,13,0,30
MUSCOGEE,3/19/2020,19,13,0,32
MUSCOGEE,3/20/2020,19,13,0,32
MUSCOGEE,3/21/2020,19,14,0,33
MUSCOGEE,3/22/2020,22,14,0,36
MUSCOGEE,3/23/2020,26,18,0,44
MUSCOGEE,3/24/2020,28,20,0,48
MUSCOGEE,3/25/2020,33,22,0,55
MUSCOGEE,3/26/2020,35,23,0,58
MUSCOGEE,3/27/2020,41,25,0,66
MUSCOGEE,3/28/2020,41,27,0,68
MUSCOGEE,3/29/2020,47,29,0,76
MUSCOGEE,3/30/2020,52,31,0,83
MUSCOGEE,3/31/2020,57,33,0,90
MUSCOGEE,4/1/2020,60,40,0,100
MUSCOGEE,4/2/2020,62,44,0,106
MUSCOGEE,4/3/2020,70,52,0,122
MUSCOGEE,4/4/2020,81,62,0,143
MUSCOGEE,4/5/2020,94,65,0,159
MUSCOGEE,4/6/2020,109,78,0,187
MUSCOGEE,4/7/2020,116,82,0,198
MUSCOGEE,4/8/2020,122,85,0,207
MUSCOGEE,4/9/2020,128,89,0,217
MUSCOGEE,4/10/2020,134,96,0,230
MUSCOGEE,4/11/2020,137,97,0,234
MUSCOGEE,4/12/2020,141,98,0,239
MUSCOGEE,4/13/2020,145,104,0,249
MUSCOGEE,4/14/2020,150,108,0,258
MUSCOGEE,4/15/2020,156,110,0,266
MUSCOGEE,4/16/2020,159,118,0,277
MUSCOGEE,4/17/2020,163,124,0,287
MUSCOGEE,4/18/2020,165,126,0,291
MUSCOGEE,4/19/2020,167,130,0,297
MUSCOGEE,4/20/2020,177,135,0,312
MUSCOGEE,4/21/2020,180,143,0,323
MUSCOGEE,4/22/2020,187,148,0,335
MUSCOGEE,4/23/2020,189,151,0,340
MUSCOGEE,4/24/2020,195,156,0,351
MUSCOGEE,4/25/2020,196,157,0,353
MUSCOGEE,4/26/2020,198,160,0,358
MUSCOGEE,4/27/2020,200,165,0,365
MUSCOGEE,4/28/2020,202,169,0,371
MUSCOGEE,4/29/2020,206,173,0,379
MUSCOGEE,4/30/2020,213,174,0,387
MUSCOGEE,5/1/2020,214,178,0,392
MUSCOGEE,5/2/2020,220,184,0,404
MUSCOGEE,5/3/2020,221,186,0,407
MUSCOGEE,5/4/2020,229,188,0,417
MUSCOGEE,5/5/2020,233,190,0,423
MUSCOGEE,5/6/2020,238,194,0,432
MUSCOGEE,5/7/2020,245,201,2,448
MUSCOGEE,5/8/2020,248,207,2,457
MUSCOGEE,5/9/2020,251,208,2,461
MUSCOGEE,5/10/2020,254,209,2,465
MUSCOGEE,5/11/2020,265,218,2,485
MUSCOGEE,5/12/2020,272,222,2,496
MUSCOGEE,5/13/2020,283,232,2,517
MUSCOGEE,5/14/2020,295,239,2,536
MUSCOGEE,5/15/2020,304,248,2,554
MUSCOGEE,5/16/2020,311,259,2,572
MUSCOGEE,5/17/2020,314,264,2,580
LUMPKIN,8/8/2020,349,304,7,660
LAURENS,1/9/2020,0,0,0,0
MUSCOGEE,5/22/2020,353,292,2,647
MUSCOGEE,5/23/2020,359,296,2,657
LONG,4/30/2020,2,4,0,6
LUMPKIN,8/9/2020,353,305,7,665
MUSCOGEE,5/24/2020,361,298,2,661
LONG,5/1/2020,2,4,0,6
LUMPKIN,8/10/2020,360,310,7,677
MUSCOGEE,5/25/2020,366,307,2,675
LONG,5/2/2020,2,4,0,6
LUMPKIN,8/11/2020,366,315,7,688
MUSCOGEE,5/26/2020,381,315,2,698
LONG,5/3/2020,2,4,0,6
LAURENS,1/10/2020,0,0,0,0
LUMPKIN,8/12/2020,374,321,7,702
MUSCOGEE,5/27/2020,397,326,2,725
LONG,5/4/2020,2,4,0,6
LAURENS,1/11/2020,0,0,0,0
LUMPKIN,8/13/2020,379,328,7,714
MUSCOGEE,5/28/2020,417,341,2,760
LONG,5/5/2020,2,4,0,6
LAURENS,1/12/2020,0,0,0,0
LAURENS,1/13/2020,0,0,0,0
LAURENS,1/14/2020,0,0,0,0
LAURENS,1/15/2020,0,0,0,0
LAURENS,1/16/2020,0,0,0,0
LAURENS,1/17/2020,0,0,0,0
LAURENS,1/18/2020,0,0,0,0
LAURENS,1/19/2020,0,0,0,0
LAURENS,1/20/2020,0,0,0,0
LAURENS,1/21/2020,0,0,0,0
LAURENS,1/22/2020,0,0,0,0
LAURENS,1/23/2020,0,0,0,0
LAURENS,1/24/2020,0,0,0,0
LAURENS,1/25/2020,0,0,0,0
LAURENS,1/26/2020,0,0,0,0
LAURENS,1/27/2020,0,0,0,0
LAURENS,1/28/2020,0,0,0,0
LAURENS,1/29/2020,0,0,0,0
LAURENS,1/30/2020,0,0,0,0
LAURENS,1/31/2020,0,0,0,0
LAURENS,2/1/2020,0,0,0,0
LAURENS,2/2/2020,0,0,0,0
LAURENS,2/3/2020,0,0,0,0
LAURENS,2/4/2020,0,0,0,0
LAURENS,2/5/2020,0,0,0,0
LAURENS,2/6/2020,0,0,0,0
LAURENS,2/7/2020,0,0,0,0
LAURENS,2/8/2020,0,0,0,0
LAURENS,2/9/2020,0,0,0,0
LAURENS,2/10/2020,0,0,0,0
LAURENS,2/11/2020,0,0,0,0
LAURENS,2/12/2020,0,0,0,0
LAURENS,2/13/2020,0,0,0,0
LAURENS,2/14/2020,0,0,0,0
LAURENS,2/15/2020,0,0,0,0
LAURENS,2/16/2020,0,0,0,0
LAURENS,2/17/2020,0,0,0,0
LAURENS,2/18/2020,0,0,0,0
LAURENS,2/19/2020,0,0,0,0
LAURENS,2/20/2020,0,0,0,0
LAURENS,2/21/2020,0,0,0,0
LAURENS,2/22/2020,0,0,0,0
LAURENS,2/23/2020,0,0,0,0
LAURENS,2/24/2020,0,0,0,0
LAURENS,2/25/2020,0,0,0,0
LAURENS,2/26/2020,0,0,0,0
LAURENS,2/27/2020,0,0,0,0
LAURENS,2/28/2020,0,0,0,0
LAURENS,2/29/2020,0,0,0,0
LAURENS,3/1/2020,0,0,0,0
LAURENS,3/2/2020,0,0,0,0
LAURENS,3/3/2020,0,0,0,0
LAURENS,3/4/2020,0,0,0,0
LAURENS,3/5/2020,1,0,0,1
LAURENS,3/6/2020,2,0,0,2
LAURENS,3/7/2020,2,0,0,2
LAURENS,3/8/2020,2,1,0,3
LAURENS,3/9/2020,2,1,0,3
LAURENS,3/10/2020,2,1,0,3
LAURENS,3/11/2020,2,2,0,4
LAURENS,3/12/2020,2,2,0,4
LAURENS,3/13/2020,2,2,0,4
LAURENS,3/14/2020,2,3,0,5
LAURENS,3/15/2020,4,3,0,7
LAURENS,3/16/2020,5,3,0,8
LAURENS,3/17/2020,6,3,0,9
LAURENS,3/18/2020,7,3,0,10
LAURENS,3/19/2020,9,3,0,12
LAURENS,3/20/2020,9,3,0,12
LAURENS,3/21/2020,11,3,0,14
LAURENS,3/22/2020,12,3,0,15
LAURENS,3/23/2020,18,3,0,21
LAURENS,3/24/2020,19,3,0,22
LAURENS,3/25/2020,21,4,0,25
LAURENS,3/26/2020,24,4,0,28
LAURENS,3/27/2020,24,4,0,28
LAURENS,3/28/2020,25,6,0,31
LAURENS,3/29/2020,27,6,0,33
LAURENS,3/30/2020,28,6,0,34
LAURENS,3/31/2020,28,6,0,34
LAURENS,4/1/2020,29,6,0,35
LAURENS,4/2/2020,31,7,0,38
LAURENS,4/3/2020,32,7,0,39
LAURENS,4/4/2020,32,8,0,40
LAURENS,4/5/2020,33,8,0,41
LAURENS,4/6/2020,35,8,0,43
LAURENS,4/7/2020,37,8,0,45
LAURENS,4/8/2020,39,8,0,47
LAURENS,4/9/2020,39,8,0,47
LAURENS,4/10/2020,40,9,0,49
LAURENS,4/11/2020,41,9,0,50
LAURENS,4/12/2020,42,9,0,51
LAURENS,4/13/2020,47,11,0,58
LAURENS,4/14/2020,48,11,0,59
LAURENS,4/15/2020,49,11,0,60
LAURENS,4/16/2020,50,11,0,61
LAURENS,4/17/2020,50,11,0,61
LAURENS,4/18/2020,51,11,0,62
LAURENS,4/19/2020,51,11,0,62
LAURENS,4/20/2020,53,12,0,65
LAURENS,4/21/2020,55,14,0,69
LAURENS,4/22/2020,57,14,0,71
LAURENS,4/23/2020,57,14,0,71
LAURENS,4/24/2020,57,15,0,72
LAURENS,4/25/2020,61,19,0,80
LAURENS,4/26/2020,62,20,0,82
LAURENS,4/27/2020,62,21,0,83
LAURENS,4/28/2020,65,21,0,86
LAURENS,4/29/2020,65,21,0,86
LAURENS,4/30/2020,67,23,0,90
LAURENS,5/1/2020,68,23,0,91
LAURENS,5/2/2020,68,23,0,91
LAURENS,5/3/2020,68,26,0,94
LAURENS,5/4/2020,68,26,0,94
LAURENS,5/5/2020,69,28,0,97
LAURENS,5/6/2020,71,28,0,99
LAURENS,5/7/2020,74,28,0,102
LAURENS,5/8/2020,78,28,0,106
LAURENS,5/9/2020,80,29,0,109
LAURENS,5/10/2020,80,29,0,109
LAURENS,5/11/2020,83,30,0,113
LAURENS,5/12/2020,83,30,0,113
LAURENS,5/13/2020,84,30,0,114
LAURENS,5/14/2020,87,30,0,117
LAURENS,5/15/2020,90,31,0,121
LAURENS,5/16/2020,90,31,0,121
LAURENS,5/17/2020,90,31,0,121
LAURENS,5/18/2020,90,31,0,121
LAURENS,5/19/2020,92,31,0,123
LAURENS,5/20/2020,93,31,0,124
LAURENS,5/21/2020,93,31,0,124
LAURENS,5/22/2020,93,31,0,124
LAURENS,5/23/2020,93,31,0,124
LAURENS,5/24/2020,94,31,0,125
LAURENS,5/25/2020,96,32,0,128
LAURENS,5/26/2020,97,32,0,129
LAURENS,5/27/2020,98,33,0,131
LAURENS,5/28/2020,98,33,0,131
LAURENS,5/29/2020,99,33,0,132
LAURENS,5/30/2020,99,33,0,132
LAURENS,5/31/2020,99,33,0,132
LAURENS,6/1/2020,99,33,0,132
LAURENS,6/2/2020,100,33,0,133
LAURENS,6/3/2020,103,34,0,137
LAURENS,6/4/2020,103,35,0,138
LAURENS,6/5/2020,105,36,0,141
LAURENS,6/6/2020,108,36,0,144
LAURENS,6/7/2020,108,36,0,144
LAURENS,6/8/2020,108,36,0,144
LAURENS,6/9/2020,109,38,0,147
LAURENS,6/10/2020,109,39,0,148
LAURENS,6/11/2020,109,42,1,152
LAURENS,6/12/2020,109,44,1,154
LAURENS,6/13/2020,109,49,1,159
LAURENS,6/14/2020,109,51,1,161
LAURENS,6/15/2020,111,55,1,167
LAURENS,6/16/2020,115,57,1,173
LAURENS,6/17/2020,116,57,1,174
LAURENS,6/18/2020,117,60,1,178
LAURENS,6/19/2020,120,60,1,181
LAURENS,6/20/2020,122,62,1,185
LAURENS,6/21/2020,125,63,1,189
LAURENS,6/22/2020,132,69,1,202
LAURENS,6/23/2020,135,71,1,207
LAURENS,6/24/2020,143,75,1,219
LAURENS,6/25/2020,150,78,1,229
LAURENS,6/26/2020,153,85,1,239
LAURENS,6/27/2020,161,89,1,251
LAURENS,6/28/2020,167,97,1,265
LAURENS,6/29/2020,176,106,1,283
LAURENS,6/30/2020,191,112,1,304
LAURENS,7/1/2020,203,124,1,328
LAURENS,7/2/2020,213,132,1,346
LAURENS,7/3/2020,217,142,1,360
LAURENS,7/4/2020,230,148,1,379
LAURENS,7/5/2020,240,156,2,398
LAURENS,7/6/2020,266,167,2,435
LAURENS,7/7/2020,278,173,2,453
LAURENS,7/8/2020,285,182,2,469
LAURENS,7/9/2020,301,190,2,493
LAURENS,7/10/2020,313,201,2,516
LAURENS,7/11/2020,320,205,2,527
LAURENS,7/12/2020,329,207,2,538
LAURENS,7/13/2020,344,215,2,561
LAURENS,7/14/2020,353,222,2,577
LAURENS,7/15/2020,367,225,2,594
LAURENS,7/16/2020,378,230,2,610
LAURENS,7/17/2020,385,236,3,624
LAURENS,7/18/2020,390,244,3,637
LAURENS,7/19/2020,394,249,3,646
LAURENS,7/20/2020,407,260,3,670
LAURENS,7/21/2020,417,272,3,692
LAURENS,7/22/2020,428,279,3,710
LAURENS,7/23/2020,432,285,3,720
LAURENS,7/24/2020,437,291,3,731
LAURENS,7/25/2020,443,298,3,744
LAURENS,7/26/2020,448,302,3,753
LAURENS,7/27/2020,468,309,3,780
LAURENS,7/28/2020,489,324,6,819
LAURENS,7/29/2020,500,330,7,837
LAURENS,7/30/2020,512,338,9,859
LAURENS,7/31/2020,522,346,10,878
LAURENS,8/1/2020,532,353,10,895
LAURENS,8/2/2020,542,358,10,910
LAURENS,8/3/2020,559,379,11,949
LAURENS,8/4/2020,571,385,11,967
LAURENS,8/5/2020,607,400,11,1018
LAURENS,8/6/2020,613,407,11,1031
LAURENS,8/7/2020,671,432,15,1118
LAURENS,8/8/2020,680,436,15,1131
LAURENS,8/9/2020,685,438,15,1138
LAURENS,8/10/2020,691,440,15,1146
LAURENS,8/11/2020,697,450,15,1162
LAURENS,8/12/2020,711,463,15,1189
LAURENS,8/13/2020,716,469,16,1201
LAURENS,8/14/2020,723,474,16,1213
LAURENS,8/15/2020,729,481,16,1226
LAURENS,8/16/2020,734,485,16,1235
LAURENS,8/17/2020,747,491,16,1254
LAURENS,8/18/2020,755,497,16,1268
LAURENS,8/19/2020,762,504,16,1282
LAURENS,8/20/2020,772,509,16,1297
LAURENS,8/21/2020,781,512,16,1309
LAURENS,8/22/2020,784,515,17,1316
LAURENS,8/23/2020,788,519,17,1324
LAURENS,8/24/2020,797,530,17,1344
LAURENS,8/25/2020,801,534,17,1352
LAURENS,8/26/2020,810,541,17,1368
LAURENS,8/27/2020,821,545,17,1383
LAURENS,8/28/2020,827,548,17,1392
LAURENS,8/29/2020,831,550,17,1398
LAURENS,8/30/2020,834,556,17,1407
LAURENS,8/31/2020,844,559,17,1420
LAURENS,9/1/2020,854,561,18,1433
LAURENS,9/2/2020,857,567,19,1443
LAURENS,9/3/2020,862,572,19,1453
LAURENS,9/4/2020,875,587,20,1482
LAURENS,9/5/2020,880,589,20,1489
LAURENS,9/6/2020,882,592,20,1494
LAURENS,9/7/2020,888,593,20,1501
LAURENS,9/8/2020,896,597,20,1513
LAURENS,9/9/2020,900,601,20,1521
LAURENS,9/10/2020,905,609,20,1534
LAURENS,9/11/2020,917,613,21,1551
LAURENS,9/12/2020,925,618,24,1567
LAURENS,9/13/2020,929,621,24,1574
LAURENS,9/14/2020,932,629,24,1585
LAURENS,9/15/2020,933,638,24,1595
LAURENS,9/16/2020,943,639,24,1606
LAURENS,9/17/2020,947,646,24,1617
LAURENS,9/18/2020,951,651,24,1626
LAURENS,9/19/2020,954,654,24,1632
LAURENS,9/20/2020,957,656,24,1637
LAURENS,9/21/2020,962,662,24,1648
LAURENS,9/22/2020,965,666,24,1655
LAURENS,9/23/2020,973,670,24,1667
LAURENS,9/24/2020,979,674,24,1677
LAURENS,9/25/2020,981,676,24,1681
LAURENS,9/26/2020,982,679,24,1685
LAURENS,9/27/2020,987,681,24,1692
LAURENS,9/28/2020,995,688,24,1707
LAURENS,9/29/2020,1000,693,24,1717
LAURENS,9/30/2020,1006,699,24,1729
LAURENS,10/1/2020,1011,703,24,1738
LAURENS,10/2/2020,1022,713,24,1759
LAURENS,10/3/2020,1031,718,24,1773
LAURENS,10/4/2020,1036,721,24,1781
LAURENS,10/5/2020,1048,729,24,1801
LAURENS,10/6/2020,1064,740,24,1828
LAURENS,10/7/2020,1069,748,24,1841
LAURENS,10/8/2020,1079,752,24,1855
LAURENS,10/9/2020,1085,753,24,1862
LAURENS,10/10/2020,1092,756,24,1872
LAURENS,10/11/2020,1096,760,24,1880
LAURENS,10/12/2020,1100,765,24,1889
LAURENS,10/13/2020,1102,770,24,1896
LAURENS,10/14/2020,1108,772,24,1904
LAURENS,10/15/2020,1114,772,24,1910
LAURENS,10/16/2020,1116,774,24,1914
LAURENS,10/17/2020,1117,775,24,1916
LAURENS,10/18/2020,1117,775,24,1916
LAURENS,10/19/2020,1117,776,24,1917
LAURENS,10/20/2020,1117,776,24,1917
LONG,1/1/2020,0,0,0,0
LONG,1/2/2020,0,0,0,0
LONG,1/3/2020,0,0,0,0
LONG,1/4/2020,0,0,0,0
LONG,1/5/2020,0,0,0,0
LONG,1/6/2020,0,0,0,0
LONG,1/7/2020,0,0,0,0
LONG,1/8/2020,0,0,0,0
LONG,1/9/2020,0,0,0,0
LONG,1/10/2020,0,0,0,0
LONG,1/11/2020,0,0,0,0
LONG,1/12/2020,0,0,0,0
LONG,1/13/2020,0,0,0,0
LONG,1/14/2020,0,0,0,0
LONG,1/15/2020,0,0,0,0
LONG,1/16/2020,0,0,0,0
LONG,1/17/2020,0,0,0,0
LONG,1/18/2020,0,0,0,0
LONG,1/19/2020,0,0,0,0
LONG,1/20/2020,0,0,0,0
LONG,1/21/2020,0,0,0,0
LONG,1/22/2020,0,0,0,0
LONG,1/23/2020,0,0,0,0
LONG,1/24/2020,0,0,0,0
LONG,1/25/2020,0,0,0,0
LONG,1/26/2020,0,0,0,0
LONG,1/27/2020,0,0,0,0
LONG,1/28/2020,0,0,0,0
LONG,1/29/2020,0,0,0,0
LONG,1/30/2020,0,0,0,0
LONG,1/31/2020,0,0,0,0
LONG,2/1/2020,0,0,0,0
LONG,2/2/2020,0,0,0,0
LONG,2/3/2020,0,0,0,0
LONG,2/4/2020,0,0,0,0
LONG,2/5/2020,0,0,0,0
LONG,2/6/2020,0,0,0,0
LONG,2/7/2020,0,0,0,0
LONG,2/8/2020,0,0,0,0
LONG,2/9/2020,0,0,0,0
LONG,2/10/2020,0,0,0,0
LONG,2/11/2020,0,0,0,0
LONG,2/12/2020,0,0,0,0
LONG,2/13/2020,0,0,0,0
LONG,2/14/2020,0,0,0,0
LONG,2/15/2020,0,0,0,0
LONG,2/16/2020,0,0,0,0
LONG,2/17/2020,0,0,0,0
LONG,2/18/2020,0,0,0,0
LONG,2/19/2020,0,0,0,0
LONG,2/20/2020,0,0,0,0
LONG,2/21/2020,0,0,0,0
LONG,2/22/2020,0,0,0,0
LONG,2/23/2020,0,0,0,0
LONG,2/24/2020,0,0,0,0
LONG,2/25/2020,0,0,0,0
LONG,2/26/2020,0,0,0,0
LONG,2/27/2020,0,0,0,0
LONG,2/28/2020,0,0,0,0
LONG,2/29/2020,0,0,0,0
LONG,3/1/2020,0,0,0,0
LONG,3/2/2020,0,0,0,0
LONG,3/3/2020,0,0,0,0
LONG,3/4/2020,0,0,0,0
LONG,3/5/2020,0,0,0,0
LONG,3/6/2020,0,0,0,0
LONG,3/7/2020,0,0,0,0
LONG,3/8/2020,0,0,0,0
LONG,3/9/2020,0,0,0,0
LONG,3/10/2020,0,0,0,0
LONG,3/11/2020,0,0,0,0
LONG,3/12/2020,0,0,0,0
LONG,3/13/2020,0,1,0,1
LONG,3/14/2020,0,1,0,1
LONG,3/15/2020,0,1,0,1
LONG,3/16/2020,0,2,0,2
LONG,3/17/2020,0,2,0,2
LONG,3/18/2020,0,2,0,2
LONG,3/19/2020,0,2,0,2
LONG,3/20/2020,0,2,0,2
LONG,3/21/2020,0,2,0,2
LONG,3/22/2020,0,2,0,2
LONG,3/23/2020,0,2,0,2
LONG,3/24/2020,0,2,0,2
LONG,3/25/2020,0,2,0,2
LONG,3/26/2020,0,2,0,2
LONG,3/27/2020,0,2,0,2
LONG,3/28/2020,0,2,0,2
LONG,3/29/2020,0,2,0,2
LONG,3/30/2020,0,2,0,2
LONG,3/31/2020,0,2,0,2
LONG,4/1/2020,0,2,0,2
LONG,4/2/2020,0,2,0,2
LONG,4/3/2020,0,2,0,2
LONG,4/4/2020,0,2,0,2
LONG,4/5/2020,0,2,0,2
LONG,4/6/2020,0,2,0,2
LONG,4/7/2020,1,2,0,3
LONG,4/8/2020,1,2,0,3
LONG,4/9/2020,1,2,0,3
LONG,4/10/2020,1,2,0,3
LONG,4/11/2020,1,2,0,3
LONG,4/12/2020,1,3,0,4
LONG,4/13/2020,1,3,0,4
LONG,4/14/2020,1,3,0,4
LONG,4/15/2020,1,3,0,4
LONG,4/16/2020,1,3,0,4
LONG,4/17/2020,1,3,0,4
LONG,4/18/2020,1,3,0,4
LONG,4/19/2020,1,3,0,4
LONG,4/20/2020,1,3,0,4
LONG,4/21/2020,1,3,0,4
LONG,4/22/2020,1,4,0,5
LONG,4/23/2020,2,4,0,6
LONG,5/6/2020,2,5,0,7
LUMPKIN,8/14/2020,382,329,7,718
LONG,5/7/2020,4,6,0,10
LUMPKIN,8/15/2020,384,332,8,724
LUMPKIN,8/16/2020,389,338,8,735
LUMPKIN,8/17/2020,398,347,9,754
LUMPKIN,8/18/2020,402,353,9,764
LUMPKIN,8/19/2020,407,356,9,772
LUMPKIN,8/20/2020,410,357,9,776
LUMPKIN,8/21/2020,415,359,9,783
LUMPKIN,8/22/2020,416,362,9,787
LUMPKIN,8/23/2020,424,364,9,797
LUMPKIN,8/24/2020,430,369,9,808
LUMPKIN,8/25/2020,435,373,9,817
LUMPKIN,8/26/2020,440,374,9,823
LUMPKIN,8/27/2020,444,376,9,829
LUMPKIN,8/28/2020,448,380,9,837
LUMPKIN,8/29/2020,451,383,9,843
LUMPKIN,8/30/2020,453,384,9,846
LUMPKIN,8/31/2020,457,387,9,853
LUMPKIN,9/1/2020,460,390,9,859
LUMPKIN,9/2/2020,462,391,9,862
LUMPKIN,9/3/2020,465,392,9,866
LUMPKIN,9/4/2020,468,394,9,871
LUMPKIN,9/5/2020,470,395,9,874
LUMPKIN,9/6/2020,472,395,9,876
LUMPKIN,9/7/2020,473,395,9,877
LUMPKIN,9/8/2020,474,398,9,881
LUMPKIN,9/9/2020,478,398,9,885
LUMPKIN,9/10/2020,478,404,10,892
LUMPKIN,9/11/2020,481,408,10,899
LUMPKIN,9/12/2020,484,413,10,907
LUMPKIN,9/13/2020,485,414,10,909
LUMPKIN,9/14/2020,488,416,10,914
LUMPKIN,9/15/2020,489,417,10,916
LUMPKIN,9/16/2020,492,418,10,920
LUMPKIN,9/17/2020,492,418,10,920
LUMPKIN,9/18/2020,494,420,10,924
LUMPKIN,9/19/2020,495,420,10,925
LUMPKIN,9/20/2020,495,424,10,929
LUMPKIN,9/21/2020,496,425,10,931
LUMPKIN,9/22/2020,497,426,10,933
LUMPKIN,9/23/2020,499,427,10,936
LUMPKIN,9/24/2020,500,427,10,937
LUMPKIN,9/25/2020,501,428,10,939
LUMPKIN,9/26/2020,503,430,10,943
LUMPKIN,9/27/2020,503,433,10,946
LUMPKIN,9/28/2020,505,435,10,950
LUMPKIN,9/29/2020,505,437,10,952
LUMPKIN,9/30/2020,505,440,10,955
LUMPKIN,10/1/2020,508,440,10,958
LUMPKIN,10/2/2020,512,443,10,965
LUMPKIN,10/3/2020,515,443,10,968
LUMPKIN,10/4/2020,516,445,10,971
LUMPKIN,10/5/2020,518,448,10,976
LUMPKIN,10/6/2020,520,451,10,981
LUMPKIN,10/7/2020,521,451,10,982
LUMPKIN,10/8/2020,525,455,10,990
LUMPKIN,10/9/2020,526,456,10,992
LUMPKIN,10/10/2020,526,458,10,994
LUMPKIN,10/11/2020,527,463,10,1000
LUMPKIN,10/12/2020,528,467,10,1005
LUMPKIN,10/13/2020,530,469,10,1009
LUMPKIN,10/14/2020,532,469,10,1011
LUMPKIN,10/15/2020,533,471,10,1014
LUMPKIN,10/16/2020,534,474,10,1018
LUMPKIN,10/17/2020,534,474,10,1018
LUMPKIN,10/18/2020,534,474,10,1018
LUMPKIN,10/19/2020,534,474,10,1018
LUMPKIN,10/20/2020,534,474,10,1018
MCDUFFIE,1/1/2020,0,0,0,0
MCDUFFIE,1/2/2020,0,0,0,0
MCDUFFIE,1/3/2020,0,0,0,0
MCDUFFIE,1/4/2020,0,0,0,0
MCDUFFIE,1/5/2020,0,0,0,0
MCDUFFIE,1/6/2020,0,0,0,0
MCDUFFIE,1/7/2020,0,0,0,0
MCDUFFIE,1/8/2020,0,0,0,0
MCDUFFIE,1/9/2020,0,0,0,0
MCDUFFIE,1/10/2020,0,0,0,0
MCDUFFIE,1/11/2020,0,0,0,0
MCDUFFIE,1/12/2020,0,0,0,0
MCDUFFIE,1/13/2020,0,0,0,0
MCDUFFIE,1/14/2020,0,0,0,0
MCDUFFIE,1/15/2020,0,0,0,0
MCDUFFIE,1/16/2020,0,0,0,0
MCDUFFIE,1/17/2020,0,0,0,0
MCDUFFIE,1/18/2020,0,0,0,0
MCDUFFIE,1/19/2020,0,0,0,0
MCDUFFIE,1/20/2020,0,0,0,0
MCDUFFIE,1/21/2020,0,0,0,0
MCDUFFIE,1/22/2020,0,0,0,0
MCDUFFIE,1/23/2020,0,0,0,0
MCDUFFIE,1/24/2020,0,0,0,0
MCDUFFIE,1/25/2020,0,0,0,0
MCDUFFIE,1/26/2020,0,0,0,0
MCDUFFIE,1/27/2020,0,0,0,0
MCDUFFIE,1/28/2020,0,0,0,0
MCDUFFIE,1/29/2020,0,0,0,0
MCDUFFIE,1/30/2020,0,0,0,0
MCDUFFIE,1/31/2020,0,0,0,0
MCDUFFIE,2/1/2020,0,0,0,0
MCDUFFIE,2/2/2020,0,0,0,0
MCDUFFIE,2/3/2020,0,0,0,0
MCDUFFIE,2/4/2020,0,0,0,0
MCDUFFIE,2/5/2020,0,0,0,0
MCDUFFIE,2/6/2020,0,0,0,0
MCDUFFIE,2/7/2020,0,0,0,0
MCDUFFIE,2/8/2020,0,0,0,0
MCDUFFIE,2/9/2020,0,0,0,0
MCDUFFIE,2/10/2020,0,0,0,0
MCDUFFIE,2/11/2020,0,0,0,0
MCDUFFIE,2/12/2020,0,0,0,0
MCDUFFIE,2/13/2020,0,0,0,0
MCDUFFIE,2/14/2020,0,0,0,0
MCDUFFIE,2/15/2020,0,0,0,0
MCDUFFIE,2/16/2020,0,0,0,0
MCDUFFIE,2/17/2020,0,0,0,0
MCDUFFIE,2/18/2020,0,0,0,0
MCDUFFIE,2/19/2020,0,0,0,0
MCDUFFIE,2/20/2020,0,0,0,0
MCDUFFIE,2/21/2020,0,0,0,0
MCDUFFIE,2/22/2020,0,0,0,0
MCDUFFIE,2/23/2020,0,0,0,0
MCDUFFIE,2/24/2020,0,0,0,0
MCDUFFIE,2/25/2020,0,0,0,0
MCDUFFIE,2/26/2020,0,0,0,0
MCDUFFIE,2/27/2020,0,0,0,0
MCDUFFIE,2/28/2020,0,0,0,0
MCDUFFIE,2/29/2020,0,0,0,0
MCDUFFIE,3/1/2020,0,0,0,0
MCDUFFIE,3/2/2020,0,0,0,0
MCDUFFIE,3/3/2020,0,0,0,0
MCDUFFIE,3/4/2020,0,0,0,0
MCDUFFIE,3/5/2020,0,0,0,0
MCDUFFIE,3/6/2020,0,0,0,0
MCDUFFIE,3/7/2020,0,0,0,0
MCDUFFIE,3/8/2020,0,0,0,0
MCDUFFIE,3/9/2020,0,0,0,0
MCDUFFIE,3/10/2020,0,0,0,0
MCDUFFIE,3/11/2020,0,0,0,0
MCDUFFIE,3/12/2020,0,0,0,0
MCDUFFIE,3/13/2020,0,0,0,0
MCDUFFIE,3/14/2020,0,0,0,0
MCDUFFIE,3/15/2020,0,0,0,0
MCDUFFIE,3/16/2020,0,0,0,0
MCDUFFIE,3/17/2020,0,1,0,1
MCDUFFIE,3/18/2020,0,1,0,1
MCDUFFIE,3/19/2020,1,1,0,2
MCDUFFIE,3/20/2020,2,2,0,4
MCDUFFIE,3/21/2020,2,2,0,4
MCDUFFIE,3/22/2020,2,2,0,4
MCDUFFIE,3/23/2020,3,2,0,5
MCDUFFIE,3/24/2020,3,2,0,5
MCDUFFIE,3/25/2020,3,2,0,5
MUSCOGEE,5/29/2020,445,353,3,801
MCDUFFIE,3/26/2020,4,2,0,6
MCDUFFIE,3/27/2020,5,2,0,7
MCDUFFIE,3/28/2020,6,3,0,9
MCDUFFIE,3/29/2020,7,3,0,10
MCDUFFIE,3/30/2020,7,3,0,10
MCDUFFIE,3/31/2020,9,3,0,12
MCDUFFIE,4/1/2020,9,4,0,13
MCDUFFIE,4/2/2020,10,6,0,16
MCDUFFIE,4/3/2020,10,6,0,16
MCDUFFIE,4/4/2020,11,7,0,18
MCDUFFIE,4/5/2020,12,7,0,19
MCDUFFIE,4/6/2020,13,7,0,20
MCDUFFIE,4/7/2020,14,9,0,23
MCDUFFIE,4/8/2020,17,10,0,27
MCDUFFIE,4/9/2020,17,10,0,27
MCDUFFIE,4/10/2020,18,12,0,30
MCDUFFIE,4/11/2020,19,15,0,34
MCDUFFIE,4/12/2020,19,17,0,36
MCDUFFIE,4/13/2020,21,17,0,38
MCDUFFIE,4/14/2020,22,17,0,39
MCDUFFIE,4/15/2020,22,18,0,40
MCDUFFIE,4/16/2020,22,18,0,40
MCDUFFIE,4/17/2020,22,18,0,40
MCDUFFIE,4/18/2020,23,18,0,41
MCDUFFIE,4/19/2020,23,18,0,41
MCDUFFIE,4/20/2020,23,19,0,42
MCDUFFIE,4/21/2020,23,19,0,42
MCDUFFIE,4/22/2020,24,20,0,44
MCDUFFIE,4/23/2020,24,20,0,44
MCDUFFIE,4/24/2020,25,20,0,45
MCDUFFIE,4/25/2020,29,20,0,49
MCDUFFIE,4/26/2020,29,20,0,49
MCDUFFIE,4/27/2020,29,20,0,49
MCDUFFIE,4/28/2020,30,20,0,50
MCDUFFIE,4/29/2020,30,20,0,50
MCDUFFIE,4/30/2020,30,20,0,50
MCDUFFIE,5/1/2020,32,21,0,53
MCDUFFIE,5/2/2020,32,21,0,53
MCDUFFIE,5/3/2020,32,21,0,53
MCDUFFIE,5/4/2020,32,22,0,54
MCDUFFIE,5/5/2020,33,22,0,55
MCDUFFIE,5/6/2020,34,22,0,56
MCDUFFIE,5/7/2020,35,22,0,57
MCDUFFIE,5/8/2020,35,23,0,58
MCDUFFIE,5/9/2020,35,23,0,58
MCDUFFIE,5/10/2020,35,23,0,58
MCDUFFIE,5/11/2020,36,23,0,59
MCDUFFIE,5/12/2020,36,23,0,59
MCDUFFIE,5/13/2020,36,23,0,59
MCDUFFIE,5/14/2020,38,24,0,62
MCDUFFIE,5/15/2020,40,24,0,64
MCDUFFIE,5/16/2020,41,24,0,65
MCDUFFIE,5/17/2020,41,24,0,65
MCDUFFIE,5/18/2020,42,24,0,66
MCDUFFIE,5/19/2020,42,24,0,66
MCDUFFIE,5/20/2020,43,25,0,68
MCDUFFIE,5/21/2020,43,25,0,68
MCDUFFIE,5/22/2020,43,25,0,68
MCDUFFIE,5/23/2020,44,25,0,69
MCDUFFIE,5/24/2020,44,26,0,70
MCDUFFIE,5/25/2020,46,26,0,72
MCDUFFIE,5/26/2020,46,26,0,72
MCDUFFIE,5/27/2020,47,26,0,73
MCDUFFIE,5/28/2020,47,26,0,73
MCDUFFIE,5/29/2020,48,27,0,75
MCDUFFIE,5/30/2020,48,27,0,75
MCDUFFIE,5/31/2020,49,28,0,77
MCDUFFIE,6/1/2020,49,29,0,78
MCDUFFIE,6/2/2020,49,29,0,78
MCDUFFIE,6/3/2020,50,29,0,79
MCDUFFIE,6/4/2020,50,29,0,79
MCDUFFIE,6/5/2020,50,29,0,79
MCDUFFIE,6/6/2020,51,29,0,80
MCDUFFIE,6/7/2020,51,29,0,80
MCDUFFIE,6/8/2020,51,29,0,80
MCDUFFIE,6/9/2020,51,29,0,80
MCDUFFIE,6/10/2020,52,29,0,81
MCDUFFIE,6/11/2020,53,29,0,82
MCDUFFIE,6/12/2020,53,29,0,82
MCDUFFIE,6/13/2020,53,29,0,82
MCDUFFIE,6/14/2020,53,29,0,82
MCDUFFIE,6/15/2020,54,30,0,84
MCDUFFIE,6/16/2020,55,31,0,86
MCDUFFIE,6/17/2020,55,32,0,87
MCDUFFIE,6/18/2020,57,32,0,89
MCDUFFIE,6/19/2020,58,33,0,91
MCDUFFIE,6/20/2020,58,34,0,92
MCDUFFIE,6/21/2020,58,35,0,93
MCDUFFIE,6/22/2020,59,37,0,96
MCDUFFIE,6/23/2020,62,39,0,101
MCDUFFIE,6/24/2020,66,42,0,108
MCDUFFIE,6/25/2020,66,42,0,108
MCDUFFIE,6/26/2020,69,43,0,112
MCDUFFIE,6/27/2020,71,44,0,115
MCDUFFIE,6/28/2020,73,44,0,117
MCDUFFIE,6/29/2020,81,51,0,132
MCDUFFIE,6/30/2020,87,55,0,142
MCDUFFIE,7/1/2020,95,56,0,151
MCDUFFIE,7/2/2020,97,60,0,157
MCDUFFIE,7/3/2020,101,60,0,161
MCDUFFIE,7/4/2020,101,60,0,161
MCDUFFIE,7/5/2020,104,62,0,166
MCDUFFIE,7/6/2020,108,66,0,174
MCDUFFIE,7/7/2020,117,67,0,184
MCDUFFIE,7/8/2020,121,69,0,190
MCDUFFIE,7/9/2020,127,74,0,201
MCDUFFIE,7/10/2020,135,79,1,215
MCDUFFIE,7/11/2020,136,79,2,217
MCDUFFIE,7/12/2020,140,79,2,221
MCDUFFIE,7/13/2020,146,84,2,232
MCDUFFIE,7/14/2020,156,91,2,249
MCDUFFIE,7/15/2020,161,95,2,258
MCDUFFIE,7/16/2020,168,98,2,268
MCDUFFIE,7/17/2020,171,104,2,277
MCDUFFIE,7/18/2020,174,107,2,283
MCDUFFIE,7/19/2020,177,108,2,287
MCDUFFIE,7/20/2020,190,113,2,305
MCDUFFIE,7/21/2020,197,116,2,315
MCDUFFIE,7/22/2020,205,120,2,327
MCDUFFIE,7/23/2020,210,125,2,337
MCDUFFIE,7/24/2020,216,130,2,348
MCDUFFIE,7/25/2020,219,131,2,352
MCDUFFIE,7/26/2020,220,134,2,356
MCDUFFIE,7/27/2020,229,140,2,371
MCDUFFIE,7/28/2020,233,143,2,378
MCDUFFIE,7/29/2020,237,146,2,385
MCDUFFIE,7/30/2020,243,149,2,394
MCDUFFIE,7/31/2020,253,155,2,410
MCDUFFIE,8/1/2020,256,157,2,415
MCDUFFIE,8/2/2020,259,158,2,419
MCDUFFIE,8/3/2020,262,159,2,423
MCDUFFIE,8/4/2020,265,161,2,428
MCDUFFIE,8/5/2020,271,164,2,437
MCDUFFIE,8/6/2020,274,167,2,443
MCDUFFIE,8/7/2020,282,170,2,454
MCDUFFIE,8/8/2020,283,170,2,455
MCDUFFIE,8/9/2020,287,171,2,460
MCDUFFIE,8/10/2020,290,174,2,466
MCDUFFIE,8/11/2020,294,179,2,475
MCDUFFIE,8/12/2020,295,182,2,479
MCDUFFIE,8/13/2020,297,185,2,484
MCDUFFIE,8/14/2020,302,187,2,491
MCDUFFIE,8/15/2020,302,190,2,494
MCDUFFIE,8/16/2020,303,190,2,495
MCDUFFIE,8/17/2020,307,191,2,500
MCDUFFIE,8/18/2020,310,195,2,507
MCDUFFIE,8/19/2020,315,196,2,513
MCDUFFIE,8/20/2020,315,204,3,522
MCDUFFIE,8/21/2020,316,205,3,524
MCDUFFIE,8/22/2020,317,212,3,532
MCDUFFIE,8/23/2020,318,213,3,534
MCDUFFIE,8/24/2020,322,216,3,541
MCDUFFIE,8/25/2020,324,217,3,544
MCDUFFIE,8/26/2020,325,224,3,552
MCDUFFIE,8/27/2020,327,226,3,556
MCDUFFIE,8/28/2020,328,226,3,557
MCDUFFIE,8/29/2020,329,228,4,561
MCDUFFIE,8/30/2020,330,229,4,563
MCDUFFIE,8/31/2020,332,231,4,567
MCDUFFIE,9/1/2020,333,233,4,570
MCDUFFIE,9/2/2020,333,234,4,571
MCDUFFIE,9/3/2020,336,234,4,574
MCDUFFIE,9/4/2020,337,236,4,577
MCDUFFIE,9/5/2020,339,238,4,581
MCDUFFIE,9/6/2020,340,239,4,583
MCDUFFIE,9/7/2020,342,239,4,585
MCDUFFIE,9/8/2020,346,241,4,591
MCDUFFIE,9/9/2020,348,242,4,594
MCDUFFIE,9/10/2020,351,242,4,597
MCDUFFIE,9/11/2020,355,244,4,603
MCDUFFIE,9/12/2020,356,245,4,605
MCDUFFIE,9/13/2020,358,247,4,609
MCDUFFIE,9/14/2020,360,248,4,612
MCDUFFIE,9/15/2020,360,248,4,612
MCDUFFIE,9/16/2020,361,249,4,614
MCDUFFIE,9/17/2020,361,249,4,614
MCDUFFIE,9/18/2020,362,249,4,615
MCDUFFIE,9/19/2020,362,249,4,615
MCDUFFIE,9/20/2020,362,250,4,616
MCDUFFIE,9/21/2020,365,253,4,622
MCDUFFIE,9/22/2020,365,253,4,622
MCDUFFIE,9/23/2020,365,254,4,623
MCDUFFIE,9/24/2020,368,254,4,626
MCDUFFIE,9/25/2020,368,256,4,628
MCDUFFIE,9/26/2020,368,257,4,629
MCDUFFIE,9/27/2020,368,257,4,629
MCDUFFIE,9/28/2020,368,258,4,630
MCDUFFIE,9/29/2020,369,258,4,631
MCDUFFIE,9/30/2020,370,259,4,633
MCDUFFIE,10/1/2020,371,261,4,636
MCDUFFIE,10/2/2020,372,261,4,637
MCDUFFIE,10/3/2020,373,263,4,640
MCDUFFIE,10/4/2020,373,264,4,641
MCDUFFIE,10/5/2020,375,267,4,646
MCDUFFIE,10/6/2020,376,267,4,647
MCDUFFIE,10/7/2020,377,268,4,649
MCDUFFIE,10/8/2020,378,268,4,650
MCDUFFIE,10/9/2020,378,270,4,652
MCDUFFIE,10/10/2020,378,271,4,653
MCDUFFIE,10/11/2020,378,271,4,653
MCDUFFIE,10/12/2020,378,272,4,654
MCDUFFIE,10/13/2020,380,274,4,658
MCDUFFIE,10/14/2020,381,274,4,659
MCDUFFIE,10/15/2020,384,276,4,664
MCDUFFIE,10/16/2020,384,277,4,665
MCDUFFIE,10/17/2020,384,278,4,666
MCDUFFIE,10/18/2020,384,278,4,666
MCDUFFIE,10/19/2020,384,278,4,666
MCDUFFIE,10/20/2020,384,278,4,666
MERIWETHER,1/1/2020,0,0,0,0
MERIWETHER,1/2/2020,0,0,0,0
MERIWETHER,1/3/2020,0,0,0,0
MERIWETHER,1/4/2020,0,0,0,0
MERIWETHER,1/5/2020,0,0,0,0
MERIWETHER,1/6/2020,0,0,0,0
MERIWETHER,1/7/2020,0,0,0,0
MERIWETHER,1/8/2020,0,0,0,0
MERIWETHER,1/9/2020,0,0,0,0
MERIWETHER,1/10/2020,0,0,0,0
MERIWETHER,1/11/2020,0,0,0,0
MERIWETHER,1/12/2020,0,0,0,0
MERIWETHER,1/13/2020,0,0,0,0
MERIWETHER,1/14/2020,0,0,0,0
MERIWETHER,1/15/2020,0,0,0,0
MERIWETHER,1/16/2020,0,0,0,0
MERIWETHER,1/17/2020,0,0,0,0
MERIWETHER,1/18/2020,0,0,0,0
MERIWETHER,1/19/2020,0,0,0,0
MERIWETHER,1/20/2020,0,0,0,0
MERIWETHER,1/21/2020,0,0,0,0
MERIWETHER,1/22/2020,0,0,0,0
MERIWETHER,1/23/2020,0,0,0,0
MERIWETHER,1/24/2020,0,0,0,0
MERIWETHER,1/25/2020,0,0,0,0
MERIWETHER,1/26/2020,0,0,0,0
MERIWETHER,1/27/2020,0,0,0,0
MERIWETHER,1/28/2020,0,0,0,0
MERIWETHER,1/29/2020,0,0,0,0
MERIWETHER,1/30/2020,0,0,0,0
MERIWETHER,1/31/2020,0,0,0,0
MERIWETHER,2/1/2020,0,0,0,0
LONG,5/8/2020,4,6,0,10
LONG,5/9/2020,4,6,0,10
MUSCOGEE,5/30/2020,468,369,3,840
LONG,5/10/2020,4,6,0,10
MUSCOGEE,5/31/2020,480,379,3,862
LONG,5/11/2020,4,6,0,10
MUSCOGEE,6/1/2020,509,394,3,906
LONG,5/12/2020,4,6,0,10
LONG,5/13/2020,5,6,0,11
LONG,5/14/2020,7,8,0,15
LONG,5/15/2020,7,8,0,15
LONG,5/16/2020,7,8,0,15
LONG,5/17/2020,7,8,0,15
LONG,5/18/2020,7,8,0,15
LONG,5/19/2020,7,8,0,15
LONG,5/20/2020,7,8,0,15
LONG,5/21/2020,7,8,0,15
LONG,5/22/2020,7,10,0,17
LONG,5/23/2020,7,10,0,17
LONG,5/24/2020,7,10,0,17
LONG,5/25/2020,7,10,0,17
LONG,5/26/2020,7,10,0,17
LONG,5/27/2020,7,10,0,17
LONG,5/28/2020,8,10,0,18
LONG,5/29/2020,9,10,0,19
LONG,5/30/2020,9,10,0,19
LONG,5/31/2020,9,10,0,19
LONG,6/1/2020,9,10,0,19
LONG,6/2/2020,9,10,0,19
LONG,6/3/2020,10,10,0,20
LONG,6/4/2020,11,12,0,23
LONG,6/5/2020,11,12,0,23
LONG,6/6/2020,11,12,0,23
LONG,6/7/2020,11,12,0,23
LONG,6/8/2020,13,12,0,25
LONG,6/9/2020,13,12,0,25
LONG,6/10/2020,13,12,0,25
LONG,6/11/2020,13,14,0,27
LONG,6/12/2020,13,15,0,28
LONG,6/13/2020,13,15,0,28
LONG,6/14/2020,15,15,0,30
LONG,6/15/2020,16,15,0,31
LONG,6/16/2020,16,16,0,32
LONG,6/17/2020,17,16,0,33
LONG,6/18/2020,19,16,0,35
LONG,6/19/2020,20,17,0,37
LONG,6/20/2020,21,18,0,39
LONG,6/21/2020,22,18,0,40
LONG,6/22/2020,23,19,0,42
LONG,6/23/2020,24,21,0,45
LONG,6/24/2020,26,21,0,47
LONG,6/25/2020,26,22,0,48
LONG,6/26/2020,27,22,0,49
LONG,6/27/2020,27,23,0,50
LONG,6/28/2020,27,24,0,51
LONG,6/29/2020,29,26,0,55
LONG,6/30/2020,29,30,0,59
LONG,7/1/2020,32,31,0,63
LONG,7/2/2020,32,33,1,66
LONG,7/3/2020,32,33,1,66
LONG,7/4/2020,34,33,1,68
LONG,7/5/2020,35,34,1,70
LONG,7/6/2020,37,37,1,75
LONG,7/7/2020,39,37,1,77
LONG,7/8/2020,40,38,1,79
LONG,7/9/2020,40,39,1,80
LONG,7/10/2020,41,40,1,82
LONG,7/11/2020,43,40,1,84
LONG,7/12/2020,45,41,1,87
LONG,7/13/2020,50,43,1,94
LONG,7/14/2020,51,46,1,98
LONG,7/15/2020,51,48,1,100
LONG,7/16/2020,52,48,1,101
LONG,7/17/2020,55,48,1,104
LONG,7/18/2020,56,48,1,105
LONG,7/19/2020,58,48,1,107
LONG,7/20/2020,58,50,1,109
LONG,7/21/2020,59,52,1,112
LONG,7/22/2020,60,52,1,113
LONG,7/23/2020,60,53,1,114
LONG,7/24/2020,61,54,1,116
LONG,7/25/2020,61,54,1,116
LONG,7/26/2020,64,54,1,119
LONG,7/27/2020,66,57,1,124
LONG,7/28/2020,66,58,1,125
LONG,7/29/2020,66,58,1,125
LONG,7/30/2020,66,58,1,125
LONG,7/31/2020,67,58,1,126
LONG,8/1/2020,67,59,1,127
LONG,8/2/2020,69,61,1,131
LONG,8/3/2020,70,63,1,134
LONG,8/4/2020,70,66,1,137
LONG,8/5/2020,72,67,1,140
LONG,8/6/2020,72,68,1,141
LONG,8/7/2020,73,68,1,142
LONG,8/8/2020,73,69,1,143
LONG,8/9/2020,73,70,1,144
LONG,8/10/2020,78,75,1,154
LONG,8/11/2020,79,78,1,158
LONG,8/12/2020,83,83,1,167
LONG,8/13/2020,84,83,1,168
LONG,8/14/2020,84,85,1,170
LONG,8/15/2020,85,87,1,173
LONG,8/16/2020,86,88,1,175
LONG,8/17/2020,86,89,1,176
LONG,8/18/2020,86,91,1,178
LONG,8/19/2020,87,92,1,180
LONG,8/20/2020,88,96,1,185
LONG,8/21/2020,89,96,1,186
LONG,8/22/2020,89,96,1,186
LONG,8/23/2020,90,96,1,187
LONG,8/24/2020,92,98,1,191
LONG,8/25/2020,93,98,1,192
LONG,8/26/2020,94,99,1,194
LONG,8/27/2020,94,99,1,194
LONG,8/28/2020,97,100,1,198
LONG,8/29/2020,98,100,1,199
LONG,8/30/2020,98,101,1,200
LONG,8/31/2020,100,102,1,203
LONG,9/1/2020,100,103,1,204
LONG,9/2/2020,101,103,1,205
LONG,9/3/2020,104,103,1,208
LONG,9/4/2020,107,105,1,213
LONG,9/5/2020,109,106,1,216
LONG,9/6/2020,109,110,1,220
LONG,9/7/2020,111,112,1,224
LONG,9/8/2020,113,114,1,228
LONG,9/9/2020,113,115,1,229
LONG,9/10/2020,113,115,1,229
LONG,9/11/2020,115,115,1,231
LONG,9/12/2020,117,115,1,233
LONG,9/13/2020,119,116,1,236
LONG,9/14/2020,119,117,1,237
LONG,9/15/2020,119,117,1,237
LONG,9/16/2020,120,118,1,239
LONG,9/17/2020,121,119,1,241
LONG,9/18/2020,122,122,1,245
LONG,9/19/2020,122,122,1,245
LONG,9/20/2020,122,123,1,246
LONG,9/21/2020,124,123,1,248
LONG,9/22/2020,126,125,1,252
LONG,9/23/2020,126,125,1,252
LONG,9/24/2020,126,128,1,255
LONG,9/25/2020,126,128,1,255
LONG,9/26/2020,127,128,1,256
LONG,9/27/2020,127,128,1,256
LONG,9/28/2020,127,129,1,257
LONG,9/29/2020,127,129,1,257
LONG,9/30/2020,127,130,1,258
LONG,10/1/2020,128,130,1,259
LONG,10/2/2020,129,131,1,261
LONG,10/3/2020,130,133,1,264
LONG,10/4/2020,130,133,1,264
LONG,10/5/2020,130,133,1,264
LONG,10/6/2020,132,133,1,266
LONG,10/7/2020,132,133,1,266
LONG,10/8/2020,132,134,1,267
LONG,10/9/2020,132,135,1,268
LONG,10/10/2020,132,135,1,268
LONG,10/11/2020,132,135,1,268
LONG,10/12/2020,133,135,1,269
LONG,10/13/2020,133,135,1,269
LONG,10/14/2020,133,135,1,269
LONG,10/15/2020,133,135,1,269
LONG,10/16/2020,133,136,1,270
LONG,10/17/2020,135,136,1,272
LONG,10/18/2020,135,136,1,272
LONG,10/19/2020,135,136,1,272
LONG,10/20/2020,135,136,1,272
LUMPKIN,1/1/2020,0,0,0,0
LUMPKIN,1/2/2020,0,0,0,0
LUMPKIN,1/3/2020,0,0,0,0
LUMPKIN,1/4/2020,0,0,0,0
LUMPKIN,1/5/2020,0,0,0,0
LUMPKIN,1/6/2020,0,0,0,0
LUMPKIN,1/7/2020,0,0,0,0
LUMPKIN,1/8/2020,0,0,0,0
LUMPKIN,1/9/2020,0,0,0,0
LUMPKIN,1/10/2020,0,0,0,0
LUMPKIN,1/11/2020,0,0,0,0
LUMPKIN,1/12/2020,0,0,0,0
LUMPKIN,1/13/2020,0,0,0,0
LUMPKIN,1/14/2020,0,0,0,0
LUMPKIN,1/15/2020,0,0,0,0
LUMPKIN,1/16/2020,0,0,0,0
LUMPKIN,1/17/2020,0,0,0,0
LUMPKIN,1/18/2020,0,0,0,0
LUMPKIN,1/19/2020,0,0,0,0
LUMPKIN,1/20/2020,0,0,0,0
LUMPKIN,1/21/2020,0,0,0,0
LUMPKIN,1/22/2020,0,0,0,0
LUMPKIN,1/23/2020,0,0,0,0
LUMPKIN,1/24/2020,0,0,0,0
LUMPKIN,1/25/2020,0,0,0,0
LUMPKIN,1/26/2020,0,0,0,0
LUMPKIN,1/27/2020,0,0,0,0
LUMPKIN,1/28/2020,0,0,0,0
LUMPKIN,1/29/2020,0,0,0,0
LUMPKIN,1/30/2020,0,0,0,0
LUMPKIN,1/31/2020,0,0,0,0
LUMPKIN,2/1/2020,0,0,0,0
LUMPKIN,2/2/2020,0,0,0,0
LUMPKIN,2/3/2020,0,0,0,0
LUMPKIN,2/4/2020,0,0,0,0
LUMPKIN,2/5/2020,0,0,0,0
LUMPKIN,2/6/2020,0,0,0,0
LUMPKIN,2/7/2020,0,0,0,0
LUMPKIN,2/8/2020,0,0,0,0
LUMPKIN,2/9/2020,0,0,0,0
LUMPKIN,2/10/2020,0,0,0,0
LUMPKIN,2/11/2020,0,0,0,0
LUMPKIN,2/12/2020,0,0,0,0
LUMPKIN,2/13/2020,0,0,0,0
LUMPKIN,2/14/2020,0,0,0,0
LUMPKIN,2/15/2020,0,0,0,0
LUMPKIN,2/16/2020,0,0,0,0
LUMPKIN,2/17/2020,0,0,0,0
LUMPKIN,2/18/2020,1,0,0,1
LUMPKIN,2/19/2020,1,1,0,2
LUMPKIN,2/20/2020,1,1,0,2
LUMPKIN,2/21/2020,1,1,0,2
LUMPKIN,2/22/2020,1,1,0,2
LUMPKIN,2/23/2020,1,1,0,2
LUMPKIN,2/24/2020,1,1,0,2
LUMPKIN,2/25/2020,1,1,0,2
LUMPKIN,2/26/2020,1,1,0,2
LUMPKIN,2/27/2020,1,1,0,2
LUMPKIN,2/28/2020,1,1,0,2
LUMPKIN,2/29/2020,1,1,0,2
LUMPKIN,3/1/2020,1,1,0,2
LUMPKIN,3/2/2020,1,1,0,2
LUMPKIN,3/3/2020,1,1,0,2
LUMPKIN,3/4/2020,1,1,0,2
LUMPKIN,3/5/2020,1,1,0,2
LUMPKIN,3/6/2020,1,1,0,2
LUMPKIN,3/7/2020,1,1,0,2
LUMPKIN,3/8/2020,1,1,0,2
LUMPKIN,3/9/2020,1,1,0,2
LUMPKIN,3/10/2020,1,1,0,2
LUMPKIN,3/11/2020,1,2,0,3
LUMPKIN,3/12/2020,1,2,0,3
LUMPKIN,3/13/2020,1,2,0,3
LUMPKIN,3/14/2020,1,2,0,3
LUMPKIN,3/15/2020,1,2,0,3
LUMPKIN,3/16/2020,1,3,0,4
LUMPKIN,3/17/2020,1,4,0,5
LUMPKIN,3/18/2020,2,4,0,6
LUMPKIN,3/19/2020,2,4,0,6
LUMPKIN,3/20/2020,2,4,0,6
LUMPKIN,3/21/2020,3,4,0,7
LUMPKIN,3/22/2020,3,4,0,7
LUMPKIN,3/23/2020,4,4,0,8
LUMPKIN,3/24/2020,4,4,0,8
LUMPKIN,3/25/2020,4,4,0,8
LUMPKIN,3/26/2020,4,4,0,8
LUMPKIN,3/27/2020,4,5,0,9
LUMPKIN,3/28/2020,4,7,0,11
LUMPKIN,3/29/2020,4,7,0,11
LUMPKIN,3/30/2020,4,7,0,11
LUMPKIN,3/31/2020,4,7,0,11
LUMPKIN,4/1/2020,6,7,0,13
LUMPKIN,4/2/2020,6,10,0,16
LUMPKIN,4/3/2020,7,10,0,17
LUMPKIN,4/4/2020,8,10,0,18
LUMPKIN,4/5/2020,9,10,0,19
LUMPKIN,4/6/2020,10,10,0,20
LUMPKIN,4/7/2020,15,15,0,30
LUMPKIN,4/8/2020,17,15,0,32
LUMPKIN,4/9/2020,18,17,0,35
LUMPKIN,4/10/2020,19,20,0,39
LUMPKIN,4/11/2020,19,20,0,39
LUMPKIN,4/12/2020,19,20,0,39
LUMPKIN,4/13/2020,19,22,0,41
LUMPKIN,4/14/2020,19,22,0,41
LUMPKIN,4/15/2020,20,22,0,42
LUMPKIN,4/16/2020,21,22,0,43
LUMPKIN,4/17/2020,24,23,0,47
LUMPKIN,4/18/2020,25,23,0,48
LUMPKIN,4/19/2020,28,24,0,52
LUMPKIN,4/20/2020,29,25,0,54
LUMPKIN,4/21/2020,32,25,0,57
LUMPKIN,4/22/2020,34,27,0,61
LUMPKIN,4/23/2020,35,29,0,64
LUMPKIN,4/24/2020,36,32,0,68
LUMPKIN,4/25/2020,37,33,0,70
LUMPKIN,4/26/2020,37,35,0,72
LUMPKIN,4/27/2020,39,37,0,76
LUMPKIN,4/28/2020,39,39,0,78
LUMPKIN,4/29/2020,41,40,0,81
LUMPKIN,4/30/2020,41,40,0,81
LUMPKIN,5/1/2020,42,40,0,82
LUMPKIN,5/2/2020,42,42,1,85
LUMPKIN,5/3/2020,42,42,1,85
LUMPKIN,5/4/2020,42,42,1,85
LUMPKIN,5/5/2020,42,43,1,86
LUMPKIN,5/6/2020,42,43,1,86
LUMPKIN,5/7/2020,43,43,1,87
LUMPKIN,5/8/2020,44,43,1,88
LUMPKIN,5/9/2020,45,43,1,89
LUMPKIN,5/10/2020,45,44,1,90
LUMPKIN,5/11/2020,47,45,1,93
LUMPKIN,5/12/2020,47,45,1,93
LUMPKIN,5/13/2020,47,45,1,93
LUMPKIN,5/14/2020,47,46,1,94
LUMPKIN,5/15/2020,47,46,1,94
LUMPKIN,5/16/2020,47,46,1,94
LUMPKIN,5/17/2020,47,47,1,95
LUMPKIN,5/18/2020,47,48,1,96
LUMPKIN,5/19/2020,47,48,1,96
LUMPKIN,5/20/2020,47,48,1,96
LUMPKIN,5/21/2020,47,48,1,96
LUMPKIN,5/22/2020,47,48,1,96
LUMPKIN,5/23/2020,48,49,1,98
LUMPKIN,5/24/2020,48,50,1,99
LUMPKIN,5/25/2020,49,50,1,100
LUMPKIN,5/26/2020,49,52,1,102
LUMPKIN,5/27/2020,50,53,1,104
LUMPKIN,5/28/2020,50,54,1,105
LUMPKIN,5/29/2020,50,54,1,105
LUMPKIN,5/30/2020,50,54,1,105
LUMPKIN,5/31/2020,51,54,1,106
LUMPKIN,6/1/2020,51,55,1,107
LUMPKIN,6/2/2020,53,55,1,109
LUMPKIN,6/3/2020,54,55,1,110
LUMPKIN,6/4/2020,55,55,1,111
LUMPKIN,6/5/2020,56,55,1,112
LUMPKIN,6/6/2020,57,55,1,113
LUMPKIN,6/7/2020,57,55,1,113
LUMPKIN,6/8/2020,59,55,1,115
LUMPKIN,6/9/2020,60,55,1,116
LUMPKIN,6/10/2020,61,55,1,117
LUMPKIN,6/11/2020,62,55,1,118
LUMPKIN,6/12/2020,62,56,1,119
LUMPKIN,6/13/2020,64,58,1,123
LUMPKIN,6/14/2020,64,58,1,123
LUMPKIN,6/15/2020,65,58,1,124
LUMPKIN,6/16/2020,67,60,1,128
LUMPKIN,6/17/2020,70,61,1,132
LUMPKIN,6/18/2020,71,62,1,134
LUMPKIN,6/19/2020,73,66,1,140
LUMPKIN,6/20/2020,75,69,1,145
LUMPKIN,6/21/2020,75,70,1,146
LUMPKIN,6/22/2020,77,71,1,149
LUMPKIN,6/23/2020,77,71,1,149
LUMPKIN,6/24/2020,81,73,1,155
LUMPKIN,6/25/2020,82,74,1,157
LUMPKIN,6/26/2020,84,74,1,159
LUMPKIN,6/27/2020,84,75,1,160
LUMPKIN,6/28/2020,86,76,1,163
LUMPKIN,6/29/2020,87,77,1,165
LUMPKIN,6/30/2020,88,80,2,170
LUMPKIN,7/1/2020,93,84,2,179
LUMPKIN,7/2/2020,98,84,3,185
LUMPKIN,7/3/2020,102,87,3,192
LUMPKIN,7/4/2020,105,91,3,199
LUMPKIN,7/5/2020,107,93,3,203
LUMPKIN,7/6/2020,113,105,3,221
LUMPKIN,7/7/2020,120,110,3,233
LUMPKIN,7/8/2020,132,119,4,255
LUMPKIN,7/9/2020,140,130,5,275
LUMPKIN,7/10/2020,152,141,5,298
LUMPKIN,7/11/2020,156,145,5,306
LUMPKIN,7/12/2020,162,148,5,315
LUMPKIN,7/13/2020,171,159,6,336
LUMPKIN,7/14/2020,177,165,6,348
LUMPKIN,7/15/2020,186,172,6,364
LUMPKIN,7/16/2020,192,182,6,380
LUMPKIN,7/17/2020,198,190,7,395
LUMPKIN,7/18/2020,204,196,7,407
LUMPKIN,7/19/2020,208,197,7,412
LUMPKIN,7/20/2020,214,206,7,427
LUMPKIN,7/21/2020,225,211,7,443
LUMPKIN,7/22/2020,231,219,7,457
LUMPKIN,7/23/2020,238,222,7,467
LUMPKIN,7/24/2020,245,227,7,479
LUMPKIN,7/25/2020,256,234,7,497
LUMPKIN,7/26/2020,264,238,7,509
LUMPKIN,7/27/2020,276,244,7,527
LUMPKIN,7/28/2020,281,250,7,538
LUMPKIN,7/29/2020,287,255,7,549
LUMPKIN,7/30/2020,295,262,7,564
LUMPKIN,7/31/2020,302,265,7,574
LUMPKIN,8/1/2020,312,276,7,595
LUMPKIN,8/2/2020,318,279,7,604
LUMPKIN,8/3/2020,322,282,7,611
LUMPKIN,8/4/2020,327,288,7,622
LUMPKIN,8/5/2020,333,296,7,636
LUMPKIN,8/6/2020,337,299,7,643
LUMPKIN,8/7/2020,342,301,7,650
MUSCOGEE,6/2/2020,542,406,3,951
MUSCOGEE,6/3/2020,556,415,3,974
MUSCOGEE,6/4/2020,580,426,3,1009
MUSCOGEE,6/5/2020,600,439,3,1042
MUSCOGEE,6/6/2020,616,448,3,1067
MUSCOGEE,6/7/2020,623,457,3,1083
MUSCOGEE,6/8/2020,644,472,3,1119
MUSCOGEE,6/9/2020,670,475,3,1148
MUSCOGEE,6/10/2020,691,484,3,1178
MUSCOGEE,6/11/2020,711,496,3,1210
MUSCOGEE,6/12/2020,732,509,3,1244
MUSCOGEE,6/13/2020,749,517,3,1269
MUSCOGEE,6/14/2020,764,522,4,1290
MUSCOGEE,6/15/2020,802,542,4,1348
MUSCOGEE,6/16/2020,835,566,4,1405
MUSCOGEE,6/17/2020,867,587,4,1458
MUSCOGEE,6/18/2020,908,606,4,1518
MUSCOGEE,6/19/2020,948,639,4,1591
MUSCOGEE,6/20/2020,985,661,4,1650
MUSCOGEE,6/21/2020,1013,685,4,1702
MUSCOGEE,6/22/2020,1056,734,4,1794
MUSCOGEE,6/23/2020,1097,781,5,1883
MUSCOGEE,6/24/2020,1149,836,6,1991
MUSCOGEE,6/25/2020,1210,887,6,2103
MUSCOGEE,6/26/2020,1272,936,8,2216
MUSCOGEE,6/27/2020,1301,978,9,2288
MUSCOGEE,6/28/2020,1342,1011,9,2362
MUSCOGEE,6/29/2020,1427,1077,10,2514
MUSCOGEE,6/30/2020,1513,1141,10,2664
MUSCOGEE,7/1/2020,1602,1202,10,2814
MUSCOGEE,7/2/2020,1668,1258,10,2936
MUSCOGEE,7/3/2020,1712,1298,10,3020
MUSCOGEE,7/4/2020,1759,1326,10,3095
MUSCOGEE,7/5/2020,1808,1371,10,3189
MUSCOGEE,7/6/2020,1893,1436,12,3341
MUSCOGEE,7/7/2020,1959,1493,12,3464
MUSCOGEE,7/8/2020,2010,1542,12,3564
MUSCOGEE,7/9/2020,2053,1567,13,3633
MUSCOGEE,7/10/2020,2113,1611,13,3737
MUSCOGEE,7/11/2020,2155,1645,13,3813
MUSCOGEE,7/12/2020,2173,1662,13,3848
MUSCOGEE,7/13/2020,2223,1705,13,3941
MUSCOGEE,7/14/2020,2256,1731,13,4000
MUSCOGEE,7/15/2020,2300,1755,13,4068
MUSCOGEE,7/16/2020,2335,1793,13,4141
MUSCOGEE,7/17/2020,2360,1823,13,4196
MUSCOGEE,7/18/2020,2383,1843,13,4239
MUSCOGEE,7/19/2020,2397,1859,13,4269
MUSCOGEE,7/20/2020,2439,1886,13,4338
MUSCOGEE,7/21/2020,2471,1917,13,4401
MUSCOGEE,7/22/2020,2502,1943,13,4458
MUSCOGEE,7/23/2020,2528,1966,14,4508
MUSCOGEE,7/24/2020,2557,1980,14,4551
MUSCOGEE,7/25/2020,2581,2001,14,4596
MUSCOGEE,7/26/2020,2604,2018,14,4636
MUSCOGEE,7/27/2020,2637,2046,14,4697
MUSCOGEE,7/28/2020,2666,2063,14,4743
MUSCOGEE,7/29/2020,2701,2082,14,4797
MUSCOGEE,7/30/2020,2724,2103,14,4841
MUSCOGEE,7/31/2020,2748,2116,14,4878
MUSCOGEE,8/1/2020,2768,2126,15,4909
MUSCOGEE,8/2/2020,2782,2140,15,4937
MUSCOGEE,8/3/2020,2805,2165,15,4985
MUSCOGEE,8/4/2020,2820,2184,15,5019
MUSCOGEE,8/5/2020,2839,2201,16,5056
MUSCOGEE,8/6/2020,2856,2218,17,5091
MUSCOGEE,8/7/2020,2878,2229,18,5125
MUSCOGEE,8/8/2020,2888,2241,18,5147
MUSCOGEE,8/9/2020,2898,2248,18,5164
MUSCOGEE,8/10/2020,2930,2268,18,5216
MUSCOGEE,8/11/2020,2958,2278,18,5254
MUSCOGEE,8/12/2020,2980,2290,18,5288
MUSCOGEE,8/13/2020,2997,2301,18,5316
MUSCOGEE,8/14/2020,3013,2302,18,5333
MUSCOGEE,8/15/2020,3023,2306,18,5347
MUSCOGEE,8/16/2020,3033,2311,18,5362
MUSCOGEE,8/17/2020,3051,2326,18,5395
MUSCOGEE,8/18/2020,3067,2339,18,5424
MUSCOGEE,8/19/2020,3085,2348,18,5451
MUSCOGEE,8/20/2020,3096,2356,19,5471
MUSCOGEE,8/21/2020,3115,2363,19,5497
MUSCOGEE,8/22/2020,3124,2367,19,5510
MUSCOGEE,8/23/2020,3131,2373,19,5523
MUSCOGEE,8/24/2020,3142,2385,19,5546
MUSCOGEE,8/25/2020,3153,2389,19,5561
MUSCOGEE,8/26/2020,3162,2397,20,5579
MUSCOGEE,8/27/2020,3172,2407,20,5599
MUSCOGEE,8/28/2020,3178,2420,21,5619
MUSCOGEE,8/29/2020,3185,2427,21,5633
MUSCOGEE,8/30/2020,3192,2433,21,5646
MUSCOGEE,8/31/2020,3202,2442,21,5665
MUSCOGEE,9/1/2020,3221,2452,24,5697
MUSCOGEE,9/2/2020,3233,2458,24,5715
MUSCOGEE,9/3/2020,3240,2464,25,5729
MUSCOGEE,9/4/2020,3247,2472,25,5744
MUSCOGEE,9/5/2020,3258,2481,25,5764
MUSCOGEE,9/6/2020,3264,2487,25,5776
MUSCOGEE,9/7/2020,3269,2492,25,5786
MUSCOGEE,9/8/2020,3284,2505,25,5814
MUSCOGEE,9/9/2020,3294,2514,25,5833
MUSCOGEE,9/10/2020,3300,2521,25,5846
MUSCOGEE,9/11/2020,3310,2531,25,5866
MUSCOGEE,9/12/2020,3316,2535,25,5876
MUSCOGEE,9/13/2020,3326,2540,25,5891
MUSCOGEE,9/14/2020,3338,2551,25,5914
MUSCOGEE,9/15/2020,3344,2554,25,5923
MUSCOGEE,9/16/2020,3353,2559,26,5938
MUSCOGEE,9/17/2020,3359,2568,26,5953
MUSCOGEE,9/18/2020,3370,2572,26,5968
MUSCOGEE,9/19/2020,3379,2580,26,5985
MUSCOGEE,9/20/2020,3392,2581,26,5999
MUSCOGEE,9/21/2020,3404,2589,26,6019
MUSCOGEE,9/22/2020,3413,2597,26,6036
MUSCOGEE,9/23/2020,3428,2605,26,6059
MUSCOGEE,9/24/2020,3432,2606,26,6064
MUSCOGEE,9/25/2020,3445,2611,27,6083
MUSCOGEE,9/26/2020,3451,2612,27,6090
MUSCOGEE,9/27/2020,3457,2614,27,6098
MUSCOGEE,9/28/2020,3464,2619,27,6110
MUSCOGEE,9/29/2020,3469,2622,27,6118
MUSCOGEE,9/30/2020,3481,2632,27,6140
MUSCOGEE,10/1/2020,3483,2637,27,6147
MUSCOGEE,10/2/2020,3488,2641,27,6156
MUSCOGEE,10/3/2020,3493,2644,27,6164
MUSCOGEE,10/4/2020,3499,2647,27,6173
MUSCOGEE,10/5/2020,3506,2649,27,6182
MUSCOGEE,10/6/2020,3512,2655,27,6194
MUSCOGEE,10/7/2020,3515,2660,27,6202
MUSCOGEE,10/8/2020,3523,2665,27,6215
MUSCOGEE,10/9/2020,3528,2672,27,6227
MUSCOGEE,10/10/2020,3531,2675,27,6233
MUSCOGEE,10/11/2020,3533,2680,27,6240
MUSCOGEE,10/12/2020,3534,2682,27,6243
MUSCOGEE,10/13/2020,3539,2685,27,6251
MUSCOGEE,10/14/2020,3545,2686,27,6258
MUSCOGEE,10/15/2020,3548,2687,27,6262
MUSCOGEE,10/16/2020,3552,2691,27,6270
MUSCOGEE,10/17/2020,3553,2695,27,6275
MUSCOGEE,10/18/2020,3554,2696,27,6277
MUSCOGEE,10/19/2020,3554,2696,27,6277
MUSCOGEE,10/20/2020,3554,2696,27,6277
OCONEE,1/1/2020,0,0,0,0
OCONEE,1/2/2020,0,0,0,0
OCONEE,1/3/2020,0,0,0,0
OCONEE,1/4/2020,0,0,0,0
OCONEE,1/5/2020,0,0,0,0
OCONEE,1/6/2020,0,0,0,0
OCONEE,1/7/2020,0,0,0,0
OCONEE,1/8/2020,0,0,0,0
OCONEE,1/9/2020,0,0,0,0
OCONEE,1/10/2020,0,0,0,0
OCONEE,1/11/2020,0,0,0,0
OCONEE,1/12/2020,0,0,0,0
OCONEE,1/13/2020,0,0,0,0
OCONEE,1/14/2020,0,0,0,0
OCONEE,1/15/2020,0,0,0,0
OCONEE,1/16/2020,0,0,0,0
OCONEE,1/17/2020,0,0,0,0
OCONEE,1/18/2020,0,0,0,0
OCONEE,1/19/2020,0,0,0,0
OCONEE,1/20/2020,0,0,0,0
OCONEE,1/21/2020,0,0,0,0
OCONEE,1/22/2020,0,0,0,0
OCONEE,1/23/2020,0,0,0,0
OCONEE,1/24/2020,0,0,0,0
OCONEE,1/25/2020,0,0,0,0
OCONEE,1/26/2020,0,0,0,0
OCONEE,1/27/2020,0,0,0,0
OCONEE,1/28/2020,0,0,0,0
OCONEE,1/29/2020,0,0,0,0
OCONEE,1/30/2020,0,0,0,0
OCONEE,1/31/2020,0,0,0,0
OCONEE,2/1/2020,0,0,0,0
OCONEE,2/2/2020,0,0,0,0
OCONEE,2/3/2020,0,0,0,0
OCONEE,2/4/2020,0,0,0,0
OCONEE,2/5/2020,0,0,0,0
OCONEE,2/6/2020,0,0,0,0
OCONEE,2/7/2020,0,0,0,0
OCONEE,2/8/2020,0,0,0,0
OCONEE,2/9/2020,0,0,0,0
OCONEE,2/10/2020,0,0,0,0
OCONEE,2/11/2020,0,0,0,0
OCONEE,2/12/2020,0,0,0,0
OCONEE,2/13/2020,0,0,0,0
OCONEE,2/14/2020,0,0,0,0
OCONEE,2/15/2020,0,0,0,0
OCONEE,2/16/2020,0,0,0,0
OCONEE,2/17/2020,0,0,0,0
OCONEE,2/18/2020,0,0,0,0
OCONEE,2/19/2020,0,0,0,0
OCONEE,2/20/2020,0,0,0,0
OCONEE,2/21/2020,0,0,0,0
OCONEE,2/22/2020,0,0,0,0
OCONEE,2/23/2020,0,0,0,0
OCONEE,2/24/2020,0,0,0,0
OCONEE,2/25/2020,0,0,0,0
OCONEE,2/26/2020,0,0,0,0
OCONEE,2/27/2020,0,0,0,0
OCONEE,2/28/2020,0,0,0,0
OCONEE,2/29/2020,0,1,0,1
OCONEE,3/1/2020,0,1,0,1
OCONEE,3/2/2020,0,1,0,1
OCONEE,3/3/2020,0,1,0,1
OCONEE,3/4/2020,0,1,0,1
OCONEE,3/5/2020,0,1,0,1
OCONEE,3/6/2020,0,1,0,1
OCONEE,3/7/2020,0,1,0,1
OCONEE,3/8/2020,0,1,0,1
OCONEE,3/9/2020,0,2,0,2
OCONEE,3/10/2020,1,3,0,4
OCONEE,3/11/2020,1,4,0,5
OCONEE,3/12/2020,2,5,0,7
OCONEE,3/13/2020,3,6,0,9
OCONEE,3/14/2020,4,6,0,10
OCONEE,3/15/2020,5,7,0,12
OCONEE,3/16/2020,5,8,0,13
OCONEE,3/17/2020,6,9,0,15
OCONEE,3/18/2020,6,10,0,16
OCONEE,3/19/2020,8,11,0,19
OCONEE,3/20/2020,9,13,0,22
OCONEE,3/21/2020,10,13,0,23
OCONEE,3/22/2020,11,13,0,24
OCONEE,3/23/2020,12,13,0,25
OCONEE,3/24/2020,13,14,0,27
OCONEE,3/25/2020,14,15,0,29
OCONEE,3/26/2020,14,16,0,30
OCONEE,3/27/2020,14,16,0,30
OCONEE,3/28/2020,14,16,0,30
OCONEE,3/29/2020,14,17,0,31
OCONEE,3/30/2020,14,18,0,32
OCONEE,3/31/2020,16,18,0,34
OCONEE,4/1/2020,16,18,0,34
OCONEE,4/2/2020,17,18,0,35
OCONEE,4/3/2020,18,18,0,36
OCONEE,4/4/2020,18,18,0,36
OCONEE,4/5/2020,18,18,0,36
OCONEE,4/6/2020,19,19,0,38
OCONEE,4/7/2020,20,19,0,39
OCONEE,4/8/2020,21,20,0,41
OCONEE,4/9/2020,23,20,0,43
OCONEE,4/10/2020,24,21,0,45
OCONEE,4/11/2020,24,21,0,45
OCONEE,4/12/2020,24,21,0,45
OCONEE,4/13/2020,24,21,0,45
OCONEE,4/14/2020,24,21,0,45
OCONEE,4/15/2020,24,22,0,46
OCONEE,4/16/2020,24,22,0,46
OCONEE,4/17/2020,27,22,0,49
OCONEE,4/18/2020,28,22,0,50
OCONEE,4/19/2020,29,22,0,51
OCONEE,4/20/2020,29,22,0,51
OCONEE,4/21/2020,30,25,0,55
OCONEE,4/22/2020,30,26,0,56
OCONEE,4/23/2020,30,28,0,58
OCONEE,4/24/2020,30,29,0,59
OCONEE,4/25/2020,31,29,0,60
OCONEE,4/26/2020,32,29,0,61
OCONEE,4/27/2020,33,31,0,64
OCONEE,4/28/2020,34,31,0,65
OCONEE,4/29/2020,38,32,0,70
OCONEE,4/30/2020,40,32,0,72
OCONEE,5/1/2020,43,33,0,76
OCONEE,5/2/2020,43,34,0,77
OCONEE,5/3/2020,43,34,0,77
OCONEE,5/4/2020,46,35,0,81
OCONEE,5/5/2020,46,36,0,82
OCONEE,5/6/2020,46,36,0,82
OCONEE,5/7/2020,47,36,0,83
OCONEE,5/8/2020,47,37,0,84
OCONEE,5/9/2020,48,38,0,86
OCONEE,5/10/2020,48,38,0,86
OCONEE,5/11/2020,50,41,0,91
OCONEE,5/12/2020,50,42,0,92
OCONEE,5/13/2020,51,42,0,93
OCONEE,5/14/2020,58,45,0,103
OCONEE,5/15/2020,59,46,0,105
OCONEE,5/16/2020,61,47,0,108
OCONEE,5/17/2020,61,48,0,109
OCONEE,5/18/2020,61,48,0,109
OCONEE,5/19/2020,62,49,0,111
OCONEE,5/20/2020,62,49,0,111
OCONEE,5/21/2020,63,50,0,113
OCONEE,5/22/2020,63,50,0,113
OCONEE,5/23/2020,64,50,0,114
OCONEE,5/24/2020,65,51,0,116
OCONEE,5/25/2020,65,51,0,116
OCONEE,5/26/2020,69,52,0,121
OCONEE,5/27/2020,70,52,0,122
OCONEE,5/28/2020,71,52,0,123
OCONEE,5/29/2020,71,52,0,123
OCONEE,5/30/2020,71,52,0,123
OCONEE,5/31/2020,71,52,0,123
OCONEE,6/1/2020,72,52,0,124
OCONEE,6/2/2020,72,53,0,125
OCONEE,6/3/2020,72,54,0,126
OCONEE,6/4/2020,72,54,0,126
OCONEE,6/5/2020,73,54,0,127
OCONEE,6/6/2020,73,55,0,128
OCONEE,6/7/2020,73,55,0,128
OCONEE,6/8/2020,73,55,0,128
OCONEE,6/9/2020,73,57,0,130
OCONEE,6/10/2020,73,58,0,131
OCONEE,6/11/2020,73,59,0,132
OCONEE,6/12/2020,74,59,0,133
OCONEE,6/13/2020,74,59,0,133
OCONEE,6/14/2020,77,59,0,136
OCONEE,6/15/2020,77,60,0,137
OCONEE,6/16/2020,79,62,0,141
OCONEE,6/17/2020,79,64,0,143
OCONEE,6/18/2020,79,64,0,143
OCONEE,6/19/2020,79,65,0,144
OCONEE,6/20/2020,81,66,0,147
OCONEE,6/21/2020,81,68,0,149
OCONEE,6/22/2020,82,72,0,154
OCONEE,6/23/2020,85,77,0,162
OCONEE,6/24/2020,87,79,0,166
OCONEE,6/25/2020,89,84,0,173
OCONEE,6/26/2020,91,89,0,180
OCONEE,6/27/2020,93,92,0,185
OCONEE,6/28/2020,98,95,0,193
OCONEE,6/29/2020,107,99,0,206
OCONEE,6/30/2020,109,104,0,213
OCONEE,7/1/2020,113,106,0,219
OCONEE,7/2/2020,118,114,1,233
OCONEE,7/3/2020,119,120,1,240
OCONEE,7/4/2020,121,120,1,242
OCONEE,7/5/2020,124,123,1,248
OCONEE,7/6/2020,130,131,1,262
OCONEE,7/7/2020,133,136,1,270
OCONEE,7/8/2020,136,144,1,281
OCONEE,7/9/2020,143,152,1,296
OCONEE,7/10/2020,146,158,1,305
OCONEE,7/11/2020,151,160,1,312
OCONEE,7/12/2020,154,164,1,319
OCONEE,7/13/2020,164,168,1,333
OCONEE,7/14/2020,168,171,1,340
OCONEE,7/15/2020,172,179,1,352
OCONEE,7/16/2020,175,181,1,357
OCONEE,7/17/2020,178,184,1,363
OCONEE,7/18/2020,182,187,1,370
OCONEE,7/19/2020,183,188,1,372
OCONEE,7/20/2020,192,191,1,384
OCONEE,7/21/2020,194,195,1,390
OCONEE,7/22/2020,199,198,1,398
OCONEE,7/23/2020,201,207,1,409
OCONEE,7/24/2020,204,209,1,414
OCONEE,7/25/2020,207,212,1,420
OCONEE,7/26/2020,208,212,1,421
OCONEE,7/27/2020,212,212,1,425
OCONEE,7/28/2020,214,214,1,429
OCONEE,7/29/2020,219,219,1,439
OCONEE,7/30/2020,220,219,1,440
OCONEE,7/31/2020,223,223,2,448
OCONEE,8/1/2020,226,224,2,452
OCONEE,8/2/2020,227,224,2,453
OCONEE,8/3/2020,230,229,2,461
OCONEE,8/4/2020,232,230,2,464
OCONEE,8/5/2020,233,232,2,467
OCONEE,8/6/2020,235,233,2,470
OCONEE,8/7/2020,238,235,2,475
OCONEE,8/8/2020,239,236,2,477
OCONEE,8/9/2020,239,237,2,478
OCONEE,8/10/2020,241,237,2,480
OCONEE,8/11/2020,246,238,2,486
OCONEE,8/12/2020,248,240,2,490
OCONEE,8/13/2020,250,242,2,494
OCONEE,8/14/2020,251,245,2,498
OCONEE,8/15/2020,255,246,2,503
OCONEE,8/16/2020,256,248,2,506
OCONEE,8/17/2020,258,251,2,511
OCONEE,8/18/2020,263,258,2,523
OCONEE,8/19/2020,267,262,2,531
OCONEE,8/20/2020,271,265,2,538
OCONEE,8/21/2020,274,271,2,547
OCONEE,8/22/2020,278,274,2,554
OCONEE,8/23/2020,280,277,2,559
OCONEE,8/24/2020,281,281,2,564
OCONEE,8/25/2020,283,282,2,567
OCONEE,8/26/2020,286,285,2,573
OCONEE,8/27/2020,291,288,2,581
OCONEE,8/28/2020,294,289,2,585
OCONEE,8/29/2020,297,290,2,589
OCONEE,8/30/2020,298,291,2,591
OCONEE,8/31/2020,306,299,3,608
PEACH,6/11/2020,69,26,0,95
PEACH,6/12/2020,70,26,0,96
PEACH,6/13/2020,70,26,0,96
PEACH,6/14/2020,70,26,0,96
PEACH,6/15/2020,71,26,0,97
PEACH,6/16/2020,71,27,0,98
PEACH,6/17/2020,71,27,0,98
PEACH,6/18/2020,71,27,0,98
PEACH,6/19/2020,71,27,0,98
PEACH,6/20/2020,71,27,0,98
PEACH,6/21/2020,72,27,0,99
PEACH,6/22/2020,72,31,0,103
PEACH,6/23/2020,72,33,0,105
PEACH,6/24/2020,73,33,0,106
PEACH,6/25/2020,76,33,0,109
PEACH,6/26/2020,77,34,0,111
PEACH,6/27/2020,79,36,0,115
PEACH,6/28/2020,80,38,0,118
PEACH,6/29/2020,85,40,0,125
PEACH,6/30/2020,89,41,0,130
PEACH,7/1/2020,92,46,0,138
PEACH,7/2/2020,94,48,0,142
PEACH,7/3/2020,97,50,0,147
PEACH,7/4/2020,103,52,0,155
ROCKDALE,3/21/2020,24,23,0,47
OCONEE,9/1/2020,314,304,3,621
PAULDING,2/26/2020,1,0,0,1
PEACH,7/5/2020,107,53,0,160
PEACH,7/6/2020,111,61,0,172
PEACH,7/7/2020,122,65,0,187
PEACH,7/8/2020,124,73,0,197
PEACH,7/9/2020,128,80,0,208
PEACH,7/10/2020,133,82,0,215
PEACH,7/11/2020,139,84,0,223
PEACH,7/12/2020,143,86,0,229
PEACH,7/13/2020,156,91,0,247
PEACH,7/14/2020,165,96,0,261
PEACH,7/15/2020,168,97,0,265
PEACH,7/16/2020,170,101,0,271
PEACH,7/17/2020,174,102,0,276
PEACH,7/18/2020,183,103,0,286
PEACH,7/19/2020,186,105,0,291
PEACH,7/20/2020,192,110,0,302
PEACH,7/21/2020,195,114,0,309
PEACH,7/22/2020,202,122,0,324
PEACH,7/23/2020,204,123,0,327
PEACH,7/24/2020,213,127,0,340
PEACH,7/25/2020,220,130,0,350
PEACH,7/26/2020,224,130,0,354
PEACH,7/27/2020,233,138,0,371
PEACH,7/28/2020,238,141,0,379
PEACH,7/29/2020,243,146,0,389
PEACH,7/30/2020,247,149,0,396
PEACH,7/31/2020,254,151,0,405
PEACH,8/1/2020,260,156,0,416
PEACH,8/2/2020,264,156,0,420
PEACH,8/3/2020,272,162,0,434
PEACH,8/4/2020,276,167,0,443
PEACH,8/5/2020,291,172,1,464
PEACH,8/6/2020,295,176,1,472
PEACH,8/7/2020,297,181,1,479
PEACH,8/8/2020,300,182,1,483
PEACH,8/9/2020,305,183,1,489
PEACH,8/10/2020,312,188,1,501
PEACH,8/11/2020,318,193,1,512
PEACH,8/12/2020,326,195,1,522
PEACH,8/13/2020,330,199,2,531
PEACH,8/14/2020,335,199,2,536
PEACH,8/15/2020,339,201,2,542
PEACH,8/16/2020,342,203,2,547
PEACH,8/17/2020,342,209,2,553
PEACH,8/18/2020,344,211,2,557
PEACH,8/19/2020,345,213,2,560
PEACH,8/20/2020,347,216,2,565
PEACH,8/21/2020,353,220,2,575
PEACH,8/22/2020,354,224,2,580
PEACH,8/23/2020,356,226,2,584
PEACH,8/24/2020,356,228,2,586
PEACH,8/25/2020,360,229,2,591
PEACH,8/26/2020,366,233,2,601
PEACH,8/27/2020,368,237,2,607
PEACH,8/28/2020,371,237,2,610
PEACH,8/29/2020,372,237,2,611
PEACH,8/30/2020,376,238,2,616
PEACH,8/31/2020,380,241,2,623
PEACH,9/1/2020,382,243,2,627
PEACH,9/2/2020,382,245,2,629
PEACH,9/3/2020,382,246,2,630
PEACH,9/4/2020,383,252,2,637
PEACH,9/5/2020,384,255,2,641
PEACH,9/6/2020,385,256,2,643
PEACH,9/7/2020,387,257,2,646
PEACH,9/8/2020,390,257,2,649
PEACH,9/9/2020,395,260,2,657
PEACH,9/10/2020,396,261,2,659
PEACH,9/11/2020,398,261,2,661
PEACH,9/12/2020,402,262,2,666
PEACH,9/13/2020,405,265,2,672
PEACH,9/14/2020,408,266,2,676
PEACH,9/15/2020,408,267,2,677
PEACH,9/16/2020,408,269,2,679
PEACH,9/17/2020,409,271,2,682
PEACH,9/18/2020,412,271,2,685
PEACH,9/19/2020,412,271,2,685
PEACH,9/20/2020,412,272,2,686
PEACH,9/21/2020,413,272,2,687
PEACH,9/22/2020,414,272,2,688
PEACH,9/23/2020,416,272,2,690
PEACH,9/24/2020,416,274,2,692
PEACH,9/25/2020,417,274,2,693
PEACH,9/26/2020,418,275,2,695
PEACH,9/27/2020,418,275,2,695
PEACH,9/28/2020,418,278,2,698
PEACH,9/29/2020,420,279,2,701
PEACH,9/30/2020,422,280,2,704
PEACH,10/1/2020,423,281,2,706
PEACH,10/2/2020,425,281,2,708
PEACH,10/3/2020,425,281,2,708
PEACH,10/4/2020,425,282,2,709
PEACH,10/5/2020,425,284,2,711
PEACH,10/6/2020,430,285,2,717
PEACH,10/7/2020,431,285,2,718
PEACH,10/8/2020,433,287,2,722
PEACH,10/9/2020,436,290,2,728
PEACH,10/10/2020,436,290,2,728
PEACH,10/11/2020,438,290,2,730
PEACH,10/12/2020,439,292,2,733
PEACH,10/13/2020,440,292,2,734
PEACH,10/14/2020,442,292,2,736
PEACH,10/15/2020,443,293,2,738
PEACH,10/16/2020,443,293,2,738
PEACH,10/17/2020,444,294,2,740
PEACH,10/18/2020,444,294,2,740
PEACH,10/19/2020,444,294,2,740
PEACH,10/20/2020,444,294,2,740
RABUN,1/1/2020,0,0,0,0
RABUN,1/2/2020,0,0,0,0
RABUN,1/3/2020,0,0,0,0
RABUN,1/4/2020,0,0,0,0
RABUN,1/5/2020,0,0,0,0
RABUN,1/6/2020,0,0,0,0
RABUN,1/7/2020,0,0,0,0
RABUN,1/8/2020,0,0,0,0
RABUN,1/9/2020,0,0,0,0
RABUN,1/10/2020,0,0,0,0
RABUN,9/25/2020,190,182,6,378
RABUN,1/11/2020,0,0,0,0
RABUN,1/12/2020,0,0,0,0
RABUN,1/13/2020,0,0,0,0
RABUN,1/14/2020,0,0,0,0
RABUN,1/15/2020,0,0,0,0
RABUN,1/16/2020,0,0,0,0
RABUN,1/17/2020,0,0,0,0
RABUN,1/18/2020,0,0,0,0
RABUN,1/19/2020,0,0,0,0
RABUN,1/20/2020,0,0,0,0
RABUN,1/21/2020,0,0,0,0
RABUN,1/22/2020,0,0,0,0
RABUN,1/23/2020,0,0,0,0
RABUN,1/24/2020,0,0,0,0
RABUN,1/25/2020,0,0,0,0
RABUN,1/26/2020,0,0,0,0
RABUN,1/27/2020,0,0,0,0
RABUN,1/28/2020,0,0,0,0
RABUN,1/29/2020,0,0,0,0
RABUN,1/30/2020,0,0,0,0
RABUN,1/31/2020,0,0,0,0
RABUN,2/1/2020,0,1,0,1
RABUN,2/2/2020,0,1,0,1
RABUN,2/3/2020,0,1,0,1
RABUN,2/4/2020,0,1,0,1
RABUN,2/5/2020,0,1,0,1
RABUN,2/6/2020,0,1,0,1
RABUN,2/7/2020,0,1,0,1
RABUN,2/8/2020,0,1,0,1
RABUN,2/9/2020,0,1,0,1
RABUN,2/10/2020,0,1,0,1
RABUN,2/11/2020,0,1,0,1
RABUN,2/12/2020,0,1,0,1
RABUN,2/13/2020,0,1,0,1
RABUN,2/14/2020,0,1,0,1
RABUN,2/15/2020,0,1,0,1
RABUN,2/16/2020,0,1,0,1
RABUN,2/17/2020,0,1,0,1
RABUN,2/18/2020,0,1,0,1
RABUN,2/19/2020,0,1,0,1
RABUN,2/20/2020,0,1,0,1
RABUN,2/21/2020,0,1,0,1
RABUN,2/22/2020,0,1,0,1
RABUN,2/23/2020,0,1,0,1
RABUN,2/24/2020,0,1,0,1
RABUN,2/25/2020,0,1,0,1
RABUN,2/26/2020,0,1,0,1
RABUN,2/27/2020,0,1,0,1
RABUN,2/28/2020,0,1,0,1
RABUN,2/29/2020,0,1,0,1
RABUN,3/1/2020,0,1,0,1
RABUN,3/2/2020,0,1,0,1
RABUN,3/3/2020,0,1,0,1
RABUN,3/4/2020,0,1,0,1
RABUN,3/5/2020,0,1,0,1
RABUN,3/6/2020,0,1,0,1
RABUN,3/7/2020,0,1,0,1
RABUN,3/8/2020,0,1,0,1
RABUN,3/9/2020,0,1,0,1
RABUN,3/10/2020,0,1,0,1
RABUN,3/11/2020,0,1,0,1
RABUN,3/12/2020,0,1,0,1
RABUN,3/13/2020,1,1,0,2
RABUN,3/14/2020,1,1,0,2
RABUN,3/15/2020,1,1,0,2
RABUN,3/16/2020,1,1,0,2
RABUN,3/17/2020,1,1,0,2
RABUN,3/18/2020,1,1,0,2
RABUN,3/19/2020,1,1,0,2
RABUN,3/20/2020,1,1,0,2
RABUN,3/21/2020,2,1,0,3
RABUN,3/22/2020,3,1,0,4
RABUN,3/23/2020,3,2,0,5
RABUN,3/24/2020,3,2,0,5
RABUN,3/25/2020,3,2,0,5
RABUN,3/26/2020,4,2,0,6
RABUN,3/27/2020,4,2,0,6
RABUN,3/28/2020,4,2,0,6
RABUN,3/29/2020,5,2,0,7
RABUN,3/30/2020,5,2,0,7
RABUN,3/31/2020,5,2,0,7
RABUN,4/1/2020,5,2,0,7
RABUN,4/2/2020,5,2,0,7
RABUN,4/3/2020,5,2,0,7
RABUN,4/4/2020,5,2,0,7
RABUN,4/5/2020,5,2,0,7
RABUN,4/6/2020,5,3,0,8
RABUN,4/7/2020,5,3,0,8
RABUN,4/8/2020,5,3,0,8
RABUN,4/9/2020,6,3,0,9
RABUN,4/10/2020,6,3,0,9
RABUN,4/11/2020,6,3,0,9
RABUN,4/12/2020,6,3,0,9
RABUN,4/13/2020,6,3,0,9
RABUN,4/14/2020,7,3,0,10
RABUN,4/15/2020,7,3,0,10
RABUN,4/16/2020,9,3,0,12
RABUN,4/17/2020,9,4,0,13
RABUN,4/18/2020,9,4,0,13
RABUN,4/19/2020,10,4,0,14
RABUN,4/20/2020,10,4,0,14
RABUN,4/21/2020,10,4,0,14
RABUN,4/22/2020,10,4,0,14
RABUN,4/23/2020,10,4,0,14
RABUN,4/24/2020,10,4,0,14
RABUN,4/25/2020,10,4,0,14
RABUN,4/26/2020,11,4,0,15
RABUN,4/27/2020,11,4,0,15
RABUN,4/28/2020,11,5,0,16
RABUN,4/29/2020,12,5,0,17
RABUN,4/30/2020,12,5,0,17
RABUN,5/1/2020,12,5,0,17
RABUN,5/2/2020,12,5,0,17
RABUN,5/3/2020,12,5,0,17
RABUN,5/4/2020,13,5,0,18
RABUN,5/5/2020,13,5,0,18
RABUN,5/6/2020,13,5,0,18
RABUN,5/7/2020,13,5,0,18
RABUN,5/8/2020,13,5,0,18
RABUN,5/9/2020,13,5,0,18
RABUN,5/10/2020,13,5,0,18
RABUN,5/11/2020,13,5,0,18
RABUN,5/12/2020,13,5,0,18
RABUN,5/13/2020,14,5,0,19
RABUN,5/14/2020,14,5,0,19
RABUN,5/15/2020,15,5,0,20
RABUN,5/16/2020,15,5,0,20
RABUN,5/17/2020,15,5,0,20
RABUN,5/18/2020,15,5,0,20
RABUN,5/19/2020,15,5,0,20
RABUN,5/20/2020,15,5,0,20
RABUN,5/21/2020,15,5,0,20
RABUN,5/22/2020,15,5,0,20
RABUN,5/23/2020,15,5,0,20
RABUN,5/24/2020,15,5,0,20
RABUN,5/25/2020,16,6,0,22
RABUN,5/26/2020,17,7,0,24
RABUN,5/27/2020,17,10,0,27
RABUN,5/28/2020,17,10,0,27
RABUN,5/29/2020,17,10,0,27
RABUN,5/30/2020,18,10,0,28
RABUN,5/31/2020,20,10,0,30
RABUN,6/1/2020,22,10,0,32
RABUN,6/2/2020,22,11,0,33
RABUN,6/3/2020,22,11,0,33
RABUN,6/4/2020,23,11,0,34
RABUN,6/5/2020,24,11,0,35
RABUN,6/6/2020,24,11,0,35
RABUN,6/7/2020,24,11,0,35
RABUN,6/8/2020,25,11,0,36
RABUN,6/9/2020,25,12,0,37
RABUN,6/10/2020,25,12,0,37
RABUN,6/11/2020,26,13,0,39
RABUN,6/12/2020,26,14,0,40
RABUN,6/13/2020,27,14,0,41
RABUN,6/14/2020,27,14,0,41
RABUN,6/15/2020,27,14,0,41
RABUN,6/16/2020,28,15,0,43
RABUN,6/17/2020,29,16,0,45
RABUN,6/18/2020,31,18,0,49
RABUN,6/19/2020,31,18,0,49
RABUN,6/20/2020,34,18,0,52
RABUN,6/21/2020,34,18,0,52
RABUN,6/22/2020,35,21,0,56
RABUN,6/23/2020,36,22,0,58
RABUN,6/24/2020,36,22,0,58
RABUN,6/25/2020,36,23,0,59
RABUN,6/26/2020,36,23,0,59
RABUN,6/27/2020,36,25,0,61
RABUN,6/28/2020,37,25,0,62
RABUN,6/29/2020,38,29,0,67
RABUN,6/30/2020,40,30,0,70
RABUN,7/1/2020,42,33,0,75
RABUN,7/2/2020,44,34,0,78
RABUN,7/3/2020,48,37,0,85
RABUN,7/4/2020,50,39,0,89
RABUN,7/5/2020,51,43,0,94
RABUN,7/6/2020,53,48,0,101
RABUN,7/7/2020,58,53,0,111
RABUN,7/8/2020,66,56,0,122
RABUN,7/9/2020,71,62,0,133
RABUN,7/10/2020,74,71,0,145
RABUN,7/11/2020,81,83,0,164
RABUN,7/12/2020,87,83,0,170
RABUN,7/13/2020,92,94,3,189
RABUN,7/14/2020,97,96,3,196
RABUN,7/15/2020,102,98,3,203
RABUN,7/16/2020,105,102,3,210
RABUN,7/17/2020,108,107,4,219
RABUN,7/18/2020,112,108,4,224
RABUN,7/19/2020,115,110,4,229
RABUN,7/20/2020,116,115,4,235
RABUN,7/21/2020,118,118,4,240
RABUN,7/22/2020,118,120,4,242
RABUN,7/23/2020,120,122,4,246
RABUN,7/24/2020,121,124,4,249
RABUN,7/25/2020,124,125,4,253
RABUN,7/26/2020,126,127,5,258
RABUN,7/27/2020,129,129,5,263
RABUN,7/28/2020,130,131,5,266
RABUN,7/29/2020,130,135,5,270
RABUN,7/30/2020,133,137,5,275
RABUN,7/31/2020,134,137,5,276
RABUN,8/1/2020,137,137,5,279
RABUN,8/2/2020,138,139,5,282
RABUN,8/3/2020,139,139,5,283
RABUN,8/4/2020,142,140,5,287
RABUN,8/5/2020,145,142,5,292
RABUN,8/6/2020,145,142,5,292
RABUN,8/7/2020,145,142,5,292
RABUN,8/8/2020,145,142,5,292
RABUN,8/9/2020,145,142,5,292
RABUN,8/10/2020,145,143,5,293
RABUN,8/11/2020,146,144,5,295
RABUN,8/12/2020,146,144,5,295
RABUN,8/13/2020,147,144,5,296
RABUN,8/14/2020,148,145,6,299
RABUN,8/15/2020,149,147,6,302
RABUN,8/16/2020,150,147,6,303
RABUN,8/17/2020,152,148,6,306
RABUN,8/18/2020,154,150,6,310
RABUN,8/19/2020,156,150,6,312
RABUN,8/20/2020,158,153,6,317
RABUN,8/21/2020,159,155,6,320
RABUN,8/22/2020,159,155,6,320
RABUN,8/23/2020,159,156,6,321
RABUN,8/24/2020,160,157,6,323
RABUN,8/25/2020,161,159,6,326
RABUN,8/26/2020,162,161,6,329
RABUN,8/27/2020,163,161,6,330
RABUN,8/28/2020,163,162,6,331
RABUN,8/29/2020,164,163,6,333
RABUN,8/30/2020,165,164,6,335
RABUN,8/31/2020,169,165,6,340
RABUN,9/1/2020,170,168,6,344
RABUN,9/2/2020,170,168,6,344
RABUN,9/3/2020,170,169,6,345
RABUN,9/4/2020,174,169,6,349
RABUN,9/5/2020,174,170,6,350
RABUN,9/6/2020,174,170,6,350
RABUN,9/7/2020,174,170,6,350
RABUN,9/8/2020,176,171,6,353
RABUN,9/9/2020,176,171,6,353
RABUN,9/10/2020,176,171,6,353
RABUN,9/11/2020,176,171,6,353
RABUN,9/12/2020,177,171,6,354
RABUN,9/13/2020,178,172,6,356
RABUN,9/14/2020,178,172,6,356
RABUN,9/15/2020,178,172,6,356
RABUN,9/16/2020,178,174,6,358
RABUN,9/17/2020,179,176,6,361
RABUN,9/18/2020,180,177,6,363
RABUN,9/19/2020,181,178,6,365
RABUN,9/20/2020,182,178,6,366
RABUN,9/21/2020,183,178,6,367
RABUN,9/22/2020,185,180,6,371
RABUN,9/23/2020,187,180,6,373
RABUN,9/24/2020,188,180,6,374
ROCKDALE,3/22/2020,26,24,0,50
ROCKDALE,3/23/2020,29,24,0,53
ROCKDALE,3/24/2020,32,25,0,57
ROCKDALE,3/25/2020,35,28,1,64
ROCKDALE,3/26/2020,37,32,1,70
OCONEE,9/2/2020,324,310,3,637
ROCKDALE,3/27/2020,37,33,1,71
ROCKDALE,3/28/2020,40,36,1,77
OCONEE,9/3/2020,328,315,3,646
ROCKDALE,3/29/2020,42,38,1,81
PAULDING,2/27/2020,1,1,0,2
OCONEE,9/4/2020,334,319,3,656
ROCKDALE,3/30/2020,46,38,1,85
PAULDING,2/28/2020,1,1,0,2
PAULDING,2/29/2020,1,1,0,2
PAULDING,3/1/2020,1,1,0,2
PAULDING,3/2/2020,1,1,0,2
PAULDING,3/3/2020,1,1,0,2
PAULDING,3/4/2020,1,2,0,3
PAULDING,3/5/2020,3,3,0,6
PAULDING,3/6/2020,4,3,0,7
PAULDING,3/7/2020,5,3,0,8
PAULDING,3/8/2020,6,3,0,9
PAULDING,3/9/2020,6,3,0,9
PAULDING,3/10/2020,7,5,0,12
PAULDING,3/11/2020,9,6,0,15
PAULDING,3/12/2020,10,7,0,17
PAULDING,3/13/2020,10,8,0,18
PAULDING,3/14/2020,10,10,0,20
PAULDING,3/15/2020,11,14,0,25
PAULDING,3/16/2020,15,18,0,33
PAULDING,3/17/2020,18,20,0,38
RABUN,9/26/2020,192,182,6,380
PAULDING,3/18/2020,19,22,0,41
PAULDING,3/19/2020,19,26,0,45
PAULDING,3/20/2020,21,27,0,48
PAULDING,3/21/2020,23,29,0,52
PAULDING,3/22/2020,24,32,0,56
PAULDING,3/23/2020,28,34,0,62
PAULDING,3/24/2020,30,37,0,67
PAULDING,3/25/2020,33,39,0,72
PAULDING,3/26/2020,33,41,0,74
PAULDING,3/27/2020,34,42,0,76
PAULDING,3/28/2020,36,43,0,79
PAULDING,3/29/2020,37,45,0,82
PAULDING,3/30/2020,40,48,0,88
PAULDING,3/31/2020,45,50,0,95
PAULDING,4/1/2020,48,51,0,99
PAULDING,4/2/2020,50,52,0,102
PAULDING,4/3/2020,51,53,0,104
PAULDING,4/4/2020,52,53,0,105
PAULDING,4/5/2020,52,56,0,108
PAULDING,4/6/2020,57,56,1,114
PAULDING,4/7/2020,59,57,1,117
PAULDING,4/8/2020,62,59,1,122
PAULDING,4/9/2020,69,60,1,130
PAULDING,4/10/2020,73,61,1,135
PAULDING,4/11/2020,73,62,1,136
PAULDING,4/12/2020,77,66,1,144
PAULDING,4/13/2020,81,69,1,151
PAULDING,4/14/2020,85,71,1,157
PAULDING,4/15/2020,87,75,1,163
PAULDING,4/16/2020,88,76,2,166
PAULDING,4/17/2020,93,77,2,172
PAULDING,4/18/2020,94,77,2,173
PAULDING,4/19/2020,98,77,2,177
PAULDING,4/20/2020,102,79,2,183
PAULDING,4/21/2020,105,79,2,186
PAULDING,4/22/2020,111,83,2,196
PAULDING,4/23/2020,112,84,2,198
PAULDING,4/24/2020,113,86,4,203
PAULDING,4/25/2020,114,90,4,208
PAULDING,4/26/2020,115,91,4,210
PAULDING,4/27/2020,118,95,4,217
PAULDING,4/28/2020,119,96,4,219
PAULDING,4/29/2020,120,97,4,221
PAULDING,4/30/2020,124,99,4,227
PAULDING,5/1/2020,125,99,6,230
PAULDING,5/2/2020,127,102,6,235
PAULDING,5/3/2020,129,102,6,237
PAULDING,5/4/2020,130,102,6,238
PAULDING,5/5/2020,133,103,6,242
PAULDING,5/6/2020,136,103,6,245
PAULDING,5/7/2020,136,103,6,245
PAULDING,5/8/2020,137,103,6,246
PAULDING,5/9/2020,139,103,6,248
PAULDING,5/10/2020,141,105,6,252
PAULDING,5/11/2020,144,109,7,260
PAULDING,5/12/2020,145,111,7,263
PAULDING,5/13/2020,147,115,7,269
PAULDING,5/14/2020,149,117,7,273
PAULDING,5/15/2020,151,117,7,275
PAULDING,5/16/2020,159,119,8,286
PAULDING,5/17/2020,161,119,9,289
PAULDING,5/18/2020,162,121,9,292
PAULDING,5/19/2020,164,124,9,297
PAULDING,5/20/2020,168,126,9,303
PAULDING,5/21/2020,172,127,9,308
PAULDING,5/22/2020,176,129,9,314
PAULDING,5/23/2020,177,132,9,318
PAULDING,5/24/2020,177,134,10,321
PAULDING,5/25/2020,179,135,10,324
PAULDING,5/26/2020,186,138,10,334
PAULDING,5/27/2020,189,140,10,339
PAULDING,5/28/2020,195,144,10,349
PAULDING,5/29/2020,196,145,11,352
PAULDING,5/30/2020,200,148,11,359
PAULDING,5/31/2020,201,149,11,361
PAULDING,6/1/2020,206,151,11,368
PAULDING,6/2/2020,209,152,11,372
PAULDING,6/3/2020,214,153,11,378
PAULDING,6/4/2020,220,155,11,386
PAULDING,6/5/2020,229,156,11,396
PAULDING,6/6/2020,230,160,11,401
PAULDING,6/7/2020,231,162,11,404
PAULDING,6/8/2020,235,169,11,415
PAULDING,6/9/2020,238,175,11,424
PAULDING,6/10/2020,240,177,12,429
PAULDING,6/11/2020,247,183,12,442
PAULDING,6/12/2020,252,185,13,450
PAULDING,6/13/2020,253,188,13,454
PAULDING,6/14/2020,255,190,13,458
PAULDING,6/15/2020,263,197,14,474
PAULDING,6/16/2020,269,206,14,489
PAULDING,6/17/2020,277,211,16,504
PAULDING,6/18/2020,281,218,16,515
PAULDING,6/19/2020,286,227,16,529
PAULDING,6/20/2020,289,234,17,540
PAULDING,6/21/2020,294,240,19,553
PAULDING,6/22/2020,302,255,19,576
PAULDING,6/23/2020,312,266,20,598
PAULDING,6/24/2020,318,273,25,616
PAULDING,6/25/2020,333,290,25,648
PAULDING,6/26/2020,351,306,26,683
PAULDING,6/27/2020,360,317,28,705
PAULDING,6/28/2020,368,326,30,724
PAULDING,6/29/2020,388,339,35,762
PAULDING,6/30/2020,405,352,36,793
PAULDING,7/1/2020,421,375,37,833
PAULDING,7/2/2020,440,391,43,874
PAULDING,7/3/2020,446,399,46,891
PAULDING,7/4/2020,458,402,46,906
PAULDING,7/5/2020,468,411,48,927
PAULDING,7/6/2020,490,429,51,970
PAULDING,7/7/2020,508,444,54,1006
PAULDING,7/8/2020,531,458,60,1049
PAULDING,7/9/2020,549,473,63,1085
PAULDING,7/10/2020,563,490,63,1116
PAULDING,7/11/2020,576,498,65,1139
PAULDING,7/12/2020,587,501,65,1153
PAULDING,7/13/2020,605,525,73,1203
PAULDING,7/14/2020,626,544,79,1249
PAULDING,7/15/2020,642,554,87,1283
PAULDING,7/16/2020,663,569,97,1329
PAULDING,7/17/2020,680,587,98,1365
PAULDING,7/18/2020,688,598,103,1389
PAULDING,7/19/2020,701,608,107,1416
PAULDING,7/20/2020,713,620,110,1443
PAULDING,7/21/2020,729,632,111,1472
PAULDING,7/22/2020,742,650,111,1503
PAULDING,7/23/2020,760,660,113,1533
PAULDING,7/24/2020,773,673,114,1560
PAULDING,7/25/2020,783,690,114,1587
PAULDING,7/26/2020,793,696,114,1603
PAULDING,7/27/2020,807,718,114,1639
PAULDING,7/28/2020,825,735,114,1674
PAULDING,7/29/2020,848,760,114,1722
PAULDING,7/30/2020,863,771,114,1748
PAULDING,7/31/2020,877,777,114,1768
PAULDING,8/1/2020,895,786,114,1795
PAULDING,8/2/2020,902,790,114,1806
PAULDING,8/3/2020,919,813,114,1846
PAULDING,8/4/2020,940,837,114,1891
PAULDING,8/5/2020,958,853,115,1926
PAULDING,8/6/2020,975,867,115,1957
PAULDING,8/7/2020,993,882,115,1990
PAULDING,8/8/2020,1009,888,115,2012
PAULDING,8/9/2020,1018,896,115,2029
PAULDING,8/10/2020,1034,921,115,2070
PAULDING,8/11/2020,1046,940,123,2109
PAULDING,8/12/2020,1061,952,123,2136
PAULDING,8/13/2020,1071,961,123,2155
PAULDING,8/14/2020,1087,968,123,2178
PAULDING,8/15/2020,1095,973,123,2191
PAULDING,8/16/2020,1106,979,123,2208
PAULDING,8/17/2020,1114,996,123,2233
PAULDING,8/18/2020,1120,1000,123,2243
PAULDING,8/19/2020,1132,1008,123,2263
PAULDING,8/20/2020,1147,1018,124,2289
PAULDING,8/21/2020,1160,1038,125,2323
PAULDING,8/22/2020,1170,1045,125,2340
PAULDING,8/23/2020,1174,1054,125,2353
PAULDING,8/24/2020,1183,1063,125,2371
PAULDING,8/25/2020,1199,1077,125,2401
PAULDING,8/26/2020,1213,1087,125,2425
PAULDING,8/27/2020,1222,1094,125,2441
PAULDING,8/28/2020,1240,1108,125,2473
PAULDING,8/29/2020,1248,1112,125,2485
PAULDING,8/30/2020,1253,1119,125,2497
PAULDING,8/31/2020,1267,1134,125,2526
PAULDING,9/1/2020,1279,1144,125,2548
PAULDING,9/2/2020,1291,1152,125,2568
PAULDING,9/3/2020,1298,1158,125,2581
PAULDING,9/4/2020,1305,1166,125,2596
PAULDING,9/5/2020,1312,1168,125,2605
PAULDING,9/6/2020,1316,1174,125,2615
PAULDING,9/7/2020,1321,1184,125,2630
PAULDING,9/8/2020,1334,1197,125,2656
PAULDING,9/9/2020,1344,1207,125,2676
PAULDING,9/10/2020,1357,1214,125,2696
PAULDING,9/11/2020,1367,1220,125,2712
PAULDING,9/12/2020,1373,1223,125,2721
PAULDING,9/13/2020,1378,1227,125,2730
PAULDING,9/14/2020,1384,1235,125,2744
PAULDING,9/15/2020,1387,1242,125,2754
PAULDING,9/16/2020,1396,1248,125,2769
PAULDING,9/17/2020,1400,1251,125,2776
PAULDING,9/18/2020,1408,1258,125,2791
PAULDING,9/19/2020,1410,1261,125,2796
PAULDING,9/20/2020,1415,1262,125,2802
PAULDING,9/21/2020,1422,1268,125,2815
PAULDING,9/22/2020,1428,1273,125,2826
PAULDING,9/23/2020,1432,1275,125,2832
PAULDING,9/24/2020,1440,1281,125,2846
PAULDING,9/25/2020,1449,1283,125,2857
PAULDING,9/26/2020,1452,1284,125,2861
PAULDING,9/27/2020,1460,1286,125,2871
PAULDING,9/28/2020,1465,1288,125,2878
PAULDING,9/29/2020,1472,1291,125,2888
PAULDING,9/30/2020,1480,1292,125,2897
PAULDING,10/1/2020,1491,1298,125,2914
PAULDING,10/2/2020,1497,1302,125,2924
PAULDING,10/3/2020,1501,1307,125,2933
PAULDING,10/4/2020,1505,1311,125,2941
PAULDING,10/5/2020,1509,1315,125,2949
PAULDING,10/6/2020,1517,1323,125,2965
PAULDING,10/7/2020,1521,1328,125,2974
PAULDING,10/8/2020,1522,1331,125,2978
PAULDING,10/9/2020,1526,1335,125,2986
PAULDING,10/10/2020,1532,1337,125,2994
PAULDING,10/11/2020,1534,1338,125,2997
PAULDING,10/12/2020,1541,1345,125,3011
PAULDING,10/13/2020,1547,1349,125,3021
PAULDING,10/14/2020,1548,1350,125,3023
PAULDING,10/15/2020,1549,1352,125,3026
PAULDING,10/16/2020,1552,1355,125,3032
PAULDING,10/17/2020,1554,1356,125,3035
PAULDING,10/18/2020,1554,1356,125,3035
PAULDING,10/19/2020,1555,1357,125,3037
PAULDING,10/20/2020,1555,1357,125,3037
PEACH,1/1/2020,0,0,0,0
PEACH,1/2/2020,0,0,0,0
PEACH,1/3/2020,0,0,0,0
PEACH,1/4/2020,0,0,0,0
PEACH,1/5/2020,0,0,0,0
PEACH,1/6/2020,0,0,0,0
PEACH,1/7/2020,0,0,0,0
PEACH,1/8/2020,0,0,0,0
PEACH,1/9/2020,0,0,0,0
PEACH,1/10/2020,0,0,0,0
PEACH,1/11/2020,0,0,0,0
PEACH,1/12/2020,0,0,0,0
PEACH,1/13/2020,0,0,0,0
PEACH,1/14/2020,0,0,0,0
PEACH,1/15/2020,0,0,0,0
PEACH,1/16/2020,0,0,0,0
PEACH,1/17/2020,0,0,0,0
PEACH,1/18/2020,0,0,0,0
PEACH,1/19/2020,0,0,0,0
PEACH,1/20/2020,0,0,0,0
PEACH,1/21/2020,0,0,0,0
PEACH,1/22/2020,0,0,0,0
PEACH,1/23/2020,0,0,0,0
PEACH,1/24/2020,0,0,0,0
PEACH,1/25/2020,0,0,0,0
PEACH,1/26/2020,0,0,0,0
PEACH,1/27/2020,0,0,0,0
PEACH,1/28/2020,0,0,0,0
PEACH,1/29/2020,0,0,0,0
PEACH,1/30/2020,0,0,0,0
PEACH,1/31/2020,0,0,0,0
PEACH,2/1/2020,0,0,0,0
PEACH,2/2/2020,0,0,0,0
PEACH,2/3/2020,0,0,0,0
PEACH,2/4/2020,0,0,0,0
PEACH,2/5/2020,0,0,0,0
PEACH,2/6/2020,0,0,0,0
PEACH,2/7/2020,0,0,0,0
PEACH,2/8/2020,0,0,0,0
PEACH,2/9/2020,0,0,0,0
PEACH,2/10/2020,0,0,0,0
PEACH,2/11/2020,0,0,0,0
PEACH,2/12/2020,0,0,0,0
PEACH,2/13/2020,0,0,0,0
PEACH,2/14/2020,0,0,0,0
PEACH,2/15/2020,0,0,0,0
PEACH,2/16/2020,0,0,0,0
PEACH,2/17/2020,0,0,0,0
PEACH,2/18/2020,0,0,0,0
PEACH,2/19/2020,0,0,0,0
PEACH,2/20/2020,0,0,0,0
PEACH,2/21/2020,0,0,0,0
PEACH,2/22/2020,0,0,0,0
PEACH,2/23/2020,0,0,0,0
PEACH,2/24/2020,0,0,0,0
PEACH,2/25/2020,0,0,0,0
PEACH,2/26/2020,0,0,0,0
PEACH,2/27/2020,0,0,0,0
PEACH,2/28/2020,0,0,0,0
PEACH,2/29/2020,0,0,0,0
PEACH,3/1/2020,0,0,0,0
PEACH,3/2/2020,0,0,0,0
PEACH,3/3/2020,0,0,0,0
PEACH,3/4/2020,0,0,0,0
PEACH,3/5/2020,1,0,0,1
PEACH,3/6/2020,1,0,0,1
PEACH,3/7/2020,1,0,0,1
PEACH,3/8/2020,1,0,0,1
PEACH,3/9/2020,2,0,0,2
PEACH,3/10/2020,2,0,0,2
PEACH,3/11/2020,2,0,0,2
PEACH,3/12/2020,2,0,0,2
PEACH,3/13/2020,3,0,0,3
PEACH,3/14/2020,3,0,0,3
PEACH,3/15/2020,3,0,0,3
PEACH,3/16/2020,4,0,0,4
PEACH,3/17/2020,5,0,0,5
PEACH,3/18/2020,6,0,0,6
PEACH,3/19/2020,7,0,0,7
PEACH,3/20/2020,7,0,0,7
PEACH,3/21/2020,7,0,0,7
PEACH,3/22/2020,8,1,0,9
PEACH,3/23/2020,8,1,0,9
PEACH,3/24/2020,8,1,0,9
PEACH,3/25/2020,9,1,0,10
PEACH,3/26/2020,9,1,0,10
PEACH,3/27/2020,9,1,0,10
PEACH,3/28/2020,11,1,0,12
PEACH,3/29/2020,11,2,0,13
PEACH,3/30/2020,13,3,0,16
PEACH,3/31/2020,14,5,0,19
PEACH,4/1/2020,15,6,0,21
PEACH,4/2/2020,15,6,0,21
PEACH,4/3/2020,15,7,0,22
PEACH,4/4/2020,15,7,0,22
PEACH,4/5/2020,15,8,0,23
PEACH,4/6/2020,16,9,0,25
PEACH,4/7/2020,19,9,0,28
PEACH,4/8/2020,20,9,0,29
PEACH,4/9/2020,22,10,0,32
PEACH,4/10/2020,22,11,0,33
PEACH,4/11/2020,24,13,0,37
PEACH,4/12/2020,24,13,0,37
PEACH,4/13/2020,25,13,0,38
PEACH,4/14/2020,25,13,0,38
PEACH,4/15/2020,26,13,0,39
PEACH,4/16/2020,26,13,0,39
PEACH,4/17/2020,26,13,0,39
PEACH,4/18/2020,27,13,0,40
PEACH,4/19/2020,28,13,0,41
PEACH,4/20/2020,31,13,0,44
PEACH,4/21/2020,31,15,0,46
PEACH,4/22/2020,33,16,0,49
PEACH,4/23/2020,36,17,0,53
PEACH,4/24/2020,36,18,0,54
PEACH,4/25/2020,38,18,0,56
PEACH,4/26/2020,38,18,0,56
PEACH,4/27/2020,40,18,0,58
PEACH,4/28/2020,42,19,0,61
PEACH,4/29/2020,43,20,0,63
PEACH,4/30/2020,43,20,0,63
PEACH,5/1/2020,43,20,0,63
PEACH,5/2/2020,43,20,0,63
PEACH,5/3/2020,43,20,0,63
PEACH,5/4/2020,44,20,0,64
PEACH,5/5/2020,45,20,0,65
PEACH,5/6/2020,45,20,0,65
PEACH,5/7/2020,47,21,0,68
PEACH,5/8/2020,47,21,0,68
PEACH,5/9/2020,47,21,0,68
PEACH,5/10/2020,48,21,0,69
PEACH,5/11/2020,48,21,0,69
PEACH,5/12/2020,48,21,0,69
PEACH,5/13/2020,48,22,0,70
PEACH,5/14/2020,49,22,0,71
PEACH,5/15/2020,49,22,0,71
PEACH,5/16/2020,49,22,0,71
PEACH,5/17/2020,49,22,0,71
PEACH,5/18/2020,49,22,0,71
PEACH,5/19/2020,49,22,0,71
PEACH,5/20/2020,50,22,0,72
PEACH,5/21/2020,50,23,0,73
PEACH,5/22/2020,50,23,0,73
PEACH,5/23/2020,51,23,0,74
PEACH,5/24/2020,51,23,0,74
PEACH,5/25/2020,53,23,0,76
PEACH,5/26/2020,53,23,0,76
PEACH,5/27/2020,54,23,0,77
PEACH,5/28/2020,55,23,0,78
PEACH,5/29/2020,56,23,0,79
PEACH,5/30/2020,56,23,0,79
PEACH,5/31/2020,56,23,0,79
PEACH,6/1/2020,56,23,0,79
PEACH,6/2/2020,56,23,0,79
PEACH,6/3/2020,57,24,0,81
PEACH,6/4/2020,57,24,0,81
PEACH,6/5/2020,57,24,0,81
PEACH,6/6/2020,58,24,0,82
PEACH,6/7/2020,61,25,0,86
PEACH,6/8/2020,66,25,0,91
PEACH,6/9/2020,67,25,0,92
PEACH,6/10/2020,68,25,0,93
ROCKDALE,3/31/2020,46,39,1,86
ROCKDALE,4/1/2020,49,41,1,91
ROCKDALE,4/2/2020,52,43,1,96
ROCKDALE,4/3/2020,53,44,1,98
ROCKDALE,4/4/2020,55,45,1,101
ROCKDALE,4/5/2020,55,45,2,102
ROCKDALE,4/6/2020,56,48,2,106
ROCKDALE,4/7/2020,56,48,2,106
ROCKDALE,4/8/2020,58,50,2,110
ROCKDALE,4/9/2020,62,53,2,117
ROCKDALE,4/10/2020,67,54,2,123
ROCKDALE,4/11/2020,68,54,2,124
ROCKDALE,4/12/2020,69,54,2,125
ROCKDALE,4/13/2020,71,55,2,128
ROCKDALE,4/14/2020,72,55,2,129
ROCKDALE,4/15/2020,76,59,2,137
ROCKDALE,4/16/2020,82,62,2,146
ROCKDALE,4/17/2020,84,64,2,150
ROCKDALE,4/18/2020,84,64,2,150
ROCKDALE,4/19/2020,85,64,2,151
OCONEE,9/5/2020,341,320,3,664
ROCKDALE,4/20/2020,89,67,2,158
ROCKDALE,4/21/2020,95,69,2,166
ROCKDALE,4/22/2020,96,70,2,168
ROCKDALE,4/23/2020,97,73,2,172
ROCKDALE,4/24/2020,101,75,2,178
ROCKDALE,4/25/2020,103,76,2,181
ROCKDALE,4/26/2020,103,76,2,181
ROCKDALE,4/27/2020,104,82,2,188
ROCKDALE,4/28/2020,107,85,2,194
ROCKDALE,4/29/2020,108,85,2,195
ROCKDALE,4/30/2020,109,85,2,196
ROCKDALE,5/1/2020,117,92,2,211
ROCKDALE,5/2/2020,120,93,2,215
ROCKDALE,5/3/2020,120,95,2,217
ROCKDALE,5/4/2020,123,97,3,223
ROCKDALE,5/5/2020,127,99,3,229
ROCKDALE,5/6/2020,131,100,3,234
ROCKDALE,5/7/2020,135,101,4,240
ROCKDALE,5/8/2020,137,104,4,245
ROCKDALE,5/9/2020,137,105,4,246
ROCKDALE,5/10/2020,137,106,4,247
ROCKDALE,5/11/2020,137,106,4,247
ROCKDALE,5/12/2020,138,106,4,248
ROCKDALE,5/13/2020,142,106,4,252
ROCKDALE,5/14/2020,143,106,4,253
ROCKDALE,5/15/2020,148,106,4,258
ROCKDALE,5/16/2020,148,106,4,258
ROCKDALE,5/17/2020,150,109,4,263
ROCKDALE,5/18/2020,151,110,4,265
ROCKDALE,5/19/2020,152,113,4,269
ROCKDALE,5/20/2020,155,115,4,274
ROCKDALE,5/21/2020,156,116,4,276
ROCKDALE,5/22/2020,162,116,4,282
ROCKDALE,5/23/2020,163,117,5,285
ROCKDALE,5/24/2020,164,117,5,286
ROCKDALE,5/25/2020,164,118,5,287
ROCKDALE,5/26/2020,164,121,5,290
ROCKDALE,5/27/2020,168,122,5,295
ROCKDALE,5/28/2020,170,124,5,299
ROCKDALE,5/29/2020,174,129,5,308
ROCKDALE,5/30/2020,175,130,5,310
ROCKDALE,5/31/2020,176,133,5,314
ROCKDALE,6/1/2020,178,133,5,316
ROCKDALE,6/2/2020,182,135,5,322
ROCKDALE,6/3/2020,184,135,5,324
ROCKDALE,6/4/2020,189,138,5,332
ROCKDALE,6/5/2020,192,138,5,335
ROCKDALE,6/6/2020,195,138,5,338
ROCKDALE,6/7/2020,195,139,5,339
ROCKDALE,6/8/2020,199,144,5,348
ROCKDALE,6/9/2020,204,144,5,353
ROCKDALE,6/10/2020,205,146,5,356
ROCKDALE,6/11/2020,207,147,6,360
ROCKDALE,6/12/2020,215,148,6,369
ROCKDALE,6/13/2020,217,150,6,373
ROCKDALE,6/14/2020,219,154,7,380
ROCKDALE,6/15/2020,227,157,7,391
ROCKDALE,6/16/2020,231,159,7,397
ROCKDALE,6/17/2020,238,164,7,409
ROCKDALE,6/18/2020,243,165,8,416
ROCKDALE,6/19/2020,248,169,8,425
ROCKDALE,6/20/2020,253,174,8,435
ROCKDALE,6/21/2020,256,178,8,442
ROCKDALE,6/22/2020,266,179,9,454
ROCKDALE,6/23/2020,274,186,9,469
ROCKDALE,6/24/2020,283,191,9,483
ROCKDALE,6/25/2020,294,206,10,510
ROCKDALE,6/26/2020,304,215,10,529
ROCKDALE,6/27/2020,308,224,11,543
ROCKDALE,6/28/2020,315,236,13,564
ROCKDALE,6/29/2020,331,246,13,590
ROCKDALE,6/30/2020,344,260,13,617
ROCKDALE,7/1/2020,361,266,13,640
ROCKDALE,7/2/2020,379,284,14,677
ROCKDALE,7/3/2020,387,294,14,695
ROCKDALE,7/4/2020,392,300,14,706
ROCKDALE,7/5/2020,398,310,14,722
ROCKDALE,7/6/2020,418,325,17,760
ROCKDALE,7/7/2020,431,342,19,792
ROCKDALE,7/8/2020,449,355,21,825
ROCKDALE,7/9/2020,471,377,25,873
ROCKDALE,7/10/2020,493,391,26,910
ROCKDALE,7/11/2020,502,394,26,922
ROCKDALE,7/12/2020,513,400,26,939
ROCKDALE,7/13/2020,527,412,26,965
ROCKDALE,7/14/2020,543,426,26,995
ROCKDALE,7/15/2020,559,436,33,1028
ROCKDALE,7/16/2020,574,447,33,1054
ROCKDALE,7/17/2020,582,460,33,1075
ROCKDALE,7/18/2020,592,464,33,1089
ROCKDALE,7/19/2020,601,468,33,1102
ROCKDALE,7/20/2020,611,481,33,1125
ROCKDALE,7/21/2020,628,489,33,1150
ROCKDALE,7/22/2020,640,496,34,1170
ROCKDALE,7/23/2020,650,505,35,1190
ROCKDALE,7/24/2020,674,517,36,1227
ROCKDALE,7/25/2020,684,523,36,1243
ROCKDALE,7/26/2020,685,529,36,1250
ROCKDALE,7/27/2020,703,539,36,1278
ROCKDALE,7/28/2020,712,549,36,1297
ROCKDALE,7/29/2020,729,559,36,1324
ROCKDALE,7/30/2020,743,573,36,1352
ROCKDALE,7/31/2020,750,586,39,1375
ROCKDALE,8/1/2020,758,592,39,1389
ROCKDALE,8/2/2020,763,593,39,1395
ROCKDALE,8/3/2020,777,607,39,1423
ROCKDALE,8/4/2020,789,613,39,1441
ROCKDALE,8/5/2020,799,617,39,1455
ROCKDALE,8/6/2020,812,626,39,1477
ROCKDALE,8/7/2020,820,637,40,1497
ROCKDALE,8/8/2020,823,640,41,1504
ROCKDALE,8/9/2020,829,649,41,1519
ROCKDALE,8/10/2020,841,661,41,1543
ROCKDALE,8/11/2020,855,669,41,1565
ROCKDALE,8/12/2020,863,676,41,1580
ROCKDALE,8/13/2020,870,679,41,1590
ROCKDALE,8/14/2020,879,687,42,1608
ROCKDALE,8/15/2020,883,692,42,1617
ROCKDALE,8/16/2020,889,695,42,1626
ROCKDALE,8/17/2020,896,703,42,1641
ROCKDALE,8/18/2020,901,707,42,1650
ROCKDALE,8/19/2020,909,711,42,1662
ROCKDALE,8/20/2020,916,715,42,1673
ROCKDALE,8/21/2020,922,721,42,1685
ROCKDALE,8/22/2020,924,723,42,1689
ROCKDALE,8/23/2020,930,727,42,1699
ROCKDALE,8/24/2020,938,734,42,1714
ROCKDALE,8/25/2020,939,741,42,1722
ROCKDALE,8/26/2020,948,748,42,1738
ROCKDALE,8/27/2020,950,754,43,1747
ROCKDALE,8/28/2020,951,758,43,1752
ROCKDALE,8/29/2020,956,760,43,1759
ROCKDALE,8/30/2020,956,762,43,1761
ROCKDALE,8/31/2020,961,766,43,1770
ROCKDALE,9/1/2020,963,769,43,1775
ROCKDALE,9/2/2020,965,773,43,1781
ROCKDALE,9/3/2020,969,775,43,1787
ROCKDALE,9/4/2020,974,776,43,1793
ROCKDALE,9/5/2020,977,777,43,1797
ROCKDALE,9/6/2020,982,777,43,1802
ROCKDALE,9/7/2020,988,782,43,1813
ROCKDALE,9/8/2020,991,782,43,1816
ROCKDALE,9/9/2020,995,786,44,1825
ROCKDALE,9/10/2020,999,789,44,1832
ROCKDALE,9/11/2020,999,790,44,1833
ROCKDALE,9/12/2020,1003,795,44,1842
ROCKDALE,9/13/2020,1005,798,44,1847
ROCKDALE,9/14/2020,1008,799,44,1851
ROCKDALE,9/15/2020,1011,802,44,1857
ROCKDALE,9/16/2020,1013,803,44,1860
ROCKDALE,9/17/2020,1015,804,44,1863
ROCKDALE,9/18/2020,1016,807,44,1867
ROCKDALE,9/19/2020,1017,810,44,1871
ROCKDALE,9/20/2020,1018,811,44,1873
ROCKDALE,9/21/2020,1020,812,44,1876
ROCKDALE,9/22/2020,1022,813,44,1879
ROCKDALE,9/23/2020,1027,815,45,1887
ROCKDALE,9/24/2020,1031,819,45,1895
ROCKDALE,9/25/2020,1035,823,45,1903
ROCKDALE,9/26/2020,1035,824,45,1904
ROCKDALE,9/27/2020,1036,825,45,1906
ROCKDALE,9/28/2020,1037,829,45,1911
ROCKDALE,9/29/2020,1039,831,45,1915
ROCKDALE,9/30/2020,1043,833,45,1921
ROCKDALE,10/1/2020,1047,834,45,1926
ROCKDALE,10/2/2020,1049,837,45,1931
ROCKDALE,10/3/2020,1053,842,45,1940
ROCKDALE,10/4/2020,1057,843,45,1945
ROCKDALE,10/5/2020,1065,849,45,1959
ROCKDALE,10/6/2020,1071,852,45,1968
ROCKDALE,10/7/2020,1074,853,45,1972
ROCKDALE,10/8/2020,1078,859,45,1982
ROCKDALE,10/9/2020,1086,861,45,1992
ROCKDALE,10/10/2020,1088,861,45,1994
ROCKDALE,10/11/2020,1090,871,46,2007
ROCKDALE,10/12/2020,1091,874,46,2011
ROCKDALE,10/13/2020,1091,876,47,2014
ROCKDALE,10/14/2020,1095,878,47,2020
ROCKDALE,10/15/2020,1097,883,47,2027
ROCKDALE,10/16/2020,1100,884,48,2032
ROCKDALE,10/17/2020,1102,885,48,2035
ROCKDALE,10/18/2020,1102,886,48,2036
ROCKDALE,10/19/2020,1102,886,48,2036
ROCKDALE,10/20/2020,1102,886,48,2036
SCHLEY,1/1/2020,0,0,0,0
SCHLEY,1/2/2020,0,0,0,0
SCHLEY,1/3/2020,0,0,0,0
SCHLEY,1/4/2020,0,0,0,0
SCHLEY,1/5/2020,0,0,0,0
SCHLEY,1/6/2020,0,0,0,0
SCHLEY,1/7/2020,0,0,0,0
SCHLEY,1/8/2020,0,0,0,0
SCHLEY,1/9/2020,0,0,0,0
SCHLEY,1/10/2020,0,0,0,0
SCHLEY,1/11/2020,0,0,0,0
SCHLEY,1/12/2020,0,0,0,0
SCHLEY,1/13/2020,0,0,0,0
SCHLEY,1/14/2020,0,0,0,0
SCHLEY,1/15/2020,0,0,0,0
SCHLEY,1/16/2020,0,0,0,0
SCHLEY,1/17/2020,0,0,0,0
SCHLEY,1/18/2020,0,0,0,0
SCHLEY,1/19/2020,0,0,0,0
SCHLEY,1/20/2020,0,0,0,0
SCHLEY,1/21/2020,0,0,0,0
SCHLEY,1/22/2020,0,0,0,0
SCHLEY,1/23/2020,0,0,0,0
SCHLEY,1/24/2020,0,0,0,0
SCHLEY,1/25/2020,0,0,0,0
SCHLEY,1/26/2020,0,0,0,0
SCHLEY,1/27/2020,0,0,0,0
SCHLEY,1/28/2020,0,0,0,0
SCHLEY,1/29/2020,0,0,0,0
SCHLEY,1/30/2020,0,0,0,0
SCHLEY,1/31/2020,0,0,0,0
SCHLEY,2/1/2020,0,0,0,0
SCHLEY,2/2/2020,0,0,0,0
SCHLEY,2/3/2020,0,0,0,0
SCHLEY,2/4/2020,0,0,0,0
SCHLEY,2/5/2020,0,0,0,0
SCHLEY,2/6/2020,0,0,0,0
SCHLEY,2/7/2020,0,0,0,0
SCHLEY,2/8/2020,0,0,0,0
SCHLEY,2/9/2020,0,0,0,0
SCHLEY,2/10/2020,0,0,0,0
SCHLEY,2/11/2020,0,0,0,0
SCHLEY,2/12/2020,0,0,0,0
SCHLEY,2/13/2020,0,0,0,0
SCHLEY,2/14/2020,0,0,0,0
SCHLEY,2/15/2020,0,0,0,0
SCHLEY,2/16/2020,0,0,0,0
SCHLEY,2/17/2020,0,0,0,0
SCHLEY,2/18/2020,0,0,0,0
SCHLEY,2/19/2020,0,0,0,0
SCHLEY,2/20/2020,0,0,0,0
SCHLEY,2/21/2020,0,0,0,0
SCHLEY,2/22/2020,0,0,0,0
SCHLEY,2/23/2020,0,0,0,0
SCHLEY,2/24/2020,0,0,0,0
SCHLEY,2/25/2020,0,0,0,0
SCHLEY,2/26/2020,0,0,0,0
SCHLEY,2/27/2020,0,0,0,0
SCHLEY,2/28/2020,0,0,0,0
SCHLEY,2/29/2020,0,0,0,0
SCHLEY,3/1/2020,0,0,0,0
SCHLEY,3/2/2020,0,0,0,0
SCHLEY,3/3/2020,0,0,0,0
SCHLEY,3/4/2020,0,0,0,0
SCHLEY,3/5/2020,0,0,0,0
SCHLEY,3/6/2020,0,0,0,0
SCHLEY,3/7/2020,0,0,0,0
SCHLEY,3/8/2020,0,0,0,0
SCHLEY,3/9/2020,0,0,0,0
SCHLEY,3/10/2020,0,0,0,0
SCHLEY,3/11/2020,0,0,0,0
SCHLEY,3/12/2020,0,0,0,0
SCHLEY,3/13/2020,0,0,0,0
SCHLEY,3/14/2020,0,0,0,0
SCHLEY,3/15/2020,0,0,0,0
SCHLEY,3/16/2020,1,0,0,1
SCHLEY,3/17/2020,1,0,0,1
SCHLEY,3/18/2020,3,0,0,3
SCHLEY,3/19/2020,4,0,0,4
SCHLEY,3/20/2020,4,0,0,4
SCHLEY,3/21/2020,4,0,0,4
SCHLEY,3/22/2020,5,0,0,5
SCHLEY,3/23/2020,5,0,0,5
SCHLEY,3/24/2020,5,0,0,5
SCHLEY,3/25/2020,5,0,0,5
SCHLEY,3/26/2020,6,0,0,6
SCHLEY,3/27/2020,6,0,0,6
SCHLEY,3/28/2020,7,0,0,7
SCHLEY,3/29/2020,8,1,0,9
SCHLEY,3/30/2020,8,1,0,9
SCHLEY,3/31/2020,8,1,0,9
SCHLEY,4/1/2020,9,1,0,10
SCHLEY,4/2/2020,9,2,0,11
SCHLEY,4/3/2020,9,2,0,11
SCHLEY,4/4/2020,9,2,0,11
SCHLEY,4/5/2020,10,2,0,12
SCHLEY,4/6/2020,10,2,0,12
SCHLEY,4/7/2020,10,4,0,14
SCHLEY,4/8/2020,10,4,0,14
SCHLEY,4/9/2020,10,4,0,14
SCHLEY,4/10/2020,11,4,0,15
SCHLEY,4/11/2020,12,4,0,16
SCHLEY,4/12/2020,12,4,0,16
SCHLEY,4/13/2020,12,4,0,16
SCHLEY,4/14/2020,12,4,0,16
SCHLEY,4/15/2020,12,4,0,16
SCHLEY,4/16/2020,12,4,0,16
SCHLEY,4/17/2020,12,4,0,16
SCHLEY,4/18/2020,12,4,0,16
SCHLEY,4/19/2020,12,4,0,16
SCHLEY,4/20/2020,12,4,0,16
SCHLEY,4/21/2020,12,4,0,16
SCHLEY,4/22/2020,12,4,0,16
SCHLEY,4/23/2020,12,4,0,16
SCHLEY,4/24/2020,12,4,0,16
SCHLEY,4/25/2020,12,4,0,16
SCHLEY,4/26/2020,12,4,0,16
SCHLEY,4/27/2020,12,4,0,16
SCHLEY,4/28/2020,12,4,0,16
SCHLEY,4/29/2020,12,4,0,16
SCHLEY,4/30/2020,12,4,0,16
SCHLEY,5/1/2020,12,4,0,16
SCHLEY,5/2/2020,12,4,0,16
SCHLEY,5/3/2020,12,4,0,16
SCHLEY,5/4/2020,12,4,0,16
SCHLEY,5/5/2020,12,4,0,16
SCHLEY,5/6/2020,12,4,0,16
SCHLEY,5/7/2020,12,4,0,16
SCHLEY,5/8/2020,12,4,0,16
SCHLEY,5/9/2020,12,4,0,16
SCHLEY,5/10/2020,13,4,0,17
SCHLEY,5/11/2020,13,4,0,17
SCHLEY,5/12/2020,13,4,0,17
SCHLEY,5/13/2020,13,4,0,17
SCHLEY,5/14/2020,13,4,0,17
SCHLEY,5/15/2020,13,4,0,17
SCHLEY,5/16/2020,13,4,0,17
SCHLEY,5/17/2020,13,4,0,17
SCHLEY,5/18/2020,13,4,0,17
SCHLEY,5/19/2020,13,4,0,17
SCHLEY,5/20/2020,13,4,0,17
SCHLEY,5/21/2020,13,4,0,17
SCHLEY,5/22/2020,13,4,0,17
SCHLEY,5/23/2020,13,4,0,17
SCHLEY,5/24/2020,13,4,0,17
SCHLEY,5/25/2020,13,4,0,17
SCHLEY,5/26/2020,13,4,0,17
SCHLEY,5/27/2020,13,4,0,17
SCHLEY,5/28/2020,14,4,0,18
SCHLEY,5/29/2020,14,4,0,18
SCHLEY,5/30/2020,14,4,0,18
SCHLEY,5/31/2020,14,4,0,18
SCHLEY,6/1/2020,15,4,0,19
SCHLEY,6/2/2020,15,4,0,19
SCHLEY,6/3/2020,15,4,0,19
SCHLEY,6/4/2020,16,4,0,20
SCHLEY,6/5/2020,16,4,0,20
SCHLEY,6/6/2020,16,4,0,20
SCHLEY,6/7/2020,16,4,0,20
SCHLEY,6/8/2020,16,4,0,20
SCHLEY,6/9/2020,16,4,0,20
SCHLEY,6/10/2020,16,4,0,20
SCHLEY,6/11/2020,17,5,0,22
SCHLEY,6/12/2020,17,5,0,22
SCHLEY,6/13/2020,18,5,0,23
SCHLEY,6/14/2020,18,5,0,23
SCHLEY,6/15/2020,19,5,0,24
SCHLEY,6/16/2020,19,5,0,24
SCHLEY,6/17/2020,19,5,0,24
SCHLEY,6/18/2020,19,5,0,24
SCHLEY,6/19/2020,19,5,0,24
SCHLEY,6/20/2020,19,6,0,25
SCHLEY,6/21/2020,19,6,0,25
SCHLEY,6/22/2020,20,6,0,26
SCHLEY,6/23/2020,20,6,0,26
SCHLEY,6/24/2020,20,7,0,27
SCHLEY,6/25/2020,20,7,0,27
SCHLEY,6/26/2020,20,7,0,27
SCHLEY,6/27/2020,20,7,0,27
SCHLEY,6/28/2020,20,7,0,27
SCHLEY,6/29/2020,21,7,0,28
SCHLEY,6/30/2020,21,7,0,28
SCHLEY,7/1/2020,21,8,0,29
SCHLEY,7/2/2020,21,9,0,30
SCHLEY,7/3/2020,21,9,0,30
SCHLEY,7/4/2020,21,10,0,31
RABUN,9/27/2020,192,182,6,380
OCONEE,9/6/2020,342,321,3,666
OCONEE,9/7/2020,347,323,3,673
OCONEE,9/8/2020,352,325,3,680
OCONEE,9/9/2020,354,330,3,687
OCONEE,9/10/2020,359,335,3,697
OCONEE,9/11/2020,363,337,3,703
OCONEE,9/12/2020,364,339,3,706
OCONEE,9/13/2020,366,341,3,710
OCONEE,9/14/2020,369,344,3,716
OCONEE,9/15/2020,371,345,3,719
OCONEE,9/16/2020,372,349,3,724
OCONEE,9/17/2020,375,352,3,730
OCONEE,9/18/2020,376,354,3,733
OCONEE,9/19/2020,377,354,3,734
OCONEE,9/20/2020,379,355,3,737
OCONEE,9/21/2020,384,357,3,744
OCONEE,9/22/2020,387,359,3,749
OCONEE,9/23/2020,392,359,3,754
OCONEE,9/24/2020,394,363,3,760
OCONEE,9/25/2020,398,363,3,764
OCONEE,9/26/2020,405,366,3,774
OCONEE,9/27/2020,406,368,3,777
OCONEE,9/28/2020,409,370,3,782
OCONEE,9/29/2020,409,370,3,782
OCONEE,9/30/2020,409,372,3,784
OCONEE,10/1/2020,410,374,3,787
OCONEE,10/2/2020,412,378,3,793
OCONEE,10/3/2020,414,381,3,798
OCONEE,10/4/2020,415,384,3,802
OCONEE,10/5/2020,416,387,3,806
OCONEE,10/6/2020,417,388,3,808
OCONEE,10/7/2020,419,388,3,810
OCONEE,10/8/2020,421,388,3,812
OCONEE,10/9/2020,424,390,3,817
OCONEE,10/10/2020,425,391,3,819
OCONEE,10/11/2020,427,391,3,821
OCONEE,10/12/2020,431,391,3,825
OCONEE,10/13/2020,432,391,3,826
OCONEE,10/14/2020,433,392,3,828
OCONEE,10/15/2020,435,394,3,832
OCONEE,10/16/2020,437,395,3,835
OCONEE,10/17/2020,437,395,3,835
OCONEE,10/18/2020,437,395,3,835
OCONEE,10/19/2020,437,395,3,835
OCONEE,10/20/2020,437,395,3,835
OGLETHORPE,1/1/2020,0,0,0,0
OGLETHORPE,1/2/2020,0,0,0,0
OGLETHORPE,1/3/2020,0,0,0,0
OGLETHORPE,1/4/2020,0,0,0,0
OGLETHORPE,1/5/2020,0,0,0,0
OGLETHORPE,1/6/2020,0,0,0,0
OGLETHORPE,1/7/2020,0,0,0,0
OGLETHORPE,1/8/2020,0,0,0,0
OGLETHORPE,1/9/2020,0,0,0,0
OGLETHORPE,1/10/2020,0,0,0,0
OGLETHORPE,1/11/2020,0,0,0,0
OGLETHORPE,1/12/2020,0,0,0,0
OGLETHORPE,1/13/2020,0,0,0,0
OGLETHORPE,1/14/2020,0,0,0,0
OGLETHORPE,1/15/2020,0,0,0,0
OGLETHORPE,1/16/2020,0,0,0,0
OGLETHORPE,1/17/2020,0,0,0,0
OGLETHORPE,1/18/2020,0,0,0,0
OGLETHORPE,1/19/2020,0,0,0,0
OGLETHORPE,1/20/2020,0,0,0,0
OGLETHORPE,1/21/2020,0,0,0,0
OGLETHORPE,1/22/2020,0,0,0,0
OGLETHORPE,1/23/2020,0,0,0,0
OGLETHORPE,1/24/2020,0,0,0,0
OGLETHORPE,1/25/2020,0,0,0,0
OGLETHORPE,1/26/2020,0,0,0,0
OGLETHORPE,1/27/2020,0,0,0,0
OGLETHORPE,1/28/2020,0,0,0,0
OGLETHORPE,1/29/2020,0,0,0,0
OGLETHORPE,1/30/2020,0,0,0,0
OGLETHORPE,1/31/2020,0,0,0,0
RABUN,9/28/2020,194,185,6,385
OGLETHORPE,2/1/2020,0,0,0,0
OGLETHORPE,2/2/2020,0,0,0,0
OGLETHORPE,2/3/2020,0,0,0,0
OGLETHORPE,2/4/2020,0,0,0,0
OGLETHORPE,2/5/2020,0,0,0,0
OGLETHORPE,2/6/2020,0,0,0,0
OGLETHORPE,2/7/2020,0,0,0,0
OGLETHORPE,2/8/2020,0,0,0,0
OGLETHORPE,2/9/2020,0,0,0,0
OGLETHORPE,2/10/2020,0,0,0,0
OGLETHORPE,2/11/2020,0,0,0,0
OGLETHORPE,2/12/2020,0,0,0,0
OGLETHORPE,2/13/2020,0,0,0,0
OGLETHORPE,2/14/2020,0,0,0,0
OGLETHORPE,2/15/2020,0,0,0,0
OGLETHORPE,2/16/2020,0,0,0,0
OGLETHORPE,2/17/2020,0,0,0,0
OGLETHORPE,2/18/2020,0,0,0,0
OGLETHORPE,2/19/2020,0,0,0,0
OGLETHORPE,2/20/2020,0,0,0,0
OGLETHORPE,2/21/2020,0,0,0,0
OGLETHORPE,2/22/2020,0,0,0,0
OGLETHORPE,2/23/2020,0,0,0,0
OGLETHORPE,2/24/2020,0,0,0,0
OGLETHORPE,2/25/2020,0,0,0,0
OGLETHORPE,2/26/2020,0,0,0,0
OGLETHORPE,2/27/2020,0,0,0,0
OGLETHORPE,2/28/2020,0,0,0,0
OGLETHORPE,2/29/2020,0,0,0,0
OGLETHORPE,3/1/2020,0,0,0,0
OGLETHORPE,3/2/2020,0,0,0,0
OGLETHORPE,3/3/2020,0,0,0,0
OGLETHORPE,3/4/2020,0,0,0,0
OGLETHORPE,3/5/2020,0,0,0,0
OGLETHORPE,3/6/2020,0,0,0,0
OGLETHORPE,3/7/2020,0,0,0,0
OGLETHORPE,3/8/2020,0,0,0,0
OGLETHORPE,3/9/2020,0,0,0,0
OGLETHORPE,3/10/2020,0,0,0,0
OGLETHORPE,3/11/2020,0,0,0,0
OGLETHORPE,3/12/2020,0,0,0,0
OGLETHORPE,3/13/2020,0,0,0,0
OGLETHORPE,3/14/2020,0,0,0,0
OGLETHORPE,3/15/2020,0,0,0,0
OGLETHORPE,3/16/2020,0,0,0,0
OGLETHORPE,3/17/2020,0,0,0,0
OGLETHORPE,3/18/2020,0,0,0,0
OGLETHORPE,3/19/2020,1,0,0,1
OGLETHORPE,3/20/2020,1,0,0,1
OGLETHORPE,3/21/2020,2,0,0,2
OGLETHORPE,3/22/2020,3,0,0,3
OGLETHORPE,3/23/2020,3,0,0,3
OGLETHORPE,3/24/2020,4,0,0,4
OGLETHORPE,3/25/2020,4,0,0,4
OGLETHORPE,3/26/2020,4,0,0,4
OGLETHORPE,3/27/2020,4,0,0,4
OGLETHORPE,3/28/2020,4,1,0,5
OGLETHORPE,3/29/2020,4,1,0,5
OGLETHORPE,3/30/2020,4,3,0,7
OGLETHORPE,3/31/2020,9,6,0,15
OGLETHORPE,4/1/2020,10,6,0,16
OGLETHORPE,4/2/2020,11,6,0,17
OGLETHORPE,4/3/2020,12,6,0,18
OGLETHORPE,4/4/2020,12,6,0,18
OGLETHORPE,4/5/2020,12,6,0,18
OGLETHORPE,4/6/2020,14,6,0,20
OGLETHORPE,4/7/2020,14,6,0,20
OGLETHORPE,4/8/2020,14,7,0,21
OGLETHORPE,4/9/2020,15,7,0,22
OGLETHORPE,4/10/2020,22,10,2,34
OGLETHORPE,4/11/2020,22,10,2,34
OGLETHORPE,4/12/2020,22,10,2,34
OGLETHORPE,4/13/2020,22,10,2,34
OGLETHORPE,4/14/2020,24,10,2,36
OGLETHORPE,4/15/2020,24,10,2,36
OGLETHORPE,4/16/2020,24,10,2,36
OGLETHORPE,4/17/2020,25,10,2,37
OGLETHORPE,4/18/2020,25,10,2,37
OGLETHORPE,4/19/2020,25,10,2,37
OGLETHORPE,4/20/2020,27,10,2,39
OGLETHORPE,4/21/2020,35,12,2,49
OGLETHORPE,4/22/2020,35,12,2,49
OGLETHORPE,4/23/2020,35,12,2,49
OGLETHORPE,4/24/2020,35,12,2,49
OGLETHORPE,4/25/2020,35,12,2,49
OGLETHORPE,4/26/2020,35,12,2,49
OGLETHORPE,4/27/2020,36,12,2,50
OGLETHORPE,4/28/2020,36,14,2,52
OGLETHORPE,4/29/2020,37,15,2,54
OGLETHORPE,4/30/2020,37,15,2,54
OGLETHORPE,5/1/2020,37,15,2,54
OGLETHORPE,5/2/2020,37,15,2,54
OGLETHORPE,5/3/2020,37,15,2,54
OGLETHORPE,5/4/2020,37,16,2,55
OGLETHORPE,5/5/2020,37,16,2,55
OGLETHORPE,5/6/2020,37,16,2,55
OGLETHORPE,5/7/2020,37,16,2,55
OGLETHORPE,5/8/2020,38,16,2,56
OGLETHORPE,5/9/2020,38,16,2,56
OGLETHORPE,5/10/2020,38,16,2,56
OGLETHORPE,5/11/2020,38,16,2,56
OGLETHORPE,5/12/2020,38,16,2,56
OGLETHORPE,5/13/2020,38,16,2,56
OGLETHORPE,5/14/2020,38,16,2,56
OGLETHORPE,5/15/2020,38,16,2,56
OGLETHORPE,5/16/2020,38,16,2,56
OGLETHORPE,5/17/2020,39,16,2,57
OGLETHORPE,5/18/2020,39,16,2,57
OGLETHORPE,5/19/2020,39,16,2,57
OGLETHORPE,5/20/2020,39,16,2,57
OGLETHORPE,5/21/2020,39,16,2,57
OGLETHORPE,5/22/2020,40,16,2,58
OGLETHORPE,5/23/2020,40,16,2,58
OGLETHORPE,5/24/2020,41,16,2,59
OGLETHORPE,5/25/2020,41,17,2,60
OGLETHORPE,5/26/2020,41,17,2,60
OGLETHORPE,5/27/2020,41,17,2,60
OGLETHORPE,5/28/2020,41,18,2,61
OGLETHORPE,5/29/2020,42,18,2,62
OGLETHORPE,5/30/2020,42,18,2,62
OGLETHORPE,5/31/2020,42,18,2,62
OGLETHORPE,6/1/2020,45,20,2,67
OGLETHORPE,6/2/2020,45,20,2,67
OGLETHORPE,6/3/2020,45,20,2,67
OGLETHORPE,6/4/2020,46,20,2,68
OGLETHORPE,6/5/2020,47,20,2,69
OGLETHORPE,6/6/2020,47,20,2,69
OGLETHORPE,6/7/2020,47,20,2,69
OGLETHORPE,6/8/2020,48,21,2,71
OGLETHORPE,6/9/2020,48,23,2,73
OGLETHORPE,6/10/2020,48,24,2,74
OGLETHORPE,6/11/2020,50,26,2,78
OGLETHORPE,6/12/2020,50,26,2,78
OGLETHORPE,6/13/2020,50,26,2,78
OGLETHORPE,6/14/2020,51,26,2,79
OGLETHORPE,6/15/2020,52,29,2,83
OGLETHORPE,6/16/2020,52,29,2,83
OGLETHORPE,6/17/2020,53,29,2,84
OGLETHORPE,6/18/2020,53,29,2,84
OGLETHORPE,6/19/2020,53,29,2,84
OGLETHORPE,6/20/2020,53,29,2,84
OGLETHORPE,6/21/2020,53,29,2,84
OGLETHORPE,6/22/2020,53,30,2,85
OGLETHORPE,6/23/2020,53,31,2,86
OGLETHORPE,6/24/2020,55,33,2,90
OGLETHORPE,6/25/2020,55,33,2,90
OGLETHORPE,6/26/2020,57,34,2,93
OGLETHORPE,6/27/2020,57,35,2,94
OGLETHORPE,6/28/2020,59,35,2,96
OGLETHORPE,6/29/2020,59,35,2,96
OGLETHORPE,6/30/2020,61,35,2,98
OGLETHORPE,7/1/2020,62,36,2,100
OGLETHORPE,7/2/2020,64,36,2,102
OGLETHORPE,7/3/2020,65,40,2,107
OGLETHORPE,7/4/2020,66,40,2,108
OGLETHORPE,7/5/2020,66,40,2,108
OGLETHORPE,7/6/2020,68,43,2,113
OGLETHORPE,7/7/2020,72,45,2,119
OGLETHORPE,7/8/2020,77,49,2,128
OGLETHORPE,7/9/2020,84,52,2,138
OGLETHORPE,7/10/2020,89,53,2,144
OGLETHORPE,7/11/2020,92,55,2,149
OGLETHORPE,7/12/2020,94,56,2,152
OGLETHORPE,7/13/2020,94,60,2,156
OGLETHORPE,7/14/2020,96,65,2,163
OGLETHORPE,7/15/2020,97,66,2,165
OGLETHORPE,7/16/2020,99,67,2,168
OGLETHORPE,7/17/2020,100,69,2,171
OGLETHORPE,7/18/2020,101,69,2,172
OGLETHORPE,7/19/2020,103,69,2,174
OGLETHORPE,7/20/2020,105,70,2,177
OGLETHORPE,7/21/2020,109,71,2,182
OGLETHORPE,7/22/2020,111,71,2,184
OGLETHORPE,7/23/2020,111,73,2,186
OGLETHORPE,7/24/2020,111,73,2,186
OGLETHORPE,7/25/2020,113,73,2,188
OGLETHORPE,7/26/2020,115,73,2,190
OGLETHORPE,7/27/2020,116,73,2,191
OGLETHORPE,7/28/2020,119,76,2,197
OGLETHORPE,7/29/2020,124,78,2,204
OGLETHORPE,7/30/2020,125,80,2,207
OGLETHORPE,7/31/2020,127,80,2,209
OGLETHORPE,8/1/2020,128,80,2,210
OGLETHORPE,8/2/2020,129,80,2,211
OGLETHORPE,8/3/2020,134,83,2,219
OGLETHORPE,8/4/2020,138,84,2,224
OGLETHORPE,8/5/2020,140,86,2,228
OGLETHORPE,8/6/2020,143,88,2,233
OGLETHORPE,8/7/2020,145,88,2,235
OGLETHORPE,8/8/2020,149,89,2,240
OGLETHORPE,8/9/2020,152,89,2,243
OGLETHORPE,8/10/2020,156,94,2,252
OGLETHORPE,8/11/2020,158,98,2,258
OGLETHORPE,8/12/2020,159,99,2,260
OGLETHORPE,8/13/2020,160,101,2,263
OGLETHORPE,8/14/2020,161,102,2,265
OGLETHORPE,8/15/2020,162,103,2,267
OGLETHORPE,8/16/2020,162,105,2,269
OGLETHORPE,8/17/2020,164,106,2,272
OGLETHORPE,8/18/2020,165,107,2,274
OGLETHORPE,8/19/2020,166,108,2,276
OGLETHORPE,8/20/2020,168,108,2,278
OGLETHORPE,8/21/2020,171,108,2,281
OGLETHORPE,8/22/2020,172,108,2,282
OGLETHORPE,8/23/2020,173,108,2,283
OGLETHORPE,8/24/2020,175,109,2,286
OGLETHORPE,8/25/2020,176,110,2,288
OGLETHORPE,8/26/2020,178,110,2,290
OGLETHORPE,8/27/2020,178,113,2,293
OGLETHORPE,8/28/2020,180,114,2,296
OGLETHORPE,8/29/2020,182,114,2,298
OGLETHORPE,8/30/2020,182,114,2,298
OGLETHORPE,8/31/2020,183,114,2,299
OGLETHORPE,9/1/2020,183,115,2,300
OGLETHORPE,9/2/2020,185,115,2,302
OGLETHORPE,9/3/2020,186,115,2,303
OGLETHORPE,9/4/2020,187,117,2,306
OGLETHORPE,9/5/2020,187,119,2,308
OGLETHORPE,9/6/2020,187,119,2,308
OGLETHORPE,9/7/2020,188,119,2,309
OGLETHORPE,9/8/2020,188,121,2,311
OGLETHORPE,9/9/2020,189,121,2,312
OGLETHORPE,9/10/2020,190,124,2,316
OGLETHORPE,9/11/2020,192,124,2,318
OGLETHORPE,9/12/2020,192,126,2,320
OGLETHORPE,9/13/2020,194,129,2,325
OGLETHORPE,9/14/2020,194,130,2,326
OGLETHORPE,9/15/2020,195,131,2,328
OGLETHORPE,9/16/2020,197,131,2,330
OGLETHORPE,9/17/2020,198,133,2,333
OGLETHORPE,9/18/2020,198,135,2,335
OGLETHORPE,9/19/2020,198,136,2,336
OGLETHORPE,9/20/2020,198,136,2,336
OGLETHORPE,9/21/2020,198,137,2,337
OGLETHORPE,9/22/2020,198,137,2,337
OGLETHORPE,9/23/2020,199,137,2,338
OGLETHORPE,9/24/2020,201,138,2,341
OGLETHORPE,9/25/2020,201,139,2,342
OGLETHORPE,9/26/2020,204,140,2,346
OGLETHORPE,9/27/2020,204,142,2,348
OGLETHORPE,9/28/2020,204,146,3,353
OGLETHORPE,9/29/2020,204,146,3,353
OGLETHORPE,9/30/2020,205,146,3,354
OGLETHORPE,10/1/2020,207,146,3,356
OGLETHORPE,10/2/2020,208,147,3,358
OGLETHORPE,10/3/2020,208,150,3,361
OGLETHORPE,10/4/2020,212,150,3,365
OGLETHORPE,10/5/2020,214,154,3,371
OGLETHORPE,10/6/2020,216,156,3,375
OGLETHORPE,10/7/2020,218,157,3,378
OGLETHORPE,10/8/2020,221,160,3,384
OGLETHORPE,10/9/2020,222,160,3,385
OGLETHORPE,10/10/2020,223,160,3,386
OGLETHORPE,10/11/2020,225,161,3,389
OGLETHORPE,10/12/2020,227,161,3,391
OGLETHORPE,10/13/2020,227,161,3,391
OGLETHORPE,10/14/2020,227,161,3,391
OGLETHORPE,10/15/2020,227,162,3,392
OGLETHORPE,10/16/2020,229,162,3,394
OGLETHORPE,10/17/2020,229,162,3,394
OGLETHORPE,10/18/2020,229,162,3,394
OGLETHORPE,10/19/2020,229,162,3,394
OGLETHORPE,10/20/2020,229,162,3,394
PAULDING,1/1/2020,0,0,0,0
PAULDING,1/2/2020,0,0,0,0
PAULDING,1/3/2020,0,0,0,0
PAULDING,1/4/2020,0,0,0,0
PAULDING,1/5/2020,0,0,0,0
PAULDING,1/6/2020,0,0,0,0
PAULDING,1/7/2020,0,0,0,0
PAULDING,1/8/2020,0,0,0,0
PAULDING,1/9/2020,0,0,0,0
PAULDING,1/10/2020,0,0,0,0
PAULDING,1/11/2020,0,0,0,0
PAULDING,1/12/2020,0,0,0,0
PAULDING,1/13/2020,0,0,0,0
PAULDING,1/14/2020,0,0,0,0
PAULDING,1/15/2020,0,0,0,0
PAULDING,1/16/2020,0,0,0,0
PAULDING,1/17/2020,0,0,0,0
PAULDING,1/18/2020,0,0,0,0
PAULDING,1/19/2020,0,0,0,0
PAULDING,1/20/2020,0,0,0,0
PAULDING,1/21/2020,0,0,0,0
PAULDING,1/22/2020,0,0,0,0
PAULDING,1/23/2020,0,0,0,0
PAULDING,1/24/2020,0,0,0,0
PAULDING,1/25/2020,0,0,0,0
PAULDING,1/26/2020,0,0,0,0
PAULDING,1/27/2020,0,0,0,0
PAULDING,1/28/2020,0,0,0,0
PAULDING,1/29/2020,0,0,0,0
PAULDING,1/30/2020,0,0,0,0
PAULDING,1/31/2020,0,0,0,0
PAULDING,2/1/2020,0,0,0,0
PAULDING,2/2/2020,0,0,0,0
PAULDING,2/3/2020,0,0,0,0
PAULDING,2/4/2020,0,0,0,0
PAULDING,2/5/2020,0,0,0,0
PAULDING,2/6/2020,0,0,0,0
PAULDING,2/7/2020,0,0,0,0
PAULDING,2/8/2020,0,0,0,0
PAULDING,2/9/2020,0,0,0,0
PAULDING,2/10/2020,0,0,0,0
PAULDING,2/11/2020,0,0,0,0
PAULDING,2/12/2020,0,0,0,0
PAULDING,2/13/2020,0,0,0,0
PAULDING,2/14/2020,0,0,0,0
PAULDING,2/15/2020,0,0,0,0
PAULDING,2/16/2020,0,0,0,0
PAULDING,2/17/2020,0,0,0,0
PAULDING,2/18/2020,0,0,0,0
PAULDING,2/19/2020,0,0,0,0
PAULDING,2/20/2020,0,0,0,0
PAULDING,2/21/2020,0,0,0,0
PAULDING,2/22/2020,0,0,0,0
PAULDING,2/23/2020,0,0,0,0
PAULDING,2/24/2020,0,0,0,0
PAULDING,2/25/2020,0,0,0,0
RABUN,9/29/2020,195,185,6,386
RABUN,9/30/2020,195,187,6,388
RABUN,10/1/2020,195,195,7,397
RABUN,10/2/2020,196,196,7,399
RABUN,10/3/2020,196,197,7,400
RABUN,10/4/2020,197,197,7,401
RABUN,10/5/2020,198,198,7,403
RABUN,10/6/2020,198,198,7,403
RABUN,10/7/2020,198,198,7,403
RABUN,10/8/2020,200,198,7,405
RABUN,10/9/2020,200,201,7,408
RABUN,10/10/2020,202,201,7,410
RABUN,10/11/2020,202,201,7,410
RABUN,10/12/2020,202,201,7,410
RABUN,10/13/2020,203,201,7,411
RABUN,10/14/2020,204,202,7,413
RABUN,10/15/2020,204,202,7,413
RABUN,10/16/2020,206,202,7,415
RABUN,10/17/2020,206,203,7,416
RABUN,10/18/2020,206,203,7,416
RABUN,10/19/2020,206,203,7,416
RABUN,10/20/2020,206,203,7,416
RICHMOND,1/1/2020,0,0,0,0
RICHMOND,1/2/2020,0,0,0,0
RICHMOND,1/3/2020,0,0,0,0
RICHMOND,1/4/2020,0,0,0,0
RICHMOND,1/5/2020,0,0,0,0
RICHMOND,1/6/2020,0,0,0,0
RICHMOND,1/7/2020,0,0,0,0
RICHMOND,1/8/2020,0,0,0,0
RICHMOND,1/9/2020,0,0,0,0
RICHMOND,1/10/2020,0,0,0,0
RICHMOND,1/11/2020,0,0,0,0
RICHMOND,1/12/2020,0,0,0,0
RICHMOND,1/13/2020,0,0,0,0
RICHMOND,1/14/2020,0,0,0,0
RICHMOND,1/15/2020,0,0,0,0
RICHMOND,1/16/2020,0,0,0,0
RICHMOND,1/17/2020,0,0,0,0
RICHMOND,1/18/2020,0,0,0,0
RICHMOND,1/19/2020,0,0,0,0
RICHMOND,1/20/2020,0,0,0,0
RICHMOND,1/21/2020,0,0,0,0
RICHMOND,1/22/2020,0,0,0,0
RICHMOND,1/23/2020,0,0,0,0
RICHMOND,1/24/2020,0,0,0,0
RICHMOND,1/25/2020,0,0,0,0
RICHMOND,1/26/2020,0,0,0,0
RICHMOND,1/27/2020,0,0,0,0
RICHMOND,1/28/2020,0,0,0,0
RICHMOND,1/29/2020,0,0,0,0
RICHMOND,1/30/2020,0,0,0,0
RICHMOND,1/31/2020,0,0,0,0
RICHMOND,2/1/2020,0,0,0,0
RICHMOND,2/2/2020,0,1,0,1
RICHMOND,2/3/2020,0,1,0,1
RICHMOND,2/4/2020,0,1,0,1
RICHMOND,2/5/2020,0,1,0,1
RICHMOND,2/6/2020,0,1,0,1
RICHMOND,2/7/2020,0,1,0,1
RICHMOND,2/8/2020,0,1,0,1
RICHMOND,2/9/2020,0,1,0,1
RICHMOND,2/10/2020,0,1,0,1
RICHMOND,2/11/2020,0,1,0,1
RICHMOND,2/12/2020,0,1,0,1
RICHMOND,2/13/2020,0,1,0,1
RICHMOND,2/14/2020,0,1,0,1
RICHMOND,2/15/2020,0,1,0,1
RICHMOND,2/16/2020,0,1,0,1
RICHMOND,2/17/2020,0,1,0,1
RICHMOND,2/18/2020,0,1,0,1
RICHMOND,2/19/2020,0,1,0,1
RICHMOND,2/20/2020,0,1,0,1
RICHMOND,2/21/2020,0,1,0,1
RICHMOND,2/22/2020,0,1,0,1
RICHMOND,2/23/2020,0,1,0,1
RICHMOND,2/24/2020,1,1,0,2
RICHMOND,2/25/2020,1,1,0,2
RICHMOND,2/26/2020,1,1,0,2
RICHMOND,2/27/2020,1,1,0,2
RICHMOND,2/28/2020,1,1,0,2
RICHMOND,2/29/2020,1,1,0,2
RICHMOND,3/1/2020,1,1,0,2
RICHMOND,3/2/2020,1,1,0,2
RICHMOND,3/3/2020,1,1,0,2
RICHMOND,3/4/2020,2,1,0,3
RICHMOND,3/5/2020,2,1,0,3
RICHMOND,3/6/2020,2,1,0,3
RICHMOND,3/7/2020,2,1,0,3
RICHMOND,3/8/2020,2,1,0,3
RICHMOND,3/9/2020,2,2,0,4
RICHMOND,3/10/2020,3,2,0,5
RICHMOND,3/11/2020,4,2,0,6
RICHMOND,3/12/2020,5,3,0,8
RICHMOND,3/13/2020,5,3,0,8
RICHMOND,3/14/2020,5,4,0,9
RICHMOND,3/15/2020,5,6,0,11
RICHMOND,3/16/2020,6,6,0,12
RICHMOND,3/17/2020,6,8,0,14
RICHMOND,3/18/2020,8,9,0,17
RICHMOND,3/19/2020,11,10,0,21
RICHMOND,3/20/2020,13,11,0,24
RICHMOND,3/21/2020,16,13,0,29
RICHMOND,3/22/2020,18,14,0,32
RICHMOND,3/23/2020,23,17,0,40
RICHMOND,3/24/2020,24,20,0,44
RICHMOND,3/25/2020,27,21,0,48
RICHMOND,3/26/2020,30,24,0,54
RICHMOND,3/27/2020,35,25,0,60
RICHMOND,3/28/2020,37,27,0,64
RICHMOND,3/29/2020,38,27,0,65
RICHMOND,3/30/2020,40,29,0,69
RICHMOND,3/31/2020,42,30,0,72
RICHMOND,4/1/2020,48,33,1,82
RICHMOND,4/2/2020,54,36,1,91
RICHMOND,4/3/2020,61,40,1,102
RICHMOND,4/4/2020,67,43,1,111
RICHMOND,4/5/2020,69,46,2,117
RICHMOND,4/6/2020,74,50,2,126
RICHMOND,4/7/2020,77,52,2,131
RICHMOND,4/8/2020,80,57,2,139
RICHMOND,4/9/2020,92,69,8,169
RICHMOND,4/10/2020,122,85,16,223
RICHMOND,4/11/2020,129,90,16,235
RICHMOND,4/12/2020,133,94,16,243
RICHMOND,4/13/2020,139,100,16,255
RICHMOND,4/14/2020,148,103,16,267
RICHMOND,4/15/2020,168,109,16,293
RICHMOND,4/16/2020,177,117,17,311
RICHMOND,4/17/2020,178,123,17,318
RICHMOND,4/18/2020,190,132,17,339
RICHMOND,4/19/2020,200,133,18,351
RICHMOND,4/20/2020,209,150,18,377
RICHMOND,4/21/2020,213,152,18,383
RICHMOND,4/22/2020,216,156,18,390
RICHMOND,4/23/2020,226,162,19,407
RICHMOND,4/24/2020,231,167,19,417
RICHMOND,4/25/2020,237,169,19,425
RICHMOND,4/26/2020,237,171,19,427
RICHMOND,4/27/2020,240,176,19,435
RICHMOND,4/28/2020,243,178,19,440
RICHMOND,4/29/2020,249,182,19,450
RICHMOND,4/30/2020,254,182,19,455
RICHMOND,5/1/2020,260,187,19,466
RICHMOND,5/2/2020,263,188,21,472
RICHMOND,5/3/2020,267,190,21,478
RICHMOND,5/4/2020,268,198,21,487
RICHMOND,5/5/2020,270,203,21,494
RICHMOND,5/6/2020,276,211,21,508
RICHMOND,5/7/2020,278,212,21,511
RICHMOND,5/8/2020,280,215,21,516
RICHMOND,5/9/2020,280,217,21,518
RICHMOND,5/10/2020,281,218,21,520
RICHMOND,5/11/2020,281,222,21,524
RICHMOND,5/12/2020,284,224,21,529
RICHMOND,5/13/2020,295,227,21,543
RICHMOND,5/14/2020,302,240,21,563
RICHMOND,5/15/2020,310,242,21,573
RICHMOND,5/16/2020,316,242,21,579
RICHMOND,5/17/2020,322,242,21,585
RICHMOND,5/18/2020,324,244,21,589
RICHMOND,5/19/2020,329,251,21,601
RICHMOND,5/20/2020,331,254,21,606
RICHMOND,5/21/2020,332,263,21,616
RICHMOND,5/22/2020,335,268,21,624
RICHMOND,5/23/2020,341,272,21,634
RICHMOND,5/24/2020,343,275,21,639
RICHMOND,5/25/2020,343,276,21,640
RICHMOND,5/26/2020,346,279,21,646
RICHMOND,5/27/2020,349,283,21,653
RICHMOND,5/28/2020,355,285,21,661
RICHMOND,5/29/2020,359,286,21,666
RICHMOND,5/30/2020,359,290,21,670
RICHMOND,5/31/2020,362,291,21,674
RICHMOND,6/1/2020,368,297,21,686
RICHMOND,6/2/2020,374,298,21,693
RICHMOND,6/3/2020,379,309,21,709
RICHMOND,6/4/2020,387,313,21,721
RICHMOND,6/5/2020,391,318,21,730
RICHMOND,6/6/2020,394,321,21,736
RICHMOND,6/7/2020,394,323,21,738
RICHMOND,6/8/2020,401,324,21,746
RICHMOND,6/9/2020,405,336,21,762
RICHMOND,6/10/2020,412,342,21,775
RICHMOND,6/11/2020,415,344,21,780
RICHMOND,6/12/2020,418,347,21,786
RICHMOND,6/13/2020,420,347,21,788
RICHMOND,6/14/2020,424,351,21,796
RICHMOND,6/15/2020,431,358,21,810
RICHMOND,6/16/2020,436,366,21,823
RICHMOND,6/17/2020,443,371,21,835
RICHMOND,6/18/2020,448,387,21,856
RICHMOND,6/19/2020,456,393,22,871
RICHMOND,6/20/2020,462,401,22,885
RICHMOND,6/21/2020,471,412,22,905
RICHMOND,6/22/2020,484,455,22,961
RICHMOND,6/23/2020,503,471,22,996
RICHMOND,6/24/2020,530,491,22,1043
RICHMOND,6/25/2020,542,518,22,1082
RICHMOND,6/26/2020,575,544,23,1142
RICHMOND,6/27/2020,605,561,23,1189
RICHMOND,6/28/2020,627,579,23,1229
RICHMOND,6/29/2020,668,621,26,1315
RICHMOND,6/30/2020,714,655,27,1396
RICHMOND,7/1/2020,758,696,28,1482
RICHMOND,7/2/2020,794,723,29,1546
RICHMOND,7/3/2020,825,744,30,1599
RICHMOND,7/4/2020,843,763,30,1636
RICHMOND,7/5/2020,872,784,30,1686
RICHMOND,7/6/2020,932,813,31,1776
RICHMOND,7/7/2020,967,854,31,1852
RICHMOND,7/8/2020,1023,908,31,1962
RICHMOND,7/9/2020,1076,950,31,2057
RICHMOND,7/10/2020,1133,1002,31,2166
RICHMOND,7/11/2020,1184,1041,32,2257
RICHMOND,7/12/2020,1217,1068,32,2317
RICHMOND,7/13/2020,1286,1122,34,2442
RICHMOND,7/14/2020,1346,1158,35,2539
RICHMOND,7/15/2020,1403,1205,37,2645
RICHMOND,7/16/2020,1459,1254,37,2750
RICHMOND,7/17/2020,1521,1296,38,2855
RICHMOND,7/18/2020,1554,1328,40,2922
RICHMOND,7/19/2020,1594,1354,40,2988
RICHMOND,7/20/2020,1652,1396,40,3088
RICHMOND,7/21/2020,1710,1443,41,3194
RICHMOND,7/22/2020,1777,1494,42,3313
RICHMOND,7/23/2020,1840,1550,42,3432
RICHMOND,7/24/2020,1905,1601,43,3549
RICHMOND,7/25/2020,1957,1641,43,3641
RICHMOND,7/26/2020,1996,1670,43,3709
RICHMOND,7/27/2020,2071,1735,51,3857
RICHMOND,7/28/2020,2141,1787,54,3982
RICHMOND,7/29/2020,2219,1832,54,4105
RICHMOND,7/30/2020,2271,1871,55,4197
RICHMOND,7/31/2020,2323,1910,60,4293
RICHMOND,8/1/2020,2368,1944,60,4372
RICHMOND,8/2/2020,2407,1969,62,4438
RICHMOND,8/3/2020,2460,2018,62,4540
RICHMOND,8/4/2020,2515,2066,63,4644
RICHMOND,8/5/2020,2578,2120,66,4764
RICHMOND,8/6/2020,2626,2155,69,4850
RICHMOND,8/7/2020,2673,2185,69,4927
RICHMOND,8/8/2020,2700,2208,69,4977
RICHMOND,8/9/2020,2728,2237,69,5034
RICHMOND,8/10/2020,2773,2272,69,5114
RICHMOND,8/11/2020,2823,2310,69,5202
RICHMOND,8/12/2020,2878,2359,69,5306
RICHMOND,8/13/2020,2924,2395,70,5389
RICHMOND,8/14/2020,2953,2435,70,5458
RICHMOND,8/15/2020,2994,2462,70,5526
RICHMOND,8/16/2020,3020,2485,70,5575
RICHMOND,8/17/2020,3060,2514,70,5644
RICHMOND,8/18/2020,3093,2552,71,5716
RICHMOND,8/19/2020,3130,2586,71,5787
RICHMOND,8/20/2020,3151,2606,71,5828
RICHMOND,8/21/2020,3183,2629,71,5883
RICHMOND,8/22/2020,3211,2640,71,5922
RICHMOND,8/23/2020,3232,2652,71,5955
RICHMOND,8/24/2020,3272,2687,71,6030
RICHMOND,8/25/2020,3301,2703,71,6075
RICHMOND,8/26/2020,3329,2730,72,6131
RICHMOND,8/27/2020,3345,2753,72,6170
RICHMOND,8/28/2020,3364,2766,73,6203
RICHMOND,8/29/2020,3377,2776,73,6226
RICHMOND,8/30/2020,3384,2800,73,6257
RICHMOND,8/31/2020,3405,2822,73,6300
RICHMOND,9/1/2020,3422,2845,73,6340
RICHMOND,9/2/2020,3443,2868,73,6384
RICHMOND,9/3/2020,3463,2893,73,6429
RICHMOND,9/4/2020,3486,2931,74,6491
RICHMOND,9/5/2020,3498,2946,74,6518
RICHMOND,9/6/2020,3511,2956,74,6541
RICHMOND,9/7/2020,3519,2962,74,6555
RICHMOND,9/8/2020,3558,2987,74,6619
RICHMOND,9/9/2020,3584,3005,74,6663
RICHMOND,9/10/2020,3615,3022,75,6712
RICHMOND,9/11/2020,3635,3045,76,6756
RICHMOND,9/12/2020,3661,3061,76,6798
RICHMOND,9/13/2020,3676,3066,76,6818
RICHMOND,9/14/2020,3687,3084,76,6847
RICHMOND,9/15/2020,3719,3104,77,6900
RICHMOND,9/16/2020,3737,3127,78,6942
RICHMOND,9/17/2020,3753,3146,78,6977
RICHMOND,9/18/2020,3771,3165,79,7015
RICHMOND,9/19/2020,3779,3168,79,7026
RICHMOND,9/20/2020,3797,3174,79,7050
RICHMOND,9/21/2020,3813,3186,79,7078
RICHMOND,9/22/2020,3828,3195,79,7102
RICHMOND,9/23/2020,3849,3209,79,7137
RICHMOND,9/24/2020,3874,3226,79,7179
RICHMOND,9/25/2020,3886,3238,79,7203
RICHMOND,9/26/2020,3896,3249,79,7224
RICHMOND,9/27/2020,3905,3259,79,7243
RICHMOND,9/28/2020,3919,3269,79,7267
RICHMOND,9/29/2020,3934,3279,82,7295
RICHMOND,9/30/2020,3959,3295,82,7336
RICHMOND,10/1/2020,3969,3304,82,7355
RICHMOND,10/2/2020,3982,3312,82,7376
RICHMOND,10/3/2020,3993,3322,82,7397
RICHMOND,10/4/2020,4002,3326,82,7410
RICHMOND,10/5/2020,4024,3338,82,7444
RICHMOND,10/6/2020,4043,3357,82,7482
RICHMOND,10/7/2020,4067,3378,83,7528
RICHMOND,10/8/2020,4088,3386,83,7557
RICHMOND,10/9/2020,4106,3402,83,7591
RICHMOND,10/10/2020,4120,3407,83,7610
RICHMOND,10/11/2020,4126,3416,84,7626
RICHMOND,10/12/2020,4136,3424,84,7644
RICHMOND,10/13/2020,4148,3434,85,7667
RICHMOND,10/14/2020,4154,3447,85,7686
RICHMOND,10/15/2020,4171,3458,85,7714
RICHMOND,10/16/2020,4184,3465,87,7736
RICHMOND,10/17/2020,4189,3472,87,7748
RICHMOND,10/18/2020,4190,3475,87,7752
RICHMOND,10/19/2020,4191,3476,87,7754
RICHMOND,10/20/2020,4191,3476,87,7754
ROCKDALE,1/1/2020,0,0,0,0
ROCKDALE,1/2/2020,0,0,0,0
ROCKDALE,1/3/2020,0,0,0,0
ROCKDALE,1/4/2020,0,0,0,0
ROCKDALE,1/5/2020,0,0,0,0
ROCKDALE,1/6/2020,0,0,0,0
ROCKDALE,1/7/2020,0,0,0,0
ROCKDALE,1/8/2020,0,0,0,0
ROCKDALE,1/9/2020,0,0,0,0
ROCKDALE,1/10/2020,0,0,0,0
ROCKDALE,1/11/2020,0,0,0,0
ROCKDALE,1/12/2020,0,0,0,0
ROCKDALE,1/13/2020,0,0,0,0
ROCKDALE,1/14/2020,0,0,0,0
ROCKDALE,1/15/2020,0,0,0,0
ROCKDALE,1/16/2020,0,0,0,0
ROCKDALE,1/17/2020,0,0,0,0
ROCKDALE,1/18/2020,0,0,0,0
ROCKDALE,1/19/2020,0,0,0,0
ROCKDALE,1/20/2020,0,0,0,0
ROCKDALE,1/21/2020,0,0,0,0
ROCKDALE,1/22/2020,0,0,0,0
ROCKDALE,1/23/2020,0,0,0,0
ROCKDALE,1/24/2020,0,0,0,0
ROCKDALE,1/25/2020,0,0,0,0
ROCKDALE,1/26/2020,0,0,0,0
ROCKDALE,1/27/2020,0,0,0,0
ROCKDALE,1/28/2020,0,0,0,0
ROCKDALE,1/29/2020,0,0,0,0
ROCKDALE,1/30/2020,0,0,0,0
ROCKDALE,1/31/2020,0,0,0,0
ROCKDALE,2/1/2020,0,0,0,0
ROCKDALE,2/2/2020,0,0,0,0
ROCKDALE,2/3/2020,0,0,0,0
ROCKDALE,2/4/2020,0,0,0,0
ROCKDALE,2/5/2020,0,0,0,0
ROCKDALE,2/6/2020,0,0,0,0
ROCKDALE,2/7/2020,0,0,0,0
ROCKDALE,2/8/2020,0,0,0,0
ROCKDALE,2/9/2020,0,0,0,0
ROCKDALE,2/10/2020,0,0,0,0
ROCKDALE,2/11/2020,0,0,0,0
ROCKDALE,2/12/2020,0,0,0,0
ROCKDALE,2/13/2020,0,0,0,0
ROCKDALE,2/14/2020,0,0,0,0
ROCKDALE,2/15/2020,0,0,0,0
ROCKDALE,2/16/2020,0,0,0,0
ROCKDALE,2/17/2020,0,0,0,0
ROCKDALE,2/18/2020,0,0,0,0
ROCKDALE,2/19/2020,0,0,0,0
ROCKDALE,2/20/2020,0,0,0,0
ROCKDALE,2/21/2020,0,0,0,0
ROCKDALE,2/22/2020,0,0,0,0
ROCKDALE,2/23/2020,0,0,0,0
ROCKDALE,2/24/2020,0,0,0,0
ROCKDALE,2/25/2020,0,1,0,1
ROCKDALE,2/26/2020,0,2,0,2
ROCKDALE,2/27/2020,0,2,0,2
ROCKDALE,2/28/2020,0,2,0,2
ROCKDALE,2/29/2020,0,2,0,2
ROCKDALE,3/1/2020,0,3,0,3
ROCKDALE,3/2/2020,0,3,0,3
ROCKDALE,3/3/2020,0,3,0,3
ROCKDALE,3/4/2020,0,4,0,4
ROCKDALE,3/5/2020,0,5,0,5
ROCKDALE,3/6/2020,0,5,0,5
ROCKDALE,3/7/2020,1,5,0,6
ROCKDALE,3/8/2020,2,7,0,9
ROCKDALE,3/9/2020,2,8,0,10
ROCKDALE,3/10/2020,2,10,0,12
ROCKDALE,3/11/2020,4,10,0,14
ROCKDALE,3/12/2020,4,10,0,14
ROCKDALE,3/13/2020,6,11,0,17
ROCKDALE,3/14/2020,6,12,0,18
ROCKDALE,3/15/2020,6,12,0,18
ROCKDALE,3/16/2020,10,13,0,23
ROCKDALE,3/17/2020,11,15,0,26
ROCKDALE,3/18/2020,14,15,0,29
ROCKDALE,3/19/2020,16,17,0,33
ROCKDALE,3/20/2020,21,19,0,40
TALIAFERRO,1/23/2020,0,0,0,0
TALIAFERRO,1/24/2020,0,0,0,0
TALIAFERRO,1/25/2020,0,0,0,0
TALIAFERRO,1/26/2020,0,0,0,0
TALIAFERRO,1/27/2020,0,0,0,0
TALIAFERRO,1/28/2020,0,0,0,0
TALIAFERRO,1/29/2020,0,0,0,0
TALIAFERRO,1/30/2020,0,0,0,0
TALIAFERRO,1/31/2020,0,0,0,0
TALIAFERRO,2/1/2020,0,0,0,0
TALIAFERRO,2/2/2020,0,0,0,0
TALIAFERRO,2/3/2020,0,0,0,0
TALIAFERRO,2/4/2020,0,0,0,0
TALIAFERRO,2/5/2020,0,0,0,0
TALIAFERRO,2/6/2020,0,0,0,0
TALIAFERRO,2/7/2020,0,0,0,0
TALIAFERRO,2/8/2020,0,0,0,0
TALIAFERRO,2/9/2020,0,0,0,0
TALIAFERRO,2/10/2020,0,0,0,0
TALIAFERRO,2/11/2020,0,0,0,0
TALIAFERRO,2/12/2020,0,0,0,0
TALIAFERRO,2/13/2020,0,0,0,0
TALIAFERRO,2/14/2020,0,0,0,0
TALIAFERRO,2/15/2020,0,0,0,0
TALIAFERRO,2/16/2020,0,0,0,0
TALIAFERRO,2/17/2020,0,0,0,0
TALIAFERRO,2/18/2020,0,0,0,0
TALIAFERRO,2/19/2020,0,0,0,0
TALIAFERRO,2/20/2020,0,0,0,0
TALIAFERRO,2/21/2020,0,0,0,0
TALIAFERRO,2/22/2020,0,0,0,0
TALIAFERRO,2/23/2020,0,0,0,0
TALIAFERRO,2/24/2020,0,0,0,0
TALIAFERRO,2/25/2020,0,0,0,0
TALIAFERRO,2/26/2020,0,0,0,0
TALIAFERRO,2/27/2020,0,0,0,0
TALIAFERRO,2/28/2020,0,0,0,0
TALIAFERRO,2/29/2020,0,0,0,0
TALIAFERRO,3/1/2020,0,0,0,0
TALIAFERRO,3/2/2020,0,0,0,0
TALIAFERRO,3/3/2020,0,0,0,0
TALIAFERRO,3/4/2020,0,0,0,0
TALIAFERRO,3/5/2020,0,0,0,0
TALIAFERRO,3/6/2020,0,0,0,0
TALIAFERRO,3/7/2020,0,0,0,0
TALIAFERRO,3/8/2020,0,0,0,0
TALIAFERRO,3/9/2020,0,0,0,0
TALIAFERRO,3/10/2020,0,0,0,0
TALIAFERRO,3/11/2020,0,0,0,0
TALIAFERRO,3/12/2020,0,0,0,0
TALIAFERRO,3/13/2020,0,0,0,0
TALIAFERRO,3/14/2020,0,0,0,0
TALIAFERRO,3/15/2020,0,0,0,0
TALIAFERRO,3/16/2020,0,0,0,0
TALIAFERRO,3/17/2020,0,0,0,0
TALIAFERRO,3/18/2020,0,0,0,0
TALIAFERRO,3/19/2020,0,0,0,0
TALIAFERRO,3/20/2020,0,0,0,0
TALIAFERRO,3/21/2020,0,0,0,0
TALIAFERRO,3/22/2020,0,0,0,0
TALIAFERRO,3/23/2020,0,0,0,0
TALIAFERRO,3/24/2020,0,0,0,0
TALIAFERRO,3/25/2020,0,0,0,0
TALIAFERRO,3/26/2020,0,0,0,0
TALIAFERRO,3/27/2020,0,0,0,0
TALIAFERRO,3/28/2020,0,0,0,0
TALIAFERRO,3/29/2020,0,0,0,0
TALIAFERRO,3/30/2020,0,0,0,0
TALIAFERRO,3/31/2020,0,0,0,0
TALIAFERRO,4/1/2020,0,0,0,0
TALIAFERRO,4/2/2020,0,0,0,0
TALIAFERRO,4/3/2020,0,0,0,0
TALIAFERRO,4/4/2020,0,0,0,0
TALIAFERRO,4/5/2020,0,0,0,0
TALIAFERRO,4/6/2020,0,0,0,0
TALIAFERRO,4/7/2020,0,0,0,0
TALIAFERRO,4/8/2020,0,0,0,0
TALIAFERRO,4/9/2020,0,0,0,0
TALIAFERRO,4/10/2020,0,0,0,0
TALIAFERRO,4/11/2020,0,0,0,0
TALIAFERRO,4/12/2020,0,0,0,0
TALIAFERRO,4/13/2020,0,0,0,0
TALIAFERRO,4/14/2020,0,1,0,1
TALIAFERRO,4/15/2020,0,1,0,1
TALIAFERRO,4/16/2020,0,1,0,1
TALIAFERRO,4/17/2020,0,1,0,1
TALIAFERRO,4/18/2020,0,1,0,1
TALIAFERRO,4/19/2020,0,1,0,1
TALIAFERRO,4/20/2020,0,1,0,1
TALIAFERRO,4/21/2020,0,1,0,1
TALIAFERRO,4/22/2020,0,1,0,1
TALIAFERRO,4/23/2020,0,1,0,1
TALIAFERRO,4/24/2020,0,1,0,1
TALIAFERRO,4/25/2020,0,1,0,1
TALIAFERRO,4/26/2020,0,1,0,1
TALIAFERRO,4/27/2020,0,1,0,1
TALIAFERRO,4/28/2020,0,1,0,1
TALIAFERRO,4/29/2020,1,1,0,2
TALIAFERRO,4/30/2020,1,1,0,2
TALIAFERRO,5/1/2020,1,1,0,2
TALIAFERRO,5/2/2020,1,1,0,2
TALIAFERRO,5/3/2020,1,1,0,2
TALIAFERRO,5/4/2020,2,1,0,3
TALIAFERRO,5/5/2020,2,1,0,3
TALIAFERRO,5/6/2020,2,1,0,3
TALIAFERRO,5/7/2020,2,1,0,3
TALIAFERRO,5/8/2020,2,1,0,3
TALIAFERRO,5/9/2020,2,1,0,3
TALIAFERRO,5/10/2020,2,1,0,3
TALIAFERRO,5/11/2020,2,1,0,3
TALIAFERRO,5/12/2020,2,1,0,3
TALIAFERRO,5/13/2020,2,1,0,3
TALIAFERRO,5/14/2020,2,1,0,3
TALIAFERRO,5/15/2020,2,1,0,3
TALIAFERRO,5/16/2020,2,1,0,3
TALIAFERRO,5/17/2020,2,1,0,3
TALIAFERRO,5/18/2020,2,1,0,3
TALIAFERRO,5/19/2020,2,1,0,3
TALIAFERRO,5/20/2020,2,1,0,3
TALIAFERRO,5/21/2020,2,1,0,3
TALIAFERRO,5/22/2020,2,1,0,3
TALIAFERRO,5/23/2020,2,1,0,3
TALIAFERRO,5/24/2020,2,1,0,3
TALIAFERRO,5/25/2020,2,1,0,3
TALIAFERRO,5/26/2020,2,1,0,3
TALIAFERRO,5/27/2020,2,1,0,3
TALIAFERRO,5/28/2020,2,1,0,3
TALIAFERRO,5/29/2020,2,1,0,3
TALIAFERRO,5/30/2020,2,1,0,3
TALIAFERRO,5/31/2020,2,1,0,3
SPALDING,4/14/2020,92,49,1,142
TALIAFERRO,6/1/2020,2,1,0,3
TALIAFERRO,6/2/2020,2,1,0,3
TALIAFERRO,6/3/2020,2,1,0,3
TALIAFERRO,6/4/2020,2,1,0,3
TALIAFERRO,6/5/2020,2,1,0,3
TALIAFERRO,6/6/2020,2,1,0,3
TALIAFERRO,6/7/2020,2,1,0,3
TALIAFERRO,6/8/2020,2,1,0,3
TALIAFERRO,6/9/2020,2,1,0,3
TALIAFERRO,6/10/2020,2,1,0,3
TALIAFERRO,6/11/2020,2,1,0,3
TALIAFERRO,6/12/2020,2,1,0,3
TALIAFERRO,6/13/2020,2,1,0,3
TALIAFERRO,6/14/2020,2,1,0,3
TALIAFERRO,6/15/2020,2,1,0,3
TALIAFERRO,6/16/2020,2,1,0,3
TALIAFERRO,6/17/2020,2,1,0,3
TALIAFERRO,6/18/2020,2,1,0,3
TALIAFERRO,6/19/2020,2,1,0,3
TALIAFERRO,6/20/2020,2,1,0,3
TALIAFERRO,6/21/2020,2,1,0,3
TALIAFERRO,6/22/2020,2,1,0,3
TALIAFERRO,6/23/2020,2,1,0,3
TALIAFERRO,6/24/2020,2,1,0,3
TALIAFERRO,6/25/2020,2,1,0,3
TALIAFERRO,6/26/2020,2,1,0,3
TALIAFERRO,6/27/2020,2,1,0,3
TALIAFERRO,6/28/2020,2,1,0,3
TALIAFERRO,6/29/2020,2,1,0,3
TALIAFERRO,6/30/2020,2,1,0,3
TALIAFERRO,7/1/2020,2,1,0,3
TALIAFERRO,7/2/2020,2,1,0,3
TALIAFERRO,7/3/2020,2,1,0,3
TALIAFERRO,7/4/2020,2,1,0,3
TALIAFERRO,7/5/2020,2,1,0,3
TALIAFERRO,7/6/2020,2,1,0,3
TALIAFERRO,7/7/2020,2,1,0,3
TALIAFERRO,7/8/2020,2,1,0,3
TALIAFERRO,7/9/2020,2,1,0,3
TALIAFERRO,7/10/2020,3,1,0,4
TALIAFERRO,7/11/2020,3,1,0,4
TALIAFERRO,7/12/2020,3,1,0,4
TALIAFERRO,7/13/2020,4,2,0,6
TALIAFERRO,7/14/2020,4,2,0,6
TALIAFERRO,7/15/2020,4,2,0,6
TALIAFERRO,7/16/2020,4,3,0,7
TALIAFERRO,7/17/2020,4,4,0,8
TALIAFERRO,7/18/2020,4,4,0,8
TALIAFERRO,7/19/2020,4,5,0,9
TALIAFERRO,7/20/2020,5,5,0,10
TALIAFERRO,7/21/2020,5,5,0,10
TALIAFERRO,7/22/2020,6,6,0,12
TALIAFERRO,7/23/2020,6,6,0,12
TALIAFERRO,7/24/2020,6,6,0,12
TALIAFERRO,7/25/2020,6,6,0,12
TALIAFERRO,7/26/2020,6,6,0,12
TALIAFERRO,7/27/2020,6,6,0,12
TALIAFERRO,7/28/2020,7,7,0,14
TALIAFERRO,7/29/2020,7,7,0,14
TALIAFERRO,7/30/2020,7,7,0,14
TALIAFERRO,7/31/2020,7,7,0,14
TALIAFERRO,8/1/2020,7,7,0,14
TALIAFERRO,8/2/2020,7,8,0,15
TALIAFERRO,8/3/2020,7,8,0,15
TALIAFERRO,8/4/2020,7,8,0,15
TALIAFERRO,8/5/2020,7,8,0,15
TALIAFERRO,8/6/2020,7,8,0,15
TALIAFERRO,8/7/2020,7,8,0,15
TALIAFERRO,8/8/2020,7,8,0,15
TALIAFERRO,8/9/2020,7,8,0,15
TALIAFERRO,8/10/2020,7,8,0,15
TALIAFERRO,8/11/2020,8,8,0,16
TALIAFERRO,8/12/2020,8,8,0,16
TALIAFERRO,8/13/2020,9,9,0,18
TALIAFERRO,8/14/2020,9,9,0,18
TALIAFERRO,8/15/2020,9,9,0,18
TALIAFERRO,8/16/2020,9,9,0,18
TALIAFERRO,8/17/2020,9,9,0,18
TALIAFERRO,8/18/2020,9,9,0,18
TALIAFERRO,8/19/2020,9,9,0,18
TALIAFERRO,8/20/2020,10,9,0,19
TALIAFERRO,8/21/2020,10,9,0,19
TALIAFERRO,8/22/2020,10,9,0,19
TALIAFERRO,8/23/2020,10,9,0,19
TALIAFERRO,8/24/2020,10,9,0,19
TALIAFERRO,8/25/2020,10,9,0,19
TALIAFERRO,8/26/2020,11,9,0,20
TALIAFERRO,8/27/2020,11,9,0,20
TALIAFERRO,8/28/2020,11,9,0,20
TALIAFERRO,8/29/2020,11,9,0,20
TALIAFERRO,8/30/2020,11,9,0,20
TALIAFERRO,8/31/2020,11,9,0,20
TALIAFERRO,9/1/2020,11,9,0,20
TALIAFERRO,9/2/2020,11,9,0,20
TALIAFERRO,9/3/2020,11,9,0,20
TALIAFERRO,9/4/2020,11,9,0,20
TALIAFERRO,9/5/2020,11,9,0,20
TALIAFERRO,9/6/2020,11,9,0,20
TALIAFERRO,9/7/2020,11,9,0,20
TALIAFERRO,9/8/2020,11,9,0,20
TALIAFERRO,9/9/2020,11,9,0,20
TALIAFERRO,9/10/2020,11,9,0,20
TALIAFERRO,9/11/2020,12,9,0,21
TALIAFERRO,9/12/2020,12,9,0,21
TALIAFERRO,9/13/2020,12,9,0,21
TALIAFERRO,9/14/2020,12,9,0,21
TALIAFERRO,9/15/2020,12,9,0,21
TALIAFERRO,9/16/2020,12,9,0,21
TALIAFERRO,9/17/2020,13,9,0,22
TALIAFERRO,9/18/2020,13,9,0,22
TALIAFERRO,9/19/2020,13,9,0,22
TALIAFERRO,9/20/2020,13,9,0,22
TALIAFERRO,9/21/2020,13,9,0,22
TALIAFERRO,9/22/2020,14,9,0,23
TALIAFERRO,9/23/2020,14,9,0,23
TALIAFERRO,9/24/2020,14,9,0,23
TALIAFERRO,9/25/2020,14,9,0,23
TALIAFERRO,9/26/2020,14,9,0,23
TALIAFERRO,9/27/2020,14,9,0,23
TALIAFERRO,9/28/2020,14,9,0,23
TALIAFERRO,9/29/2020,14,9,0,23
TALIAFERRO,9/30/2020,14,9,0,23
TALIAFERRO,10/1/2020,14,9,0,23
TALIAFERRO,10/2/2020,14,9,0,23
TALIAFERRO,10/3/2020,14,10,0,24
TALIAFERRO,10/4/2020,14,10,0,24
TALIAFERRO,10/5/2020,14,10,0,24
TALIAFERRO,10/6/2020,14,11,0,25
TALIAFERRO,10/7/2020,14,11,0,25
TALIAFERRO,10/8/2020,14,11,0,25
TALIAFERRO,10/9/2020,14,11,0,25
TALIAFERRO,10/10/2020,14,11,0,25
TALIAFERRO,10/11/2020,14,11,0,25
TALIAFERRO,10/12/2020,14,11,0,25
TALIAFERRO,10/13/2020,14,11,0,25
TALIAFERRO,10/14/2020,14,11,0,25
TALIAFERRO,10/15/2020,14,11,0,25
TALIAFERRO,10/16/2020,14,11,0,25
TALIAFERRO,10/17/2020,14,11,0,25
TALIAFERRO,10/18/2020,14,11,0,25
TALIAFERRO,10/19/2020,14,11,0,25
TALIAFERRO,10/20/2020,14,11,0,25
TATTNALL,1/1/2020,0,0,0,0
TATTNALL,1/2/2020,0,0,0,0
TATTNALL,1/3/2020,0,0,0,0
TATTNALL,1/4/2020,0,0,0,0
TATTNALL,1/5/2020,0,0,0,0
TATTNALL,1/6/2020,0,0,0,0
TATTNALL,1/7/2020,0,0,0,0
TATTNALL,1/8/2020,0,0,0,0
TATTNALL,1/9/2020,0,0,0,0
TATTNALL,1/10/2020,0,0,0,0
TATTNALL,1/11/2020,0,0,0,0
TATTNALL,1/12/2020,0,0,0,0
TATTNALL,1/13/2020,0,0,0,0
TATTNALL,1/14/2020,0,0,0,0
TATTNALL,1/15/2020,0,0,0,0
TATTNALL,1/16/2020,0,0,0,0
TATTNALL,1/17/2020,0,0,0,0
TATTNALL,1/18/2020,0,0,0,0
TATTNALL,1/19/2020,0,0,0,0
TATTNALL,1/20/2020,0,0,0,0
TATTNALL,1/21/2020,0,0,0,0
TATTNALL,1/22/2020,0,0,0,0
TATTNALL,1/23/2020,0,0,0,0
TATTNALL,1/24/2020,0,0,0,0
TATTNALL,1/25/2020,0,0,0,0
TATTNALL,1/26/2020,0,0,0,0
TATTNALL,1/27/2020,0,0,0,0
TATTNALL,1/28/2020,0,0,0,0
TATTNALL,1/29/2020,0,0,0,0
TATTNALL,1/30/2020,0,0,0,0
TATTNALL,1/31/2020,0,0,0,0
TATTNALL,2/1/2020,0,0,0,0
TATTNALL,2/2/2020,0,0,0,0
TATTNALL,2/3/2020,0,0,0,0
TATTNALL,2/4/2020,0,0,0,0
TATTNALL,2/5/2020,0,0,0,0
TATTNALL,2/6/2020,0,0,0,0
TATTNALL,2/7/2020,0,0,0,0
TATTNALL,2/8/2020,0,0,0,0
TATTNALL,2/9/2020,0,0,0,0
TATTNALL,2/10/2020,0,0,0,0
TATTNALL,2/11/2020,0,0,0,0
TATTNALL,2/12/2020,0,0,0,0
TATTNALL,2/13/2020,0,0,0,0
TATTNALL,2/14/2020,0,0,0,0
TATTNALL,2/15/2020,0,0,0,0
TATTNALL,2/16/2020,0,0,0,0
TATTNALL,2/17/2020,0,0,0,0
TATTNALL,2/18/2020,0,0,0,0
TATTNALL,2/19/2020,0,0,0,0
TATTNALL,2/20/2020,0,0,0,0
TATTNALL,2/21/2020,0,0,0,0
TATTNALL,2/22/2020,0,0,0,0
TATTNALL,2/23/2020,0,0,0,0
TATTNALL,2/24/2020,0,0,0,0
TATTNALL,2/25/2020,0,0,0,0
TATTNALL,2/26/2020,0,0,0,0
TATTNALL,2/27/2020,0,0,0,0
TATTNALL,2/28/2020,0,0,0,0
TATTNALL,2/29/2020,0,0,0,0
TATTNALL,3/1/2020,0,0,0,0
TATTNALL,3/2/2020,0,0,0,0
TATTNALL,3/3/2020,0,0,0,0
TATTNALL,3/4/2020,0,0,0,0
TATTNALL,3/5/2020,0,0,0,0
TATTNALL,3/6/2020,0,0,0,0
TATTNALL,3/7/2020,0,0,0,0
TATTNALL,3/8/2020,0,0,0,0
TATTNALL,3/9/2020,0,0,0,0
TATTNALL,3/10/2020,0,0,0,0
TATTNALL,3/11/2020,0,0,0,0
TATTNALL,3/12/2020,0,0,0,0
TATTNALL,3/13/2020,0,0,0,0
TATTNALL,3/14/2020,0,0,0,0
TATTNALL,3/15/2020,0,1,0,1
TATTNALL,3/16/2020,0,1,0,1
TATTNALL,3/17/2020,0,1,0,1
TATTNALL,3/18/2020,0,1,0,1
TATTNALL,3/19/2020,0,1,0,1
TATTNALL,3/20/2020,0,2,0,2
TATTNALL,3/21/2020,0,3,0,3
TATTNALL,3/22/2020,0,3,0,3
TATTNALL,3/23/2020,0,3,0,3
TATTNALL,3/24/2020,0,3,0,3
TATTNALL,3/25/2020,0,3,0,3
TATTNALL,3/26/2020,0,3,0,3
TATTNALL,3/27/2020,0,3,0,3
TATTNALL,3/28/2020,0,4,0,4
TATTNALL,3/29/2020,0,4,0,4
TATTNALL,3/30/2020,0,4,0,4
TATTNALL,3/31/2020,0,4,0,4
TATTNALL,4/1/2020,0,4,0,4
TATTNALL,4/2/2020,1,4,0,5
TATTNALL,4/3/2020,1,4,0,5
TATTNALL,4/4/2020,1,4,0,5
TATTNALL,4/5/2020,1,4,0,5
TATTNALL,4/6/2020,1,4,0,5
TATTNALL,4/7/2020,1,5,0,6
TATTNALL,4/8/2020,1,5,0,6
TATTNALL,4/9/2020,1,5,0,6
TATTNALL,4/10/2020,2,5,0,7
TATTNALL,4/11/2020,2,5,0,7
TATTNALL,4/12/2020,2,5,0,7
TATTNALL,4/13/2020,3,5,0,8
TATTNALL,4/14/2020,3,6,0,9
TATTNALL,4/15/2020,3,6,0,9
TATTNALL,4/16/2020,3,6,0,9
TATTNALL,4/17/2020,3,6,0,9
TATTNALL,4/18/2020,3,6,0,9
TATTNALL,4/19/2020,3,6,0,9
TATTNALL,4/20/2020,3,7,0,10
TATTNALL,4/21/2020,4,7,0,11
TATTNALL,4/22/2020,4,7,0,11
TATTNALL,4/23/2020,4,7,0,11
TATTNALL,4/24/2020,4,7,0,11
TATTNALL,4/25/2020,4,8,0,12
TATTNALL,4/26/2020,4,8,0,12
TATTNALL,4/27/2020,4,8,0,12
TATTNALL,4/28/2020,4,8,0,12
TATTNALL,4/29/2020,4,8,0,12
TATTNALL,4/30/2020,4,8,0,12
TATTNALL,5/1/2020,4,8,0,12
TATTNALL,5/2/2020,4,9,0,13
TATTNALL,5/3/2020,4,9,0,13
TATTNALL,5/4/2020,4,9,0,13
TATTNALL,5/5/2020,4,9,0,13
TATTNALL,5/6/2020,4,9,0,13
TATTNALL,5/7/2020,4,9,0,13
STEWART,7/29/2020,107,235,0,342
SCHLEY,7/5/2020,21,10,0,31
SCREVEN,10/19/2020,258,183,4,445
STEWART,7/30/2020,109,235,0,344
STEWART,7/31/2020,110,236,0,346
SPALDING,4/15/2020,93,51,1,145
SCHLEY,7/6/2020,21,12,0,33
SCREVEN,10/20/2020,258,183,4,445
STEWART,8/1/2020,110,237,0,347
SPALDING,4/16/2020,95,51,1,147
SCHLEY,7/7/2020,21,12,0,33
SEMINOLE,1/1/2020,0,0,0,0
STEWART,8/2/2020,110,239,0,349
SPALDING,4/17/2020,96,52,1,149
SCHLEY,7/8/2020,21,12,0,33
SEMINOLE,1/2/2020,0,0,0,0
STEWART,8/3/2020,110,241,0,351
SPALDING,4/18/2020,97,52,1,150
SPALDING,4/19/2020,97,53,1,151
SPALDING,4/20/2020,98,53,1,152
SPALDING,4/21/2020,101,54,1,156
SPALDING,4/22/2020,131,64,1,196
SPALDING,4/23/2020,133,64,1,198
SPALDING,4/24/2020,136,67,1,204
SPALDING,4/25/2020,138,68,1,207
SPALDING,4/26/2020,138,69,1,208
SPALDING,4/27/2020,140,71,1,212
SPALDING,4/28/2020,150,71,1,222
SPALDING,4/29/2020,153,72,1,226
SPALDING,4/30/2020,155,73,1,229
SPALDING,5/1/2020,158,75,1,234
SPALDING,5/2/2020,160,75,1,236
SPALDING,5/3/2020,164,75,1,240
SPALDING,5/4/2020,164,75,1,240
SPALDING,5/5/2020,166,77,1,244
SPALDING,5/6/2020,167,78,1,246
SPALDING,5/7/2020,167,78,1,246
SPALDING,5/8/2020,169,79,1,249
SPALDING,5/9/2020,170,79,1,250
SPALDING,5/10/2020,171,79,1,251
SPALDING,5/11/2020,173,81,1,255
SPALDING,5/12/2020,176,82,1,259
SPALDING,5/13/2020,179,83,1,263
SPALDING,5/14/2020,179,83,1,263
SPALDING,5/15/2020,182,89,1,272
SPALDING,5/16/2020,185,91,1,277
SPALDING,5/17/2020,191,94,1,286
SPALDING,5/18/2020,191,94,1,286
SPALDING,5/19/2020,195,97,1,293
SPALDING,5/20/2020,196,97,1,294
SPALDING,5/21/2020,198,97,1,296
SPALDING,5/22/2020,201,99,1,301
SPALDING,5/23/2020,202,99,1,302
SPALDING,5/24/2020,202,99,1,302
SPALDING,5/25/2020,202,99,1,302
SPALDING,5/26/2020,206,101,1,308
SPALDING,5/27/2020,207,101,1,309
SPALDING,5/28/2020,209,104,1,314
SPALDING,5/29/2020,210,105,1,316
SPALDING,5/30/2020,210,105,1,316
SPALDING,5/31/2020,211,106,1,318
SPALDING,6/1/2020,213,110,1,324
SPALDING,6/2/2020,214,112,1,327
SPALDING,6/3/2020,217,113,1,331
SPALDING,6/4/2020,218,113,1,332
SPALDING,6/5/2020,220,115,1,336
SPALDING,6/6/2020,221,117,1,339
SPALDING,6/7/2020,224,117,1,342
SPALDING,6/8/2020,227,119,1,347
SPALDING,6/9/2020,229,121,1,351
SPALDING,6/10/2020,232,121,1,354
SPALDING,6/11/2020,234,122,1,357
SPALDING,6/12/2020,235,125,1,361
SPALDING,6/13/2020,237,126,1,364
SPALDING,6/14/2020,237,128,1,366
SPALDING,6/15/2020,239,133,1,373
SPALDING,6/16/2020,242,136,1,379
SPALDING,6/17/2020,245,139,1,385
SPALDING,6/18/2020,249,140,1,390
SPALDING,6/19/2020,253,142,1,396
SPALDING,6/20/2020,257,145,1,403
SPALDING,6/21/2020,262,148,1,411
SPALDING,6/22/2020,268,157,1,426
SPALDING,6/23/2020,269,164,1,434
SPALDING,6/24/2020,274,174,1,449
SPALDING,6/25/2020,277,174,1,452
SPALDING,6/26/2020,288,181,1,470
SPALDING,6/27/2020,293,183,1,477
SPALDING,6/28/2020,296,186,1,483
SPALDING,6/29/2020,303,190,1,494
SPALDING,6/30/2020,311,197,1,509
SPALDING,7/1/2020,321,209,1,531
SPALDING,7/2/2020,330,214,1,545
SPALDING,7/3/2020,335,223,1,559
SPALDING,7/4/2020,340,230,1,571
SPALDING,7/5/2020,346,234,1,581
SPALDING,7/6/2020,359,241,1,601
SPALDING,7/7/2020,367,248,1,616
SPALDING,7/8/2020,379,252,1,632
SPALDING,7/9/2020,383,259,2,644
SPALDING,7/10/2020,390,262,2,654
SPALDING,7/11/2020,393,265,2,660
SPALDING,7/12/2020,398,270,2,670
SPALDING,7/13/2020,416,280,2,698
SPALDING,7/14/2020,423,286,2,711
SPALDING,7/15/2020,430,296,2,728
SPALDING,7/16/2020,435,303,2,740
SPALDING,7/17/2020,441,308,2,751
SPALDING,7/18/2020,447,313,2,762
SPALDING,7/19/2020,450,319,2,771
SPALDING,7/20/2020,463,329,2,794
SPALDING,7/21/2020,468,337,2,807
SPALDING,7/22/2020,477,342,2,821
SPALDING,7/23/2020,487,344,2,833
SPALDING,7/24/2020,499,351,2,852
SPALDING,7/25/2020,502,357,2,861
SPALDING,7/26/2020,505,360,2,867
SPALDING,7/27/2020,515,370,2,887
SPALDING,7/28/2020,526,378,2,906
SPALDING,7/29/2020,531,386,2,919
SPALDING,7/30/2020,546,392,2,940
SPALDING,7/31/2020,551,395,3,949
SPALDING,8/1/2020,555,398,3,956
SPALDING,8/2/2020,557,404,3,964
SPALDING,8/3/2020,562,408,3,973
SPALDING,8/4/2020,572,410,3,985
SPALDING,8/5/2020,581,414,3,998
SPALDING,8/6/2020,586,417,3,1006
SPALDING,8/7/2020,593,423,3,1019
SPALDING,8/8/2020,602,427,3,1032
SPALDING,8/9/2020,609,430,3,1042
SPALDING,8/10/2020,622,439,3,1064
SPALDING,8/11/2020,629,440,3,1072
SPALDING,8/12/2020,635,442,3,1080
SPALDING,8/13/2020,640,445,3,1088
SPALDING,8/14/2020,646,451,3,1100
SPALDING,8/15/2020,649,452,3,1104
SPALDING,8/16/2020,654,453,3,1110
SPALDING,8/17/2020,662,459,4,1125
SPALDING,8/18/2020,665,462,4,1131
SPALDING,8/19/2020,672,465,4,1141
SPALDING,8/20/2020,672,468,4,1144
SPALDING,8/21/2020,688,475,4,1167
SPALDING,8/22/2020,690,477,4,1171
SPALDING,8/23/2020,697,477,4,1178
SPALDING,8/24/2020,708,484,4,1196
SPALDING,8/25/2020,714,485,4,1203
SPALDING,8/26/2020,717,489,4,1210
SPALDING,8/27/2020,718,493,4,1215
SPALDING,8/28/2020,721,494,4,1219
SPALDING,8/29/2020,726,495,4,1225
SPALDING,8/30/2020,728,497,4,1229
SPALDING,8/31/2020,732,501,4,1237
SPALDING,9/1/2020,735,503,4,1242
SPALDING,9/2/2020,739,503,4,1246
SPALDING,9/3/2020,741,504,4,1249
SPALDING,9/4/2020,744,509,4,1257
SPALDING,9/5/2020,746,510,4,1260
SPALDING,9/6/2020,748,510,5,1263
SPALDING,9/7/2020,749,514,5,1268
SPALDING,9/8/2020,751,518,5,1274
SPALDING,9/9/2020,753,520,5,1278
SPALDING,9/10/2020,754,523,5,1282
SPALDING,9/11/2020,757,524,5,1286
SPALDING,9/12/2020,758,524,5,1287
SPALDING,9/13/2020,762,526,5,1293
SPALDING,9/14/2020,763,528,5,1296
SPALDING,9/15/2020,765,531,5,1301
SPALDING,9/16/2020,768,533,5,1306
SPALDING,9/17/2020,772,534,5,1311
SPALDING,9/18/2020,778,537,5,1320
SPALDING,9/19/2020,782,539,5,1326
SPALDING,9/20/2020,787,541,5,1333
SPALDING,9/21/2020,789,547,5,1341
SPALDING,9/22/2020,797,550,5,1352
SPALDING,9/23/2020,797,553,5,1355
SPALDING,9/24/2020,799,555,5,1359
SPALDING,9/25/2020,799,557,5,1361
SPALDING,9/26/2020,800,557,5,1362
SPALDING,9/27/2020,800,557,5,1362
SPALDING,9/28/2020,801,563,5,1369
SPALDING,9/29/2020,803,564,5,1372
SPALDING,9/30/2020,809,566,5,1380
SPALDING,10/1/2020,813,568,5,1386
SPALDING,10/2/2020,820,573,7,1400
SPALDING,10/3/2020,823,575,7,1405
SPALDING,10/4/2020,827,575,7,1409
SPALDING,10/5/2020,830,579,7,1416
SPALDING,10/6/2020,831,586,7,1424
SPALDING,10/7/2020,838,588,7,1433
SPALDING,10/8/2020,840,591,7,1438
SPALDING,10/9/2020,845,598,7,1450
SPALDING,10/10/2020,850,601,7,1458
SPALDING,10/11/2020,852,603,7,1462
SPALDING,10/12/2020,857,605,7,1469
SPALDING,10/13/2020,859,607,7,1473
SPALDING,10/14/2020,862,609,7,1478
SPALDING,10/15/2020,868,615,7,1490
SPALDING,10/16/2020,871,619,7,1497
SPALDING,10/17/2020,873,621,7,1501
SPALDING,10/18/2020,874,622,7,1503
SPALDING,10/19/2020,875,622,7,1504
SPALDING,10/20/2020,875,622,7,1504
STEWART,1/1/2020,0,0,0,0
STEWART,1/2/2020,0,0,0,0
STEWART,1/3/2020,0,0,0,0
STEWART,1/4/2020,0,0,0,0
STEWART,1/5/2020,0,0,0,0
STEWART,1/6/2020,0,0,0,0
STEWART,1/7/2020,0,0,0,0
STEWART,1/8/2020,0,0,0,0
STEWART,1/9/2020,0,0,0,0
STEWART,1/10/2020,0,0,0,0
STEWART,1/11/2020,0,0,0,0
STEWART,1/12/2020,0,0,0,0
STEWART,1/13/2020,0,0,0,0
STEWART,1/14/2020,0,0,0,0
STEWART,1/15/2020,0,0,0,0
STEWART,1/16/2020,0,0,0,0
STEWART,1/17/2020,0,0,0,0
STEWART,1/18/2020,0,0,0,0
STEWART,1/19/2020,0,0,0,0
STEWART,1/20/2020,0,0,0,0
STEWART,1/21/2020,0,0,0,0
STEWART,1/22/2020,0,0,0,0
STEWART,1/23/2020,0,0,0,0
STEWART,1/24/2020,0,0,0,0
STEWART,1/25/2020,0,0,0,0
STEWART,1/26/2020,0,0,0,0
STEWART,1/27/2020,0,0,0,0
STEWART,1/28/2020,0,0,0,0
STEWART,1/29/2020,0,0,0,0
STEWART,1/30/2020,0,0,0,0
STEWART,1/31/2020,0,0,0,0
STEWART,2/1/2020,0,0,0,0
STEWART,2/2/2020,0,0,0,0
STEWART,2/3/2020,0,0,0,0
STEWART,2/4/2020,0,0,0,0
STEWART,2/5/2020,0,0,0,0
STEWART,2/6/2020,0,0,0,0
STEWART,2/7/2020,0,0,0,0
STEWART,2/8/2020,0,0,0,0
STEWART,2/9/2020,0,0,0,0
STEWART,2/10/2020,0,0,0,0
STEWART,2/11/2020,0,0,0,0
STEWART,2/12/2020,0,0,0,0
STEWART,2/13/2020,0,0,0,0
STEWART,2/14/2020,0,0,0,0
STEWART,2/15/2020,0,0,0,0
STEWART,2/16/2020,0,0,0,0
STEWART,2/17/2020,0,0,0,0
STEWART,2/18/2020,0,0,0,0
STEWART,2/19/2020,0,1,0,1
STEWART,2/20/2020,0,1,0,1
STEWART,2/21/2020,0,1,0,1
STEWART,2/22/2020,0,1,0,1
STEWART,2/23/2020,0,1,0,1
STEWART,2/24/2020,0,1,0,1
STEWART,2/25/2020,0,1,0,1
STEWART,2/26/2020,0,1,0,1
STEWART,2/27/2020,0,1,0,1
STEWART,2/28/2020,0,1,0,1
STEWART,2/29/2020,0,1,0,1
STEWART,3/1/2020,0,1,0,1
STEWART,3/2/2020,0,1,0,1
STEWART,3/3/2020,0,1,0,1
STEWART,3/4/2020,0,1,0,1
STEWART,3/5/2020,0,1,0,1
STEWART,3/6/2020,0,1,0,1
STEWART,3/7/2020,0,1,0,1
STEWART,3/8/2020,0,1,0,1
STEWART,3/9/2020,0,1,0,1
STEWART,3/10/2020,0,1,0,1
STEWART,3/11/2020,0,1,0,1
STEWART,3/12/2020,0,1,0,1
STEWART,3/13/2020,0,1,0,1
STEWART,3/14/2020,0,1,0,1
STEWART,3/15/2020,0,1,0,1
STEWART,3/16/2020,0,1,0,1
STEWART,3/17/2020,0,1,0,1
STEWART,3/18/2020,0,1,0,1
STEWART,3/19/2020,0,1,0,1
STEWART,3/20/2020,0,1,0,1
STEWART,3/21/2020,0,1,0,1
STEWART,3/22/2020,0,1,0,1
STEWART,3/23/2020,0,1,0,1
STEWART,3/24/2020,0,1,0,1
STEWART,3/25/2020,1,1,0,2
STEWART,3/26/2020,1,2,0,3
STEWART,3/27/2020,1,2,0,3
STEWART,3/28/2020,1,2,0,3
STEWART,3/29/2020,1,2,0,3
STEWART,3/30/2020,1,2,0,3
STEWART,3/31/2020,1,2,0,3
STEWART,4/1/2020,1,2,0,3
STEWART,4/2/2020,1,2,0,3
STEWART,4/3/2020,1,3,0,4
STEWART,4/4/2020,2,3,0,5
STEWART,4/5/2020,2,3,0,5
STEWART,4/6/2020,2,4,0,6
STEWART,4/7/2020,2,6,0,8
STEWART,4/8/2020,2,8,0,10
STEWART,4/9/2020,2,8,0,10
STEWART,4/10/2020,2,9,0,11
STEWART,4/11/2020,3,10,0,13
STEWART,4/12/2020,3,10,0,13
STEWART,4/13/2020,4,11,0,15
STEWART,4/14/2020,4,11,0,15
STEWART,4/15/2020,5,11,0,16
STEWART,4/16/2020,5,12,0,17
STEWART,4/17/2020,6,13,0,19
STEWART,4/18/2020,6,13,0,19
STEWART,4/19/2020,6,13,0,19
STEWART,4/20/2020,7,13,0,20
STEWART,4/21/2020,7,13,0,20
STEWART,4/22/2020,7,14,0,21
STEWART,4/23/2020,8,15,0,23
STEWART,4/24/2020,8,16,0,24
STEWART,4/25/2020,8,16,0,24
STEWART,4/26/2020,8,16,0,24
STEWART,4/27/2020,9,16,0,25
STEWART,4/28/2020,10,16,0,26
STEWART,4/29/2020,11,18,0,29
STEWART,4/30/2020,12,18,0,30
STEWART,5/1/2020,13,18,0,31
STEWART,5/2/2020,13,18,0,31
STEWART,5/3/2020,16,21,0,37
STEWART,5/4/2020,18,21,0,39
STEWART,5/5/2020,18,21,0,39
STEWART,5/6/2020,18,21,0,39
STEWART,5/7/2020,19,21,0,40
STEWART,5/8/2020,20,22,0,42
STEWART,5/9/2020,20,23,0,43
STEWART,5/10/2020,20,23,0,43
STEWART,5/11/2020,22,23,0,45
STEWART,5/12/2020,22,23,0,45
STEWART,5/13/2020,24,24,0,48
STEWART,5/14/2020,24,24,0,48
STEWART,5/15/2020,25,24,0,49
STEWART,5/16/2020,25,24,0,49
STEWART,5/17/2020,25,24,0,49
STEWART,5/18/2020,26,24,0,50
STEWART,5/19/2020,26,41,0,67
STEWART,5/20/2020,26,41,0,67
STEWART,5/21/2020,26,45,0,71
STEWART,5/22/2020,26,47,0,73
STEWART,5/23/2020,26,48,0,74
STEWART,5/24/2020,26,48,0,74
STEWART,5/25/2020,28,51,0,79
STEWART,5/26/2020,29,52,0,81
STEWART,5/27/2020,35,55,0,90
STEWART,5/28/2020,36,55,0,91
STEWART,5/29/2020,38,58,0,96
STEWART,5/30/2020,39,58,0,97
STEWART,5/31/2020,39,59,0,98
STEWART,6/1/2020,39,61,0,100
STEWART,6/2/2020,41,63,0,104
STEWART,6/3/2020,42,63,0,105
STEWART,6/4/2020,42,64,0,106
STEWART,6/5/2020,43,64,0,107
STEWART,6/6/2020,43,66,0,109
STEWART,6/7/2020,43,66,0,109
STEWART,6/8/2020,46,69,0,115
STEWART,6/9/2020,46,69,0,115
STEWART,6/10/2020,49,69,0,118
STEWART,6/11/2020,49,71,0,120
STEWART,6/12/2020,51,78,0,129
STEWART,6/13/2020,52,78,0,130
STEWART,6/14/2020,52,78,0,130
STEWART,6/15/2020,53,78,0,131
STEWART,6/16/2020,54,81,0,135
STEWART,6/17/2020,54,83,0,137
STEWART,6/18/2020,54,83,0,137
STEWART,6/19/2020,54,83,0,137
STEWART,6/20/2020,54,84,0,138
STEWART,6/21/2020,57,84,0,141
STEWART,6/22/2020,59,87,0,146
STEWART,6/23/2020,60,89,0,149
STEWART,6/24/2020,61,98,0,159
STEWART,6/25/2020,63,106,0,169
STEWART,6/26/2020,63,106,0,169
STEWART,6/27/2020,64,107,0,171
STEWART,6/28/2020,66,107,0,173
STEWART,6/29/2020,80,123,0,203
STEWART,6/30/2020,80,125,0,205
STEWART,7/1/2020,82,127,0,209
STEWART,7/2/2020,84,130,0,214
STEWART,7/3/2020,86,132,0,218
STEWART,7/4/2020,87,132,0,219
STEWART,7/5/2020,87,132,0,219
STEWART,7/6/2020,91,135,0,226
STEWART,7/7/2020,94,140,0,234
STEWART,7/8/2020,95,143,0,238
STEWART,7/9/2020,96,145,0,241
STEWART,7/10/2020,96,170,0,266
STEWART,7/11/2020,96,181,0,277
STEWART,7/12/2020,96,184,0,280
STEWART,7/13/2020,96,189,0,285
STEWART,7/14/2020,96,191,0,287
STEWART,7/15/2020,97,198,0,295
STEWART,7/16/2020,97,198,0,295
STEWART,7/17/2020,100,201,0,301
STEWART,7/18/2020,100,202,0,302
STEWART,7/19/2020,100,202,0,302
STEWART,7/20/2020,100,205,0,305
STEWART,7/21/2020,100,209,0,309
STEWART,7/22/2020,100,210,0,310
STEWART,7/23/2020,102,211,0,313
STEWART,7/24/2020,104,222,0,326
STEWART,7/25/2020,105,222,0,327
STEWART,7/26/2020,105,222,0,327
STEWART,7/27/2020,105,228,0,333
STEWART,7/28/2020,105,233,0,338
SEMINOLE,1/3/2020,0,0,0,0
SEMINOLE,1/4/2020,0,0,0,0
STEWART,8/4/2020,111,241,0,352
SEMINOLE,1/5/2020,0,0,0,0
SEMINOLE,1/6/2020,0,0,0,0
SEMINOLE,1/7/2020,0,0,0,0
SEMINOLE,1/8/2020,0,0,0,0
SEMINOLE,1/9/2020,0,0,0,0
SEMINOLE,1/10/2020,0,0,0,0
SEMINOLE,1/11/2020,0,0,0,0
SEMINOLE,1/12/2020,0,0,0,0
SEMINOLE,1/13/2020,0,0,0,0
SEMINOLE,1/14/2020,0,0,0,0
SEMINOLE,1/15/2020,0,0,0,0
SEMINOLE,1/16/2020,0,0,0,0
SEMINOLE,1/17/2020,0,0,0,0
SEMINOLE,1/18/2020,0,0,0,0
SEMINOLE,1/19/2020,0,0,0,0
SEMINOLE,1/20/2020,0,0,0,0
SEMINOLE,1/21/2020,0,0,0,0
SEMINOLE,1/22/2020,0,0,0,0
SEMINOLE,1/23/2020,0,0,0,0
SEMINOLE,1/24/2020,0,0,0,0
SEMINOLE,1/25/2020,0,0,0,0
SEMINOLE,1/26/2020,0,0,0,0
SEMINOLE,1/27/2020,0,0,0,0
SEMINOLE,1/28/2020,0,0,0,0
SEMINOLE,1/29/2020,0,0,0,0
SEMINOLE,1/30/2020,0,0,0,0
SEMINOLE,1/31/2020,0,0,0,0
SEMINOLE,2/1/2020,0,0,0,0
SEMINOLE,2/2/2020,0,0,0,0
SEMINOLE,2/3/2020,0,0,0,0
SEMINOLE,2/4/2020,0,0,0,0
SEMINOLE,2/5/2020,0,0,0,0
SEMINOLE,2/6/2020,0,0,0,0
SEMINOLE,2/7/2020,0,0,0,0
SEMINOLE,2/8/2020,0,0,0,0
SEMINOLE,2/9/2020,0,0,0,0
SEMINOLE,2/10/2020,0,0,0,0
SEMINOLE,2/11/2020,0,0,0,0
SEMINOLE,2/12/2020,0,0,0,0
SCHLEY,7/9/2020,21,12,0,33
SEMINOLE,2/13/2020,0,0,0,0
SEMINOLE,2/14/2020,0,0,0,0
SEMINOLE,2/15/2020,0,0,0,0
SEMINOLE,2/16/2020,0,0,0,0
SEMINOLE,2/17/2020,0,0,0,0
SEMINOLE,2/18/2020,0,0,0,0
SEMINOLE,2/19/2020,0,0,0,0
SEMINOLE,2/20/2020,0,0,0,0
SEMINOLE,2/21/2020,0,0,0,0
SEMINOLE,2/22/2020,0,0,0,0
SEMINOLE,2/23/2020,0,0,0,0
SEMINOLE,2/24/2020,0,0,0,0
SEMINOLE,2/25/2020,0,0,0,0
SEMINOLE,2/26/2020,0,0,0,0
SEMINOLE,2/27/2020,0,0,0,0
SEMINOLE,2/28/2020,0,0,0,0
SEMINOLE,2/29/2020,0,0,0,0
SEMINOLE,3/1/2020,0,0,0,0
SEMINOLE,3/2/2020,0,0,0,0
SEMINOLE,3/3/2020,0,0,0,0
SEMINOLE,3/4/2020,0,0,0,0
SEMINOLE,3/5/2020,0,0,0,0
SEMINOLE,3/6/2020,0,0,0,0
SEMINOLE,3/7/2020,0,0,0,0
SEMINOLE,3/8/2020,0,0,0,0
SEMINOLE,3/9/2020,0,0,0,0
SEMINOLE,3/10/2020,0,0,0,0
SEMINOLE,3/11/2020,0,0,0,0
SEMINOLE,3/12/2020,0,0,0,0
SEMINOLE,3/13/2020,0,0,0,0
SEMINOLE,3/14/2020,1,0,0,1
SEMINOLE,3/15/2020,1,0,0,1
SEMINOLE,3/16/2020,1,0,0,1
SEMINOLE,3/17/2020,1,0,0,1
SEMINOLE,3/18/2020,1,0,0,1
SEMINOLE,3/19/2020,1,1,0,2
SEMINOLE,3/20/2020,1,1,0,2
SEMINOLE,3/21/2020,2,1,0,3
SEMINOLE,3/22/2020,3,1,0,4
SEMINOLE,3/23/2020,3,1,0,4
SEMINOLE,3/24/2020,3,1,0,4
SEMINOLE,3/25/2020,3,1,0,4
SEMINOLE,3/26/2020,3,2,0,5
SEMINOLE,3/27/2020,3,3,0,6
SEMINOLE,3/28/2020,3,3,0,6
SEMINOLE,3/29/2020,5,3,0,8
SEMINOLE,3/30/2020,5,4,0,9
SEMINOLE,3/31/2020,5,4,0,9
SEMINOLE,4/1/2020,5,4,0,9
SEMINOLE,4/2/2020,5,5,0,10
SEMINOLE,4/3/2020,5,5,0,10
SEMINOLE,4/4/2020,6,6,0,12
SEMINOLE,4/5/2020,6,6,0,12
SEMINOLE,4/6/2020,6,6,0,12
SEMINOLE,4/7/2020,6,6,0,12
SEMINOLE,4/8/2020,7,6,0,13
SEMINOLE,4/9/2020,7,8,0,15
SEMINOLE,4/10/2020,8,8,0,16
SEMINOLE,4/11/2020,8,8,0,16
SEMINOLE,4/12/2020,9,8,0,17
SEMINOLE,4/13/2020,10,8,0,18
SEMINOLE,4/14/2020,13,8,0,21
SEMINOLE,4/15/2020,13,8,0,21
SEMINOLE,4/16/2020,13,8,0,21
SEMINOLE,4/17/2020,14,9,0,23
SEMINOLE,4/18/2020,14,9,0,23
SEMINOLE,4/19/2020,14,9,0,23
SEMINOLE,4/20/2020,14,10,0,24
SEMINOLE,4/21/2020,14,11,0,25
SEMINOLE,4/22/2020,14,11,0,25
SEMINOLE,4/23/2020,15,11,0,26
SEMINOLE,4/24/2020,15,12,0,27
SEMINOLE,4/25/2020,16,12,0,28
SEMINOLE,4/26/2020,16,12,0,28
SEMINOLE,4/27/2020,16,12,0,28
SEMINOLE,4/28/2020,16,12,0,28
SEMINOLE,4/29/2020,16,12,0,28
SEMINOLE,4/30/2020,18,12,0,30
SEMINOLE,5/1/2020,19,12,0,31
SEMINOLE,5/2/2020,19,12,0,31
SEMINOLE,5/3/2020,19,13,0,32
SEMINOLE,5/4/2020,20,13,0,33
SEMINOLE,5/5/2020,21,13,0,34
SEMINOLE,5/6/2020,22,14,0,36
SEMINOLE,5/7/2020,22,14,0,36
SEMINOLE,5/8/2020,22,14,0,36
SEMINOLE,5/9/2020,22,14,0,36
SEMINOLE,5/10/2020,22,14,0,36
SEMINOLE,5/11/2020,22,17,0,39
SEMINOLE,5/12/2020,24,17,0,41
SEMINOLE,5/13/2020,24,17,0,41
SEMINOLE,5/14/2020,24,17,0,41
SEMINOLE,5/15/2020,24,18,0,42
SEMINOLE,5/16/2020,24,18,0,42
SEMINOLE,5/17/2020,24,18,0,42
SEMINOLE,5/18/2020,24,18,0,42
SEMINOLE,5/19/2020,24,19,0,43
SEMINOLE,5/20/2020,24,19,0,43
SEMINOLE,5/21/2020,25,19,0,44
SEMINOLE,5/22/2020,25,19,0,44
SEMINOLE,5/23/2020,25,19,0,44
SEMINOLE,5/24/2020,25,19,0,44
SEMINOLE,5/25/2020,25,19,0,44
SEMINOLE,5/26/2020,25,19,0,44
SEMINOLE,5/27/2020,27,20,0,47
SEMINOLE,5/28/2020,27,20,0,47
SEMINOLE,5/29/2020,27,21,0,48
SEMINOLE,5/30/2020,27,21,0,48
SEMINOLE,5/31/2020,27,21,0,48
SEMINOLE,6/1/2020,27,21,0,48
SEMINOLE,6/2/2020,28,21,0,49
SEMINOLE,6/3/2020,28,22,0,50
SEMINOLE,6/4/2020,28,22,0,50
SEMINOLE,6/5/2020,28,22,0,50
SEMINOLE,6/6/2020,28,22,0,50
SEMINOLE,6/7/2020,28,22,0,50
SEMINOLE,6/8/2020,28,22,0,50
SEMINOLE,6/9/2020,28,22,0,50
SEMINOLE,6/10/2020,28,22,0,50
SEMINOLE,6/11/2020,28,22,0,50
SEMINOLE,6/12/2020,28,22,0,50
SEMINOLE,6/13/2020,28,22,0,50
SEMINOLE,6/14/2020,28,22,0,50
SEMINOLE,6/15/2020,28,22,0,50
SEMINOLE,6/16/2020,28,22,0,50
SEMINOLE,6/17/2020,28,22,0,50
SEMINOLE,6/18/2020,28,22,0,50
SEMINOLE,6/19/2020,28,22,0,50
SEMINOLE,6/20/2020,28,22,0,50
SEMINOLE,6/21/2020,28,22,0,50
SEMINOLE,6/22/2020,29,22,0,51
SEMINOLE,6/23/2020,29,23,0,52
SEMINOLE,6/24/2020,29,23,0,52
SEMINOLE,6/25/2020,29,23,0,52
SEMINOLE,6/26/2020,29,23,0,52
SEMINOLE,6/27/2020,29,23,0,52
SEMINOLE,6/28/2020,29,23,0,52
SEMINOLE,6/29/2020,31,24,0,55
SEMINOLE,6/30/2020,33,24,0,57
SEMINOLE,7/1/2020,33,24,0,57
SEMINOLE,7/2/2020,33,24,0,57
SEMINOLE,7/3/2020,33,24,0,57
SEMINOLE,7/4/2020,33,25,0,58
SEMINOLE,7/5/2020,34,26,0,60
SEMINOLE,7/6/2020,34,27,0,61
SEMINOLE,7/7/2020,34,27,0,61
SEMINOLE,7/8/2020,36,27,0,63
SEMINOLE,7/9/2020,38,29,0,67
SEMINOLE,7/10/2020,40,32,0,72
SEMINOLE,7/11/2020,40,32,0,72
SEMINOLE,7/12/2020,40,32,0,72
SEMINOLE,7/13/2020,42,36,0,78
SEMINOLE,7/14/2020,43,37,0,80
SEMINOLE,7/15/2020,45,38,0,83
SEMINOLE,7/16/2020,48,40,0,88
SEMINOLE,7/17/2020,50,42,0,92
SEMINOLE,7/18/2020,50,42,0,92
SEMINOLE,7/19/2020,51,44,0,95
SEMINOLE,7/20/2020,55,47,0,102
SEMINOLE,7/21/2020,58,48,0,106
SEMINOLE,7/22/2020,61,50,0,111
SEMINOLE,7/23/2020,65,52,0,117
SEMINOLE,7/24/2020,71,57,0,128
SEMINOLE,7/25/2020,73,59,0,132
SEMINOLE,7/26/2020,74,59,0,133
SEMINOLE,7/27/2020,83,63,1,147
SEMINOLE,7/28/2020,86,71,1,158
SEMINOLE,7/29/2020,89,76,1,166
SEMINOLE,7/30/2020,93,78,1,172
SEMINOLE,7/31/2020,102,85,1,188
SEMINOLE,8/1/2020,103,87,2,192
SEMINOLE,8/2/2020,106,88,2,196
SEMINOLE,8/3/2020,111,90,2,203
SEMINOLE,8/4/2020,115,91,2,208
SEMINOLE,8/5/2020,119,95,2,216
SEMINOLE,8/6/2020,122,97,3,222
SEMINOLE,8/7/2020,129,103,3,235
SEMINOLE,8/8/2020,130,103,3,236
SEMINOLE,8/9/2020,130,103,3,236
SEMINOLE,8/10/2020,133,107,3,243
SEMINOLE,8/11/2020,134,111,3,248
SEMINOLE,8/12/2020,136,116,3,255
SEMINOLE,8/13/2020,136,118,3,257
SEMINOLE,8/14/2020,140,120,3,263
SEMINOLE,8/15/2020,142,120,3,265
SEMINOLE,8/16/2020,144,120,3,267
SEMINOLE,8/17/2020,144,120,3,267
SEMINOLE,8/18/2020,148,122,3,273
SEMINOLE,8/19/2020,148,122,3,273
SEMINOLE,8/20/2020,150,124,3,277
SEMINOLE,8/21/2020,150,124,3,277
SEMINOLE,8/22/2020,152,124,3,279
SEMINOLE,8/23/2020,152,124,3,279
SEMINOLE,8/24/2020,158,125,3,286
SEMINOLE,8/25/2020,160,127,3,290
SEMINOLE,8/26/2020,163,128,3,294
SEMINOLE,8/27/2020,163,129,3,295
SEMINOLE,8/28/2020,166,132,3,301
SEMINOLE,8/29/2020,167,132,3,302
SEMINOLE,8/30/2020,168,132,3,303
SEMINOLE,8/31/2020,168,134,3,305
SEMINOLE,9/1/2020,168,135,3,306
SEMINOLE,9/2/2020,175,137,3,315
SEMINOLE,9/3/2020,179,141,3,323
SEMINOLE,9/4/2020,181,142,3,326
SEMINOLE,9/5/2020,181,142,3,326
SEMINOLE,9/6/2020,181,142,3,326
SEMINOLE,9/7/2020,183,142,3,328
SEMINOLE,9/8/2020,184,143,3,330
SEMINOLE,9/9/2020,185,144,3,332
SEMINOLE,9/10/2020,186,148,3,337
SEMINOLE,9/11/2020,192,148,3,343
SEMINOLE,9/12/2020,193,148,3,344
SEMINOLE,9/13/2020,193,149,3,345
SEMINOLE,9/14/2020,193,150,3,346
SEMINOLE,9/15/2020,194,152,3,349
SEMINOLE,9/16/2020,196,152,3,351
SEMINOLE,9/17/2020,197,153,3,353
SEMINOLE,9/18/2020,199,155,3,357
SEMINOLE,9/19/2020,199,155,3,357
SEMINOLE,9/20/2020,201,155,3,359
SEMINOLE,9/21/2020,201,156,3,360
SEMINOLE,9/22/2020,203,156,3,362
SEMINOLE,9/23/2020,204,156,3,363
SEMINOLE,9/24/2020,204,156,3,363
SEMINOLE,9/25/2020,206,156,3,365
SEMINOLE,9/26/2020,207,156,3,366
SEMINOLE,9/27/2020,207,156,3,366
SEMINOLE,9/28/2020,208,157,3,368
SEMINOLE,9/29/2020,209,157,3,369
SEMINOLE,9/30/2020,210,158,3,371
SEMINOLE,10/1/2020,211,158,3,372
SEMINOLE,10/2/2020,211,159,3,373
SEMINOLE,10/3/2020,211,159,3,373
SEMINOLE,10/4/2020,211,160,3,374
SEMINOLE,10/5/2020,211,160,3,374
SEMINOLE,10/6/2020,212,160,3,375
SEMINOLE,10/7/2020,213,160,3,376
SEMINOLE,10/8/2020,213,161,3,377
SEMINOLE,10/9/2020,213,162,3,378
SEMINOLE,10/10/2020,213,162,3,378
SEMINOLE,10/11/2020,213,163,3,379
SEMINOLE,10/12/2020,213,163,3,379
SEMINOLE,10/13/2020,214,164,3,381
SEMINOLE,10/14/2020,214,165,3,382
SEMINOLE,10/15/2020,214,165,3,382
SEMINOLE,10/16/2020,214,166,3,383
SEMINOLE,10/17/2020,214,166,3,383
SEMINOLE,10/18/2020,214,166,3,383
SEMINOLE,10/19/2020,214,166,3,383
SEMINOLE,10/20/2020,214,166,3,383
SPALDING,1/1/2020,0,0,0,0
SPALDING,1/2/2020,0,0,0,0
SPALDING,1/3/2020,0,0,0,0
SPALDING,1/4/2020,0,0,0,0
SPALDING,1/5/2020,0,0,0,0
SPALDING,1/6/2020,0,0,0,0
SPALDING,1/7/2020,0,0,0,0
SPALDING,1/8/2020,0,0,0,0
SPALDING,1/9/2020,0,0,0,0
SPALDING,1/10/2020,0,0,0,0
SPALDING,1/11/2020,0,0,0,0
SPALDING,1/12/2020,0,0,0,0
SPALDING,1/13/2020,0,0,0,0
SPALDING,1/14/2020,0,0,0,0
SPALDING,1/15/2020,0,0,0,0
SPALDING,1/16/2020,0,0,0,0
SPALDING,1/17/2020,0,0,0,0
SPALDING,1/18/2020,0,0,0,0
SPALDING,1/19/2020,0,0,0,0
SPALDING,1/20/2020,0,0,0,0
SPALDING,1/21/2020,0,0,0,0
SPALDING,1/22/2020,0,0,0,0
SPALDING,1/23/2020,0,0,0,0
SPALDING,1/24/2020,0,0,0,0
SPALDING,1/25/2020,0,0,0,0
SPALDING,1/26/2020,0,0,0,0
SPALDING,1/27/2020,0,0,0,0
SPALDING,1/28/2020,0,0,0,0
SPALDING,1/29/2020,0,0,0,0
SPALDING,1/30/2020,0,0,0,0
SPALDING,1/31/2020,0,0,0,0
SPALDING,2/1/2020,0,0,0,0
SPALDING,2/2/2020,0,0,0,0
SPALDING,2/3/2020,0,0,0,0
SPALDING,2/4/2020,0,0,0,0
SPALDING,2/5/2020,0,0,0,0
SPALDING,2/6/2020,0,0,0,0
SPALDING,2/7/2020,0,0,0,0
SPALDING,2/8/2020,0,0,0,0
SPALDING,2/9/2020,0,0,0,0
SPALDING,2/10/2020,0,0,0,0
SPALDING,2/11/2020,0,0,0,0
SPALDING,2/12/2020,0,0,0,0
SPALDING,2/13/2020,0,0,0,0
SPALDING,2/14/2020,0,0,0,0
SPALDING,2/15/2020,0,0,0,0
SPALDING,2/16/2020,0,0,0,0
SPALDING,2/17/2020,0,0,0,0
SPALDING,2/18/2020,0,0,0,0
SPALDING,2/19/2020,0,0,0,0
SPALDING,2/20/2020,0,0,0,0
SPALDING,2/21/2020,0,0,0,0
SPALDING,2/22/2020,0,0,0,0
SPALDING,2/23/2020,0,0,0,0
SPALDING,2/24/2020,0,0,0,0
SPALDING,2/25/2020,0,0,0,0
SPALDING,2/26/2020,0,0,0,0
SPALDING,2/27/2020,0,0,0,0
SPALDING,2/28/2020,0,0,0,0
SPALDING,2/29/2020,0,0,0,0
SPALDING,3/1/2020,0,0,0,0
SPALDING,3/2/2020,0,0,0,0
SPALDING,3/3/2020,0,0,0,0
SPALDING,3/4/2020,0,0,0,0
SPALDING,3/5/2020,0,0,0,0
SPALDING,3/6/2020,0,0,0,0
SPALDING,3/7/2020,0,0,0,0
SPALDING,3/8/2020,0,1,0,1
SPALDING,3/9/2020,0,1,0,1
SPALDING,3/10/2020,0,1,0,1
SPALDING,3/11/2020,1,1,0,2
SPALDING,3/12/2020,2,1,0,3
SPALDING,3/13/2020,4,1,0,5
SPALDING,3/14/2020,5,1,0,6
SPALDING,3/15/2020,7,1,0,8
SPALDING,3/16/2020,7,2,0,9
SPALDING,3/17/2020,8,6,0,14
SPALDING,3/18/2020,9,6,0,15
SPALDING,3/19/2020,11,6,0,17
SPALDING,3/20/2020,14,6,0,20
SPALDING,3/21/2020,14,7,0,21
SPALDING,3/22/2020,14,7,0,21
SPALDING,3/23/2020,18,8,0,26
SPALDING,3/24/2020,21,8,0,29
SPALDING,3/25/2020,24,8,0,32
SPALDING,3/26/2020,26,10,0,36
SPALDING,3/27/2020,29,13,0,42
SPALDING,3/28/2020,30,14,0,44
SPALDING,3/29/2020,30,15,0,45
SPALDING,3/30/2020,33,17,0,50
SPALDING,3/31/2020,37,18,0,55
SPALDING,4/1/2020,42,21,0,63
SPALDING,4/2/2020,45,21,0,66
SPALDING,4/3/2020,46,23,0,69
SPALDING,4/4/2020,47,25,0,72
SPALDING,4/5/2020,48,28,0,76
SPALDING,4/6/2020,59,30,1,90
SPALDING,4/7/2020,63,32,1,96
SPALDING,4/8/2020,67,34,1,102
SPALDING,4/9/2020,71,36,1,108
SPALDING,4/10/2020,76,40,1,117
SPALDING,4/11/2020,81,42,1,124
SPALDING,4/12/2020,82,42,1,125
SPALDING,4/13/2020,89,48,1,138
STEWART,8/5/2020,112,242,0,354
STEWART,8/6/2020,113,242,0,355
STEWART,8/7/2020,113,243,0,356
STEWART,8/8/2020,113,243,0,356
STEWART,8/9/2020,113,243,0,356
STEWART,8/10/2020,113,244,0,357
STEWART,8/11/2020,113,245,0,358
STEWART,8/12/2020,113,247,0,360
STEWART,8/13/2020,113,247,0,360
STEWART,8/14/2020,113,247,0,360
STEWART,8/15/2020,114,248,0,362
STEWART,8/16/2020,114,248,0,362
STEWART,8/17/2020,114,250,0,364
STEWART,8/18/2020,114,267,1,382
STEWART,8/19/2020,114,311,1,426
STEWART,8/20/2020,114,323,1,438
STEWART,8/21/2020,114,327,1,442
STEWART,8/22/2020,114,328,1,443
STEWART,8/23/2020,114,349,1,464
STEWART,8/24/2020,114,377,1,492
STEWART,8/25/2020,114,380,1,495
STEWART,8/26/2020,114,388,1,503
STEWART,8/27/2020,114,388,1,503
STEWART,8/28/2020,115,393,1,509
STEWART,8/29/2020,116,393,1,510
SCHLEY,7/10/2020,21,13,0,34
STEWART,8/30/2020,116,395,1,512
STEWART,8/31/2020,116,396,1,513
STEWART,9/1/2020,117,397,1,515
STEWART,9/2/2020,117,399,1,517
STEWART,9/3/2020,117,399,1,517
STEWART,9/4/2020,117,399,1,517
STEWART,9/5/2020,117,399,1,517
STEWART,9/6/2020,118,399,1,518
STEWART,9/7/2020,118,399,1,518
STEWART,9/8/2020,118,406,1,525
STEWART,9/9/2020,118,406,1,525
STEWART,9/10/2020,118,406,1,525
STEWART,9/11/2020,119,406,1,526
STEWART,9/12/2020,119,407,1,527
STEWART,9/13/2020,119,407,1,527
STEWART,9/14/2020,120,407,1,528
STEWART,9/15/2020,120,408,1,529
STEWART,9/16/2020,120,408,1,529
STEWART,9/17/2020,120,409,1,530
STEWART,9/18/2020,120,409,1,530
STEWART,9/19/2020,120,409,1,530
STEWART,9/20/2020,120,410,1,531
STEWART,9/21/2020,120,410,1,531
STEWART,9/22/2020,120,410,1,531
STEWART,9/23/2020,120,411,1,532
STEWART,9/24/2020,120,411,1,532
STEWART,9/25/2020,121,411,1,533
STEWART,9/26/2020,121,411,1,533
STEWART,9/27/2020,121,411,1,533
STEWART,9/28/2020,121,411,1,533
STEWART,9/29/2020,121,411,1,533
STEWART,9/30/2020,121,411,1,533
STEWART,10/1/2020,121,411,1,533
STEWART,10/2/2020,121,411,1,533
STEWART,10/3/2020,121,411,1,533
STEWART,10/4/2020,121,411,1,533
STEWART,10/5/2020,121,411,1,533
STEWART,10/6/2020,121,411,1,533
STEWART,10/7/2020,121,411,1,533
STEWART,10/8/2020,121,411,1,533
STEWART,10/9/2020,122,411,1,534
STEWART,10/10/2020,122,411,1,534
STEWART,10/11/2020,122,411,1,534
STEWART,10/12/2020,122,411,1,534
STEWART,10/13/2020,122,411,1,534
STEWART,10/14/2020,122,411,1,534
STEWART,10/15/2020,122,411,1,534
STEWART,10/16/2020,122,411,1,534
STEWART,10/17/2020,122,411,1,534
STEWART,10/18/2020,122,411,1,534
STEWART,10/19/2020,122,411,1,534
STEWART,10/20/2020,122,411,1,534
TALBOT,1/1/2020,0,0,0,0
TALBOT,1/2/2020,0,0,0,0
TALBOT,1/3/2020,0,0,0,0
TALBOT,1/4/2020,0,0,0,0
TALBOT,1/5/2020,0,0,0,0
TALBOT,1/6/2020,0,0,0,0
TALBOT,1/7/2020,0,0,0,0
TALBOT,1/8/2020,0,0,0,0
TALBOT,1/9/2020,0,0,0,0
TALBOT,1/10/2020,0,0,0,0
TALBOT,1/11/2020,0,0,0,0
TALBOT,1/12/2020,0,0,0,0
TALBOT,1/13/2020,0,0,0,0
TALBOT,1/14/2020,0,0,0,0
TALBOT,1/15/2020,0,0,0,0
TALBOT,1/16/2020,0,0,0,0
TALBOT,1/17/2020,0,0,0,0
TALBOT,1/18/2020,0,0,0,0
TALBOT,1/19/2020,0,0,0,0
TALBOT,1/20/2020,0,0,0,0
TALBOT,1/21/2020,0,0,0,0
TALBOT,1/22/2020,0,0,0,0
TALBOT,1/23/2020,0,0,0,0
TALBOT,1/24/2020,0,0,0,0
TALBOT,1/25/2020,0,0,0,0
TALBOT,1/26/2020,0,0,0,0
TALBOT,1/27/2020,0,0,0,0
TALBOT,1/28/2020,0,0,0,0
TALBOT,1/29/2020,0,0,0,0
TALBOT,1/30/2020,0,0,0,0
TALBOT,1/31/2020,0,0,0,0
TALBOT,2/1/2020,0,0,0,0
TALBOT,2/2/2020,0,0,0,0
TALBOT,2/3/2020,0,0,0,0
TALBOT,2/4/2020,0,0,0,0
TALBOT,2/5/2020,0,0,0,0
TALBOT,2/6/2020,0,0,0,0
TALBOT,2/7/2020,0,0,0,0
TALBOT,2/8/2020,0,0,0,0
TALBOT,2/9/2020,0,0,0,0
TALBOT,2/10/2020,0,0,0,0
TALBOT,2/11/2020,0,0,0,0
TALBOT,2/12/2020,0,0,0,0
TALBOT,2/13/2020,0,0,0,0
TALBOT,2/14/2020,0,0,0,0
TALBOT,2/15/2020,0,0,0,0
TALBOT,2/16/2020,0,0,0,0
TALBOT,2/17/2020,0,0,0,0
TALBOT,2/18/2020,0,0,0,0
TALBOT,2/19/2020,0,0,0,0
TALBOT,2/20/2020,0,0,0,0
TALBOT,2/21/2020,0,0,0,0
TALBOT,2/22/2020,0,0,0,0
TALBOT,2/23/2020,0,0,0,0
TALBOT,2/24/2020,0,0,0,0
TALBOT,2/25/2020,0,0,0,0
TALBOT,2/26/2020,0,0,0,0
TALBOT,2/27/2020,0,0,0,0
TALBOT,2/28/2020,0,0,0,0
TALBOT,2/29/2020,0,0,0,0
TALBOT,3/1/2020,0,0,0,0
TALBOT,3/2/2020,0,0,0,0
TALBOT,3/3/2020,0,0,0,0
TALBOT,3/4/2020,0,0,0,0
TALBOT,3/5/2020,0,0,0,0
TALBOT,3/6/2020,0,0,0,0
TALBOT,3/7/2020,0,0,0,0
TALBOT,3/8/2020,0,0,0,0
TALBOT,3/9/2020,0,0,0,0
TALBOT,3/10/2020,0,0,0,0
TALBOT,3/11/2020,0,0,0,0
TALBOT,3/12/2020,1,0,0,1
TALBOT,3/13/2020,1,0,0,1
TALBOT,3/14/2020,1,0,0,1
TALBOT,3/15/2020,1,0,0,1
TALBOT,3/16/2020,1,0,0,1
TALBOT,3/17/2020,1,0,0,1
TALBOT,3/18/2020,1,0,0,1
TALBOT,3/19/2020,1,0,0,1
TALBOT,3/20/2020,1,0,0,1
TALBOT,3/21/2020,1,1,0,2
TALBOT,3/22/2020,1,1,0,2
TALBOT,3/23/2020,1,1,0,2
TALBOT,3/24/2020,1,1,0,2
TALBOT,3/25/2020,2,1,0,3
TALBOT,3/26/2020,2,3,0,5
TALBOT,3/27/2020,2,3,0,5
TALBOT,3/28/2020,2,3,0,5
TALBOT,3/29/2020,2,3,0,5
TALBOT,3/30/2020,3,3,0,6
TALBOT,3/31/2020,3,3,0,6
TALBOT,4/1/2020,3,3,0,6
TALBOT,4/2/2020,4,3,0,7
TALBOT,4/3/2020,4,3,0,7
TALBOT,4/4/2020,4,3,0,7
TALBOT,4/5/2020,5,3,0,8
TALBOT,4/6/2020,5,4,0,9
TALBOT,4/7/2020,5,4,0,9
TALBOT,4/8/2020,6,4,0,10
TALBOT,4/9/2020,6,4,0,10
TALBOT,4/10/2020,6,5,0,11
TALBOT,4/11/2020,6,5,0,11
TALBOT,4/12/2020,6,5,0,11
TALBOT,4/13/2020,7,5,0,12
TALBOT,4/14/2020,7,7,0,14
TALBOT,4/15/2020,9,7,0,16
TALBOT,4/16/2020,11,7,0,18
TALBOT,4/17/2020,11,7,0,18
TALBOT,4/18/2020,12,7,0,19
TALBOT,4/19/2020,12,7,0,19
TALBOT,4/20/2020,12,8,0,20
TALBOT,4/21/2020,13,8,0,21
TALBOT,4/22/2020,13,8,0,21
TALBOT,4/23/2020,13,8,0,21
TALBOT,4/24/2020,13,8,0,21
TALBOT,4/25/2020,13,8,0,21
TALBOT,4/26/2020,13,8,0,21
TALBOT,4/27/2020,13,9,0,22
TALBOT,4/28/2020,14,11,0,25
TALBOT,4/29/2020,14,11,0,25
TALBOT,4/30/2020,14,12,0,26
TALBOT,5/1/2020,15,12,0,27
TALBOT,5/2/2020,15,12,0,27
TALBOT,5/3/2020,16,12,0,28
TALBOT,5/4/2020,16,12,0,28
TALBOT,5/5/2020,16,12,0,28
TALBOT,5/6/2020,16,12,0,28
TALBOT,5/7/2020,16,12,0,28
TALBOT,5/8/2020,16,12,0,28
TALBOT,5/9/2020,16,12,0,28
TALBOT,5/10/2020,16,13,0,29
TALBOT,5/11/2020,17,14,0,31
TALBOT,5/12/2020,17,14,0,31
TALBOT,5/13/2020,17,14,0,31
TALBOT,5/14/2020,17,14,0,31
TALBOT,5/15/2020,19,14,0,33
TALBOT,5/16/2020,19,15,0,34
TALBOT,5/17/2020,19,15,0,34
TALBOT,5/18/2020,21,16,0,37
TALBOT,5/19/2020,22,16,0,38
TALBOT,5/20/2020,23,17,0,40
TALBOT,5/21/2020,23,17,0,40
TALBOT,5/22/2020,24,17,0,41
TALBOT,5/23/2020,25,17,0,42
TALBOT,5/24/2020,25,17,0,42
TALBOT,5/25/2020,26,17,0,43
TALBOT,5/26/2020,27,17,0,44
TALBOT,5/27/2020,27,17,0,44
TALBOT,5/28/2020,27,17,0,44
TALBOT,5/29/2020,27,18,0,45
TALBOT,5/30/2020,28,18,0,46
TALBOT,5/31/2020,28,18,0,46
TALBOT,6/1/2020,28,18,0,46
TALBOT,6/2/2020,29,18,0,47
TALBOT,6/3/2020,29,19,0,48
TALBOT,6/4/2020,29,20,0,49
TALBOT,6/5/2020,30,20,0,50
TALBOT,6/6/2020,30,20,0,50
TALBOT,6/7/2020,30,20,0,50
TALBOT,6/8/2020,31,20,0,51
TALBOT,6/9/2020,31,20,0,51
TALBOT,6/10/2020,32,21,0,53
TALBOT,6/11/2020,32,21,0,53
TALBOT,6/12/2020,33,22,0,55
TALBOT,6/13/2020,36,23,0,59
TALBOT,6/14/2020,36,23,0,59
TALBOT,6/15/2020,36,24,0,60
TALBOT,6/16/2020,37,24,0,61
TALBOT,6/17/2020,38,25,0,63
TALBOT,6/18/2020,40,26,0,66
TALBOT,6/19/2020,41,27,0,68
TALBOT,6/20/2020,42,29,0,71
TALBOT,6/21/2020,43,30,0,73
TALBOT,6/22/2020,44,30,0,74
TALBOT,6/23/2020,46,30,0,76
TALBOT,6/24/2020,49,32,0,81
TALBOT,6/25/2020,50,35,0,85
TALBOT,6/26/2020,51,35,0,86
TALBOT,6/27/2020,51,35,0,86
TALBOT,6/28/2020,51,35,0,86
TALBOT,6/29/2020,52,35,0,87
TALBOT,6/30/2020,54,36,0,90
TALBOT,7/1/2020,58,37,0,95
TALBOT,7/2/2020,59,37,0,96
TALBOT,7/3/2020,59,37,0,96
TALBOT,7/4/2020,60,37,0,97
TALBOT,7/5/2020,60,38,0,98
TALBOT,7/6/2020,61,41,0,102
TALBOT,7/7/2020,61,41,0,102
TALBOT,7/8/2020,64,41,0,105
TALBOT,7/9/2020,64,41,0,105
TALBOT,7/10/2020,64,42,0,106
TALBOT,7/11/2020,66,42,0,108
TALBOT,7/12/2020,67,43,0,110
TALBOT,7/13/2020,68,45,0,113
TALBOT,7/14/2020,69,45,0,114
TALBOT,7/15/2020,70,45,0,115
TALBOT,7/16/2020,71,45,0,116
TALBOT,7/17/2020,72,48,0,120
TALBOT,7/18/2020,73,48,0,121
TALBOT,7/19/2020,73,48,0,121
TALBOT,7/20/2020,75,48,0,123
TALBOT,7/21/2020,77,49,0,126
TALBOT,7/22/2020,79,49,0,128
TALBOT,7/23/2020,79,49,0,128
TALBOT,7/24/2020,80,50,0,130
TALBOT,7/25/2020,80,50,0,130
TALBOT,7/26/2020,81,50,0,131
TALBOT,7/27/2020,83,50,0,133
TALBOT,7/28/2020,83,50,0,133
TALBOT,7/29/2020,83,50,0,133
TALBOT,7/30/2020,84,50,0,134
TALBOT,7/31/2020,85,51,0,136
TALBOT,8/1/2020,85,53,0,138
TALBOT,8/2/2020,85,54,0,139
TALBOT,8/3/2020,86,54,0,140
TALBOT,8/4/2020,87,54,0,141
TALBOT,8/5/2020,88,55,0,143
TALBOT,8/6/2020,88,55,0,143
TALBOT,8/7/2020,89,56,0,145
TALBOT,8/8/2020,89,56,0,145
TALBOT,8/9/2020,90,56,0,146
TALBOT,8/10/2020,90,56,0,146
TALBOT,8/11/2020,90,56,0,146
TALBOT,8/12/2020,90,56,0,146
TALBOT,8/13/2020,90,57,0,147
TALBOT,8/14/2020,90,57,0,147
TALBOT,8/15/2020,91,57,0,148
TALBOT,8/16/2020,92,58,0,150
TALBOT,8/17/2020,93,58,0,151
TALBOT,8/18/2020,94,58,0,152
TALBOT,8/19/2020,95,58,0,153
TALBOT,8/20/2020,95,58,0,153
TALBOT,8/21/2020,95,58,0,153
TALBOT,8/22/2020,95,58,0,153
TALBOT,8/23/2020,95,59,0,154
TALBOT,8/24/2020,95,59,0,154
TALBOT,8/25/2020,95,59,0,154
TALBOT,8/26/2020,95,59,0,154
TALBOT,8/27/2020,95,59,0,154
TALBOT,8/28/2020,95,59,0,154
TALBOT,8/29/2020,96,59,0,155
TALBOT,8/30/2020,97,59,0,156
TALBOT,8/31/2020,97,59,0,156
TALBOT,9/1/2020,97,59,0,156
TALBOT,9/2/2020,97,59,0,156
TALBOT,9/3/2020,97,59,0,156
TALBOT,9/4/2020,97,59,0,156
TALBOT,9/5/2020,99,59,0,158
TALBOT,9/6/2020,99,59,0,158
TALBOT,9/7/2020,102,59,0,161
TALBOT,9/8/2020,102,60,0,162
TALBOT,9/9/2020,102,60,0,162
TALBOT,9/10/2020,102,60,0,162
TALBOT,9/11/2020,102,60,0,162
TALBOT,9/12/2020,102,60,0,162
TALBOT,9/13/2020,102,60,0,162
TALBOT,9/14/2020,102,60,0,162
TALBOT,9/15/2020,102,60,0,162
TALBOT,9/16/2020,102,61,0,163
TALBOT,9/17/2020,102,61,0,163
TALBOT,9/18/2020,103,61,0,164
TALBOT,9/19/2020,104,61,0,165
TALBOT,9/20/2020,104,61,0,165
TALBOT,9/21/2020,105,61,0,166
TALBOT,9/22/2020,105,61,0,166
TALBOT,9/23/2020,105,61,0,166
TALBOT,9/24/2020,105,61,0,166
TALBOT,9/25/2020,105,61,0,166
TALBOT,9/26/2020,105,61,0,166
TALBOT,9/27/2020,105,61,0,166
TALBOT,9/28/2020,105,61,0,166
TALBOT,9/29/2020,105,61,0,166
TALBOT,9/30/2020,105,61,0,166
TALBOT,10/1/2020,106,61,0,167
TALBOT,10/2/2020,106,61,0,167
TALBOT,10/3/2020,106,61,0,167
TALBOT,10/4/2020,106,61,0,167
TALBOT,10/5/2020,106,61,0,167
TALBOT,10/6/2020,106,61,0,167
TALBOT,10/7/2020,106,61,0,167
TALBOT,10/8/2020,106,61,0,167
TALBOT,10/9/2020,106,61,0,167
TALBOT,10/10/2020,106,61,0,167
TALBOT,10/11/2020,106,61,0,167
TALBOT,10/12/2020,106,61,0,167
TALBOT,10/13/2020,106,61,0,167
TALBOT,10/14/2020,106,61,0,167
TALBOT,10/15/2020,106,62,0,168
TALBOT,10/16/2020,106,62,0,168
TALBOT,10/17/2020,106,62,0,168
TALBOT,10/18/2020,106,62,0,168
TALBOT,10/19/2020,106,62,0,168
TALBOT,10/20/2020,106,62,0,168
TALIAFERRO,1/1/2020,0,0,0,0
TALIAFERRO,1/2/2020,0,0,0,0
TALIAFERRO,1/3/2020,0,0,0,0
TALIAFERRO,1/4/2020,0,0,0,0
TALIAFERRO,1/5/2020,0,0,0,0
TALIAFERRO,1/6/2020,0,0,0,0
TALIAFERRO,1/7/2020,0,0,0,0
TALIAFERRO,1/8/2020,0,0,0,0
TALIAFERRO,1/9/2020,0,0,0,0
TALIAFERRO,1/10/2020,0,0,0,0
TALIAFERRO,1/11/2020,0,0,0,0
TALIAFERRO,1/12/2020,0,0,0,0
TALIAFERRO,1/13/2020,0,0,0,0
TALIAFERRO,1/14/2020,0,0,0,0
TALIAFERRO,1/15/2020,0,0,0,0
TALIAFERRO,1/16/2020,0,0,0,0
TALIAFERRO,1/17/2020,0,0,0,0
TALIAFERRO,1/18/2020,0,0,0,0
TALIAFERRO,1/19/2020,0,0,0,0
TALIAFERRO,1/20/2020,0,0,0,0
TALIAFERRO,1/21/2020,0,0,0,0
TALIAFERRO,1/22/2020,0,0,0,0
SCHLEY,7/11/2020,22,13,0,35
SCHLEY,7/12/2020,22,13,0,35
SCHLEY,7/13/2020,22,14,0,36
SCHLEY,7/14/2020,22,14,0,36
SCHLEY,7/15/2020,22,14,0,36
SCHLEY,7/16/2020,22,14,0,36
SCHLEY,7/17/2020,22,15,0,37
SCHLEY,7/18/2020,24,18,0,42
SCHLEY,7/19/2020,25,18,0,43
SCHLEY,7/20/2020,26,21,0,47
SCHLEY,7/21/2020,27,21,0,48
SCHLEY,7/22/2020,28,22,0,50
SCHLEY,7/23/2020,29,22,0,51
SCHLEY,7/24/2020,30,23,0,53
SCHLEY,7/25/2020,31,25,0,56
SCHLEY,7/26/2020,31,27,0,58
SCHLEY,7/27/2020,31,27,0,58
SCHLEY,7/28/2020,31,29,0,60
SCHLEY,7/29/2020,32,29,0,61
SCHLEY,7/30/2020,32,31,0,63
SCHLEY,7/31/2020,35,32,0,67
SCHLEY,8/1/2020,35,32,0,67
SCHLEY,8/2/2020,36,33,0,69
SCHLEY,8/3/2020,37,35,0,72
SCHLEY,8/4/2020,37,35,0,72
SCHLEY,8/5/2020,37,36,0,73
SCHLEY,8/6/2020,37,36,0,73
SCHLEY,8/7/2020,38,36,0,74
SCHLEY,8/8/2020,39,36,0,75
SCHLEY,8/9/2020,39,36,0,75
SCHLEY,8/10/2020,39,38,0,77
SCHLEY,8/11/2020,40,40,0,80
SCHLEY,8/12/2020,42,40,0,82
SCHLEY,8/13/2020,43,40,0,83
SCHLEY,8/14/2020,44,40,0,84
SCHLEY,8/15/2020,45,40,0,85
SCHLEY,8/16/2020,46,44,0,90
SCHLEY,8/17/2020,46,45,0,91
SCHLEY,8/18/2020,46,45,0,91
SCHLEY,8/19/2020,46,45,0,91
SCHLEY,8/20/2020,46,45,0,91
SCHLEY,8/21/2020,46,45,0,91
SCHLEY,8/22/2020,47,45,0,92
SCHLEY,8/23/2020,48,45,0,93
SCHLEY,8/24/2020,49,45,0,94
SCHLEY,8/25/2020,49,45,0,94
SCHLEY,8/26/2020,49,45,0,94
SCHLEY,8/27/2020,50,45,0,95
SCHLEY,8/28/2020,50,45,0,95
SCHLEY,8/29/2020,50,45,0,95
SCHLEY,8/30/2020,50,48,0,98
SCHLEY,8/31/2020,52,48,0,100
SCHLEY,9/1/2020,53,48,0,101
SCHLEY,9/2/2020,53,48,0,101
SCHLEY,9/3/2020,53,49,0,102
SCHLEY,9/4/2020,53,50,0,103
SCHLEY,9/5/2020,53,50,0,103
SCHLEY,9/6/2020,53,50,0,103
SCHLEY,9/7/2020,53,50,0,103
SCHLEY,9/8/2020,53,50,0,103
SCHLEY,9/9/2020,53,50,0,103
SCHLEY,9/10/2020,53,51,0,104
SCHLEY,9/11/2020,53,51,0,104
SCHLEY,9/12/2020,53,51,0,104
SCHLEY,9/13/2020,53,52,0,105
SCHLEY,9/14/2020,53,52,0,105
SCHLEY,9/15/2020,53,52,0,105
SCHLEY,9/16/2020,53,52,0,105
SCHLEY,9/17/2020,53,52,0,105
SCHLEY,9/18/2020,53,52,0,105
SCHLEY,9/19/2020,53,52,0,105
SCHLEY,9/20/2020,53,52,0,105
SCHLEY,9/21/2020,53,52,0,105
SCHLEY,9/22/2020,53,52,0,105
SCHLEY,9/23/2020,53,52,0,105
SCHLEY,9/24/2020,53,52,0,105
SCHLEY,9/25/2020,53,52,0,105
SCHLEY,9/26/2020,53,52,0,105
SCHLEY,9/27/2020,53,52,0,105
SCHLEY,9/28/2020,53,52,0,105
SCHLEY,9/29/2020,53,53,0,106
SCHLEY,9/30/2020,53,53,0,106
SCHLEY,10/1/2020,53,53,0,106
SCHLEY,10/2/2020,54,53,0,107
SCHLEY,10/3/2020,54,53,0,107
SCHLEY,10/4/2020,54,53,0,107
SCHLEY,10/5/2020,54,53,0,107
SCHLEY,10/6/2020,54,53,0,107
SCHLEY,10/7/2020,54,53,0,107
SCHLEY,10/8/2020,54,54,0,108
SCHLEY,10/9/2020,54,54,0,108
SCHLEY,10/10/2020,54,54,0,108
SCHLEY,10/11/2020,54,54,0,108
SCHLEY,10/12/2020,54,54,0,108
SCHLEY,10/13/2020,54,54,0,108
SCHLEY,10/14/2020,54,54,0,108
SCHLEY,10/15/2020,54,54,0,108
SCHLEY,10/16/2020,54,54,0,108
SCHLEY,10/17/2020,54,54,0,108
SCHLEY,10/18/2020,54,54,0,108
SCHLEY,10/19/2020,54,54,0,108
SCHLEY,10/20/2020,54,54,0,108
SCREVEN,1/1/2020,0,0,0,0
SCREVEN,1/2/2020,0,0,0,0
SCREVEN,1/3/2020,0,0,0,0
SCREVEN,1/4/2020,0,0,0,0
SCREVEN,1/5/2020,0,0,0,0
SCREVEN,1/6/2020,0,0,0,0
SCREVEN,1/7/2020,0,0,0,0
SCREVEN,1/8/2020,0,0,0,0
SCREVEN,1/9/2020,0,0,0,0
SCREVEN,1/10/2020,0,0,0,0
SCREVEN,1/11/2020,0,0,0,0
SCREVEN,1/12/2020,0,0,0,0
SCREVEN,1/13/2020,0,0,0,0
SCREVEN,1/14/2020,0,0,0,0
SCREVEN,1/15/2020,0,0,0,0
SCREVEN,1/16/2020,0,0,0,0
SCREVEN,1/17/2020,0,0,0,0
SCREVEN,1/18/2020,0,0,0,0
SCREVEN,1/19/2020,0,0,0,0
SCREVEN,1/20/2020,0,0,0,0
SCREVEN,1/21/2020,0,0,0,0
SCREVEN,1/22/2020,0,0,0,0
SCREVEN,1/23/2020,0,0,0,0
SCREVEN,1/24/2020,0,0,0,0
SCREVEN,1/25/2020,0,0,0,0
SCREVEN,1/26/2020,0,0,0,0
SCREVEN,1/27/2020,0,0,0,0
SCREVEN,1/28/2020,0,0,0,0
SCREVEN,1/29/2020,0,0,0,0
SCREVEN,1/30/2020,0,0,0,0
SCREVEN,1/31/2020,0,0,0,0
SCREVEN,2/1/2020,0,0,0,0
SCREVEN,2/2/2020,0,0,0,0
SCREVEN,2/3/2020,0,0,0,0
SCREVEN,2/4/2020,0,0,0,0
SCREVEN,2/5/2020,0,0,0,0
SCREVEN,2/6/2020,0,0,0,0
SCREVEN,2/7/2020,0,0,0,0
SCREVEN,2/8/2020,0,0,0,0
SCREVEN,2/9/2020,0,0,0,0
SCREVEN,2/10/2020,0,0,0,0
SCREVEN,2/11/2020,0,0,0,0
SCREVEN,2/12/2020,0,0,0,0
SCREVEN,2/13/2020,0,0,0,0
SCREVEN,2/14/2020,0,0,0,0
SCREVEN,2/15/2020,0,0,0,0
SCREVEN,2/16/2020,0,0,0,0
SCREVEN,2/17/2020,0,0,0,0
SCREVEN,2/18/2020,0,0,0,0
SCREVEN,2/19/2020,0,0,0,0
SCREVEN,2/20/2020,0,0,0,0
SCREVEN,2/21/2020,0,0,0,0
SCREVEN,2/22/2020,0,0,0,0
SCREVEN,2/23/2020,0,0,0,0
SCREVEN,2/24/2020,0,0,0,0
SCREVEN,2/25/2020,0,0,0,0
SCREVEN,2/26/2020,0,0,0,0
SCREVEN,2/27/2020,0,0,0,0
SCREVEN,2/28/2020,0,0,0,0
SCREVEN,2/29/2020,0,0,0,0
SCREVEN,3/1/2020,0,0,0,0
SCREVEN,3/2/2020,0,0,0,0
SCREVEN,3/3/2020,0,0,0,0
SCREVEN,3/4/2020,0,0,0,0
SCREVEN,3/5/2020,0,0,0,0
SCREVEN,3/6/2020,0,0,0,0
SCREVEN,3/7/2020,0,0,0,0
SCREVEN,3/8/2020,0,0,0,0
SCREVEN,3/9/2020,0,0,0,0
SCREVEN,3/10/2020,0,0,0,0
SCREVEN,3/11/2020,0,0,0,0
SCREVEN,3/12/2020,0,0,0,0
SCREVEN,3/13/2020,0,0,0,0
SCREVEN,3/14/2020,0,0,0,0
SCREVEN,3/15/2020,0,0,0,0
SCREVEN,3/16/2020,0,0,0,0
SCREVEN,3/17/2020,0,0,0,0
SCREVEN,3/18/2020,0,0,0,0
SCREVEN,3/19/2020,0,0,0,0
SCREVEN,3/20/2020,0,0,0,0
SCREVEN,3/21/2020,0,0,0,0
SCREVEN,3/22/2020,0,0,0,0
SCREVEN,3/23/2020,0,0,0,0
SCREVEN,3/24/2020,0,1,0,1
SCREVEN,3/25/2020,0,1,0,1
SCREVEN,3/26/2020,0,1,0,1
SCREVEN,3/27/2020,0,1,0,1
SCREVEN,3/28/2020,1,1,0,2
SCREVEN,3/29/2020,2,1,0,3
SCREVEN,3/30/2020,2,2,0,4
SCREVEN,3/31/2020,2,2,0,4
SCREVEN,4/1/2020,2,2,0,4
SCREVEN,4/2/2020,4,2,0,6
SCREVEN,4/3/2020,4,2,0,6
SCREVEN,4/4/2020,5,2,0,7
SCREVEN,4/5/2020,5,2,0,7
SCREVEN,4/6/2020,7,2,0,9
SCREVEN,4/7/2020,7,2,0,9
SCREVEN,4/8/2020,7,3,0,10
SCREVEN,4/9/2020,8,4,0,12
SCREVEN,4/10/2020,10,4,0,14
SCREVEN,4/11/2020,10,4,0,14
SCREVEN,4/12/2020,11,4,0,15
SCREVEN,4/13/2020,14,4,0,18
SCREVEN,4/14/2020,14,4,0,18
SCREVEN,4/15/2020,14,4,0,18
SCREVEN,4/16/2020,14,4,0,18
SCREVEN,4/17/2020,15,5,0,20
SCREVEN,4/18/2020,15,5,0,20
SCREVEN,4/19/2020,15,5,0,20
SCREVEN,4/20/2020,15,5,0,20
SCREVEN,4/21/2020,15,5,0,20
SCREVEN,4/22/2020,15,5,0,20
SCREVEN,4/23/2020,15,6,0,21
SCREVEN,4/24/2020,15,6,0,21
SCREVEN,4/25/2020,16,6,0,22
SCREVEN,4/26/2020,16,6,0,22
SCREVEN,4/27/2020,16,8,0,24
SCREVEN,4/28/2020,16,8,0,24
SCREVEN,4/29/2020,16,8,0,24
SCREVEN,4/30/2020,20,8,0,28
SCREVEN,5/1/2020,20,8,0,28
SCREVEN,5/2/2020,20,8,0,28
SCREVEN,5/3/2020,20,8,0,28
SCREVEN,5/4/2020,21,8,0,29
SCREVEN,5/5/2020,21,9,0,30
SCREVEN,5/6/2020,21,9,0,30
SCREVEN,5/7/2020,22,9,0,31
SCREVEN,5/8/2020,22,10,0,32
SCREVEN,5/9/2020,22,10,0,32
SCREVEN,5/10/2020,22,10,0,32
SCREVEN,5/11/2020,23,10,0,33
SCREVEN,5/12/2020,23,10,0,33
SCREVEN,5/13/2020,23,12,0,35
SCREVEN,5/14/2020,24,13,0,37
SCREVEN,5/15/2020,25,13,0,38
SCREVEN,5/16/2020,25,13,0,38
SCREVEN,5/17/2020,26,14,0,40
SCREVEN,5/18/2020,29,15,0,44
SCREVEN,5/19/2020,32,17,0,49
SCREVEN,5/20/2020,39,17,0,56
SCREVEN,5/21/2020,41,19,0,60
SCREVEN,5/22/2020,42,19,0,61
SCREVEN,5/23/2020,42,19,0,61
SCREVEN,5/24/2020,43,19,0,62
SCREVEN,5/25/2020,44,19,0,63
SCREVEN,5/26/2020,48,20,0,68
SCREVEN,5/27/2020,48,20,0,68
SCREVEN,5/28/2020,49,20,0,69
SCREVEN,5/29/2020,51,20,0,71
SCREVEN,5/30/2020,52,20,0,72
SCREVEN,5/31/2020,52,20,0,72
SCREVEN,6/1/2020,54,21,0,75
SCREVEN,6/2/2020,55,22,0,77
SCREVEN,6/3/2020,57,22,0,79
SCREVEN,6/4/2020,57,23,0,80
SCREVEN,6/5/2020,60,23,0,83
SCREVEN,6/6/2020,60,23,0,83
SCREVEN,6/7/2020,60,24,0,84
SCREVEN,6/8/2020,62,24,0,86
SCREVEN,6/9/2020,62,24,0,86
SCREVEN,6/10/2020,62,24,0,86
SCREVEN,6/11/2020,62,31,0,93
SCREVEN,6/12/2020,62,31,0,93
SCREVEN,6/13/2020,63,31,0,94
SCREVEN,6/14/2020,63,31,0,94
SCREVEN,6/15/2020,63,31,0,94
SCREVEN,6/16/2020,64,31,0,95
SCREVEN,6/17/2020,64,31,0,95
SCREVEN,6/18/2020,64,33,0,97
SCREVEN,6/19/2020,65,34,0,99
SCREVEN,6/20/2020,66,34,0,100
SCREVEN,6/21/2020,66,34,0,100
SCREVEN,6/22/2020,66,36,0,102
SCREVEN,6/23/2020,66,38,0,104
SCREVEN,6/24/2020,67,38,0,105
SCREVEN,6/25/2020,70,39,0,109
SCREVEN,6/26/2020,70,42,0,112
SCREVEN,6/27/2020,70,42,0,112
SCREVEN,6/28/2020,71,42,0,113
SCREVEN,6/29/2020,75,44,0,119
SCREVEN,6/30/2020,76,46,0,122
SCREVEN,7/1/2020,77,47,0,124
SCREVEN,7/2/2020,77,52,0,129
SCREVEN,7/3/2020,78,54,0,132
SCREVEN,7/4/2020,78,54,0,132
SCREVEN,7/5/2020,78,54,0,132
SCREVEN,7/6/2020,79,54,0,133
SCREVEN,7/7/2020,80,54,0,134
SCREVEN,7/8/2020,82,57,0,139
SCREVEN,7/9/2020,86,60,0,146
SCREVEN,7/10/2020,87,60,0,147
SCREVEN,7/11/2020,87,64,0,151
SCREVEN,7/12/2020,87,64,0,151
SCREVEN,7/13/2020,93,66,1,160
SCREVEN,7/14/2020,94,66,1,161
SCREVEN,7/15/2020,94,68,1,163
SCREVEN,7/16/2020,98,68,1,167
SCREVEN,7/17/2020,98,68,1,167
SCREVEN,7/18/2020,99,69,1,169
SCREVEN,7/19/2020,99,69,1,169
SCREVEN,7/20/2020,101,69,1,171
SCREVEN,7/21/2020,105,71,1,177
SCREVEN,7/22/2020,107,73,1,181
SCREVEN,7/23/2020,108,75,1,184
SCREVEN,7/24/2020,108,76,1,185
SCREVEN,7/25/2020,109,76,1,186
SCREVEN,7/26/2020,109,77,1,187
SCREVEN,7/27/2020,110,81,1,192
SCREVEN,7/28/2020,112,82,2,196
SCREVEN,7/29/2020,113,85,2,200
SCREVEN,7/30/2020,118,85,2,205
SCREVEN,7/31/2020,122,86,2,210
SCREVEN,8/1/2020,122,87,2,211
SCREVEN,8/2/2020,125,87,2,214
SCREVEN,8/3/2020,129,91,2,222
SCREVEN,8/4/2020,133,93,2,228
SCREVEN,8/5/2020,137,94,2,233
SCREVEN,8/6/2020,140,95,2,237
SCREVEN,8/7/2020,144,98,2,244
SCREVEN,8/8/2020,145,99,2,246
SCREVEN,8/9/2020,147,101,2,250
SCREVEN,8/10/2020,147,101,2,250
SCREVEN,8/11/2020,149,101,2,252
SCREVEN,8/12/2020,153,103,2,258
SCREVEN,8/13/2020,156,106,2,264
SCREVEN,8/14/2020,162,108,2,272
SCREVEN,8/15/2020,162,108,2,272
SCREVEN,8/16/2020,163,108,2,273
SCREVEN,8/17/2020,166,111,2,279
SCREVEN,8/18/2020,168,111,2,281
SCREVEN,8/19/2020,170,111,2,283
SCREVEN,8/20/2020,171,115,2,288
SCREVEN,8/21/2020,178,116,2,296
SCREVEN,8/22/2020,179,117,3,299
SCREVEN,8/23/2020,180,119,3,302
SCREVEN,8/24/2020,182,120,3,305
SCREVEN,8/25/2020,182,121,3,306
SCREVEN,8/26/2020,184,124,3,311
SCREVEN,8/27/2020,188,127,3,318
SCREVEN,8/28/2020,191,127,3,321
SCREVEN,8/29/2020,192,129,3,324
SCREVEN,8/30/2020,193,130,3,326
SCREVEN,8/31/2020,194,134,3,331
SCREVEN,9/1/2020,197,135,3,335
SCREVEN,9/2/2020,201,136,3,340
SCREVEN,9/3/2020,204,136,3,343
SCREVEN,9/4/2020,206,136,3,345
SCREVEN,9/5/2020,209,138,3,350
SCREVEN,9/6/2020,210,138,3,351
SCREVEN,9/7/2020,214,139,3,356
SCREVEN,9/8/2020,215,141,3,359
SCREVEN,9/9/2020,219,145,3,367
SCREVEN,9/10/2020,220,146,3,369
SCREVEN,9/11/2020,220,148,3,371
SCREVEN,9/12/2020,221,149,3,373
SCREVEN,9/13/2020,221,150,3,374
SCREVEN,9/14/2020,224,152,3,379
SCREVEN,9/15/2020,227,156,3,386
SCREVEN,9/16/2020,230,158,3,391
SCREVEN,9/17/2020,232,164,3,399
SCREVEN,9/18/2020,234,169,3,406
SCREVEN,9/19/2020,237,169,3,409
SCREVEN,9/20/2020,239,169,3,411
SCREVEN,9/21/2020,241,171,3,415
SCREVEN,9/22/2020,243,172,3,418
SCREVEN,9/23/2020,246,173,3,422
SCREVEN,9/24/2020,248,173,3,424
SCREVEN,9/25/2020,248,173,3,424
SCREVEN,9/26/2020,248,173,3,424
SCREVEN,9/27/2020,248,174,3,425
SCREVEN,9/28/2020,250,174,3,427
SCREVEN,9/29/2020,250,174,3,427
SCREVEN,9/30/2020,250,174,3,427
SCREVEN,10/1/2020,251,174,3,428
SCREVEN,10/2/2020,252,174,3,429
SCREVEN,10/3/2020,252,174,3,429
SCREVEN,10/4/2020,252,174,3,429
SCREVEN,10/5/2020,253,176,3,432
SCREVEN,10/6/2020,255,176,3,434
SCREVEN,10/7/2020,255,176,3,434
SCREVEN,10/8/2020,255,177,3,435
SCREVEN,10/9/2020,256,178,3,437
SCREVEN,10/10/2020,256,179,3,438
SCREVEN,10/11/2020,256,180,3,439
SCREVEN,10/12/2020,256,180,4,440
SCREVEN,10/13/2020,257,180,4,441
SCREVEN,10/14/2020,257,182,4,443
SCREVEN,10/15/2020,258,182,4,444
SCREVEN,10/16/2020,258,183,4,445
SCREVEN,10/17/2020,258,183,4,445
SCREVEN,10/18/2020,258,183,4,445
TOWNS,9/15/2020,179,133,3,315
TOWNS,9/16/2020,181,134,3,318
TOWNS,9/17/2020,183,135,3,321
TOWNS,9/18/2020,183,137,3,323
TOWNS,9/19/2020,184,138,3,325
TOWNS,9/20/2020,193,140,5,338
TOWNS,9/21/2020,198,142,5,345
TOWNS,9/22/2020,198,142,5,345
TOWNS,9/23/2020,198,145,5,348
TOWNS,9/24/2020,198,146,5,349
TOWNS,9/25/2020,201,146,5,352
TOWNS,9/26/2020,202,147,5,354
TOWNS,9/27/2020,202,147,5,354
TOWNS,9/28/2020,204,149,5,358
TOWNS,9/29/2020,206,150,5,361
TOWNS,9/30/2020,211,150,5,366
TOWNS,10/1/2020,212,153,5,370
TOWNS,10/2/2020,212,157,5,374
TOWNS,10/3/2020,214,157,5,376
TOWNS,10/4/2020,214,159,5,378
TOWNS,10/5/2020,216,160,5,381
TOWNS,10/6/2020,219,160,5,384
TOWNS,10/7/2020,221,161,5,387
TOWNS,10/8/2020,222,163,5,390
TOWNS,10/9/2020,224,165,5,394
TOWNS,10/10/2020,225,166,5,396
TOWNS,10/11/2020,225,166,5,396
TOWNS,10/12/2020,226,167,5,398
TOWNS,10/13/2020,228,169,5,402
TOWNS,10/14/2020,228,169,6,403
TOWNS,10/15/2020,228,170,6,404
TOWNS,10/16/2020,230,172,6,408
TOWNS,10/17/2020,232,173,6,411
TOWNS,10/18/2020,232,173,6,411
TOWNS,10/19/2020,232,173,6,411
TOWNS,10/20/2020,232,173,6,411
TREUTLEN,1/1/2020,0,0,0,0
TREUTLEN,1/2/2020,0,0,0,0
TREUTLEN,1/3/2020,0,0,0,0
TREUTLEN,1/4/2020,0,0,0,0
TREUTLEN,1/5/2020,0,0,0,0
TREUTLEN,1/6/2020,0,0,0,0
TREUTLEN,1/7/2020,0,0,0,0
TREUTLEN,1/8/2020,0,0,0,0
TREUTLEN,1/9/2020,0,0,0,0
TREUTLEN,1/10/2020,0,0,0,0
TREUTLEN,1/11/2020,0,0,0,0
TREUTLEN,1/12/2020,0,0,0,0
TREUTLEN,1/13/2020,0,0,0,0
TREUTLEN,1/14/2020,0,0,0,0
TREUTLEN,1/15/2020,0,0,0,0
TREUTLEN,1/16/2020,0,0,0,0
TREUTLEN,1/17/2020,0,0,0,0
TREUTLEN,1/18/2020,0,0,0,0
TREUTLEN,1/19/2020,0,0,0,0
TREUTLEN,1/20/2020,0,0,0,0
TREUTLEN,1/21/2020,0,0,0,0
TREUTLEN,1/22/2020,0,0,0,0
TREUTLEN,1/23/2020,0,0,0,0
TREUTLEN,1/24/2020,0,0,0,0
TREUTLEN,1/25/2020,0,0,0,0
TREUTLEN,1/26/2020,0,0,0,0
TREUTLEN,1/27/2020,0,0,0,0
TREUTLEN,1/28/2020,0,0,0,0
TREUTLEN,1/29/2020,0,0,0,0
TREUTLEN,1/30/2020,0,0,0,0
TREUTLEN,1/31/2020,0,0,0,0
TREUTLEN,2/1/2020,0,0,0,0
TREUTLEN,2/2/2020,0,0,0,0
TREUTLEN,2/3/2020,0,0,0,0
TREUTLEN,2/4/2020,0,0,0,0
TREUTLEN,2/5/2020,0,0,0,0
TREUTLEN,2/6/2020,0,0,0,0
TREUTLEN,2/7/2020,0,0,0,0
TREUTLEN,2/8/2020,0,0,0,0
TREUTLEN,2/9/2020,0,0,0,0
TREUTLEN,2/10/2020,0,0,0,0
TREUTLEN,2/11/2020,0,0,0,0
TREUTLEN,2/12/2020,0,0,0,0
TREUTLEN,2/13/2020,0,0,0,0
TREUTLEN,2/14/2020,0,0,0,0
TREUTLEN,2/15/2020,0,0,0,0
TREUTLEN,2/16/2020,0,0,0,0
TREUTLEN,2/17/2020,0,0,0,0
TREUTLEN,2/18/2020,0,0,0,0
TREUTLEN,2/19/2020,0,0,0,0
TREUTLEN,2/20/2020,0,0,0,0
TREUTLEN,2/21/2020,0,0,0,0
TREUTLEN,2/22/2020,0,0,0,0
TREUTLEN,2/23/2020,0,0,0,0
TREUTLEN,2/24/2020,0,0,0,0
TREUTLEN,2/25/2020,0,0,0,0
TREUTLEN,2/26/2020,0,0,0,0
TREUTLEN,2/27/2020,0,0,0,0
TREUTLEN,2/28/2020,0,0,0,0
TREUTLEN,2/29/2020,0,0,0,0
TREUTLEN,3/1/2020,0,0,0,0
TREUTLEN,3/2/2020,0,0,0,0
TREUTLEN,3/3/2020,0,0,0,0
TREUTLEN,3/4/2020,0,0,0,0
TREUTLEN,3/5/2020,0,0,0,0
TREUTLEN,3/6/2020,0,0,0,0
TREUTLEN,3/7/2020,0,0,0,0
TREUTLEN,3/8/2020,0,0,0,0
TREUTLEN,3/9/2020,0,0,0,0
TREUTLEN,3/10/2020,0,0,0,0
TREUTLEN,3/11/2020,0,0,0,0
TREUTLEN,3/12/2020,0,0,0,0
TREUTLEN,3/13/2020,0,0,0,0
TREUTLEN,3/14/2020,0,0,0,0
TREUTLEN,3/15/2020,0,0,0,0
TREUTLEN,3/16/2020,0,0,0,0
TREUTLEN,3/17/2020,0,0,0,0
TREUTLEN,3/18/2020,0,0,0,0
TREUTLEN,3/19/2020,0,0,0,0
TREUTLEN,3/20/2020,0,0,0,0
TREUTLEN,3/21/2020,0,0,0,0
TREUTLEN,3/22/2020,0,0,0,0
TREUTLEN,3/23/2020,0,0,0,0
TREUTLEN,3/24/2020,0,0,0,0
TREUTLEN,3/25/2020,0,0,0,0
TREUTLEN,3/26/2020,0,0,0,0
TREUTLEN,3/27/2020,0,0,0,0
TREUTLEN,3/28/2020,0,0,0,0
TREUTLEN,3/29/2020,0,0,0,0
TREUTLEN,3/30/2020,0,0,0,0
TREUTLEN,3/31/2020,1,0,0,1
TREUTLEN,4/1/2020,1,0,0,1
TREUTLEN,4/2/2020,1,0,0,1
TREUTLEN,4/3/2020,1,0,0,1
TREUTLEN,4/4/2020,1,0,0,1
TREUTLEN,4/5/2020,1,0,0,1
TREUTLEN,4/6/2020,1,0,0,1
TREUTLEN,4/7/2020,1,1,0,2
TREUTLEN,4/8/2020,1,1,0,2
TREUTLEN,4/9/2020,1,1,0,2
TREUTLEN,4/10/2020,1,1,0,2
TREUTLEN,4/11/2020,1,1,0,2
TREUTLEN,4/12/2020,1,1,0,2
TREUTLEN,4/13/2020,1,1,0,2
TREUTLEN,4/14/2020,1,1,0,2
TREUTLEN,4/15/2020,1,1,0,2
TREUTLEN,4/16/2020,2,1,0,3
TREUTLEN,4/17/2020,2,1,0,3
TREUTLEN,4/18/2020,2,1,0,3
TREUTLEN,4/19/2020,2,1,0,3
TREUTLEN,4/20/2020,2,1,0,3
TREUTLEN,4/21/2020,2,1,0,3
TREUTLEN,4/22/2020,3,1,0,4
TREUTLEN,4/23/2020,3,1,0,4
TREUTLEN,4/24/2020,4,1,0,5
TREUTLEN,4/25/2020,4,1,0,5
TREUTLEN,4/26/2020,4,1,0,5
TREUTLEN,4/27/2020,4,1,0,5
TREUTLEN,4/28/2020,4,1,0,5
TREUTLEN,4/29/2020,4,1,0,5
TREUTLEN,4/30/2020,4,2,0,6
TREUTLEN,5/1/2020,4,2,0,6
TREUTLEN,5/2/2020,4,3,0,7
TREUTLEN,5/3/2020,4,3,0,7
TREUTLEN,5/4/2020,5,3,0,8
TREUTLEN,5/5/2020,5,3,0,8
TREUTLEN,5/6/2020,5,3,0,8
TREUTLEN,5/7/2020,5,3,0,8
TREUTLEN,5/8/2020,5,3,0,8
TREUTLEN,5/9/2020,5,3,0,8
TREUTLEN,5/10/2020,5,3,0,8
TREUTLEN,5/11/2020,5,4,0,9
TREUTLEN,5/12/2020,5,4,0,9
TREUTLEN,5/13/2020,5,4,0,9
TREUTLEN,5/14/2020,5,4,0,9
TREUTLEN,5/15/2020,5,4,0,9
TREUTLEN,5/16/2020,5,4,0,9
TREUTLEN,5/17/2020,5,4,0,9
TREUTLEN,5/18/2020,5,4,0,9
TREUTLEN,5/19/2020,5,4,0,9
TREUTLEN,5/20/2020,5,4,0,9
TREUTLEN,5/21/2020,5,4,0,9
TREUTLEN,5/22/2020,5,4,0,9
TREUTLEN,5/23/2020,5,4,0,9
TREUTLEN,5/24/2020,5,4,0,9
TREUTLEN,5/25/2020,5,4,0,9
TREUTLEN,5/26/2020,5,4,0,9
TREUTLEN,5/27/2020,6,4,0,10
TREUTLEN,5/28/2020,6,4,0,10
TREUTLEN,5/29/2020,7,6,0,13
TREUTLEN,5/30/2020,8,6,0,14
TREUTLEN,5/31/2020,8,6,0,14
TREUTLEN,6/1/2020,9,6,0,15
TREUTLEN,6/2/2020,9,6,0,15
TREUTLEN,6/3/2020,9,7,0,16
TREUTLEN,6/4/2020,9,7,0,16
TREUTLEN,6/5/2020,10,8,0,18
TREUTLEN,6/6/2020,10,9,0,19
TREUTLEN,6/7/2020,10,9,0,19
TREUTLEN,6/8/2020,10,9,0,19
TREUTLEN,6/9/2020,10,9,0,19
TREUTLEN,6/10/2020,10,9,0,19
TREUTLEN,6/11/2020,11,9,0,20
TREUTLEN,6/12/2020,11,9,0,20
TREUTLEN,6/13/2020,11,9,0,20
TREUTLEN,6/14/2020,11,9,0,20
TREUTLEN,6/15/2020,12,9,0,21
TREUTLEN,6/16/2020,12,10,0,22
TREUTLEN,6/17/2020,13,10,0,23
TREUTLEN,6/18/2020,13,10,0,23
TREUTLEN,6/19/2020,14,10,0,24
TREUTLEN,6/20/2020,14,10,0,24
TREUTLEN,6/21/2020,14,11,0,25
TREUTLEN,6/22/2020,16,11,0,27
TREUTLEN,6/23/2020,16,11,4,31
TREUTLEN,6/24/2020,17,12,4,33
TREUTLEN,6/25/2020,17,12,4,33
TREUTLEN,6/26/2020,18,13,4,35
TREUTLEN,6/27/2020,18,13,4,35
TREUTLEN,6/28/2020,19,13,4,36
TREUTLEN,6/29/2020,22,16,4,42
TREUTLEN,6/30/2020,23,17,4,44
TREUTLEN,7/1/2020,25,17,4,46
TREUTLEN,7/2/2020,25,19,4,48
TREUTLEN,7/3/2020,25,20,4,49
TREUTLEN,7/4/2020,25,22,4,51
TREUTLEN,7/5/2020,27,22,4,53
TREUTLEN,7/6/2020,28,23,4,55
TREUTLEN,7/7/2020,28,25,4,57
TREUTLEN,7/8/2020,31,25,4,60
TREUTLEN,7/9/2020,31,26,4,61
TREUTLEN,7/10/2020,31,26,4,61
TREUTLEN,7/11/2020,32,26,4,62
TREUTLEN,7/12/2020,35,27,4,66
TREUTLEN,7/13/2020,36,27,4,67
TREUTLEN,7/14/2020,39,27,4,70
TREUTLEN,7/15/2020,40,28,4,72
TREUTLEN,7/16/2020,44,29,4,77
TREUTLEN,7/17/2020,47,29,4,80
TREUTLEN,7/18/2020,49,30,4,83
TREUTLEN,7/19/2020,51,30,4,85
TREUTLEN,7/20/2020,52,33,4,89
TREUTLEN,7/21/2020,53,33,5,91
TREUTLEN,7/22/2020,55,35,5,95
TREUTLEN,7/23/2020,57,36,5,98
TREUTLEN,7/24/2020,58,38,5,101
TREUTLEN,7/25/2020,60,39,5,104
TREUTLEN,7/26/2020,60,40,5,105
TREUTLEN,7/27/2020,62,41,5,108
TREUTLEN,7/28/2020,64,44,5,113
TREUTLEN,7/29/2020,67,49,5,121
TREUTLEN,7/30/2020,69,50,5,124
TREUTLEN,7/31/2020,70,52,5,127
TREUTLEN,8/1/2020,70,53,5,128
TREUTLEN,8/2/2020,72,54,5,131
TREUTLEN,8/3/2020,74,55,5,134
TREUTLEN,8/4/2020,77,55,5,137
TREUTLEN,8/5/2020,79,55,5,139
TREUTLEN,8/6/2020,79,55,5,139
TREUTLEN,8/7/2020,81,55,5,141
TREUTLEN,8/8/2020,81,57,5,143
TREUTLEN,8/9/2020,82,59,5,146
TREUTLEN,8/10/2020,86,62,5,153
TREUTLEN,8/11/2020,87,64,5,156
TREUTLEN,8/12/2020,89,68,5,162
TREUTLEN,8/13/2020,92,70,5,167
TREUTLEN,8/14/2020,93,71,5,169
TREUTLEN,8/15/2020,96,72,5,173
TREUTLEN,8/16/2020,99,74,5,178
TREUTLEN,8/17/2020,103,75,5,183
TREUTLEN,8/18/2020,103,76,5,184
TREUTLEN,8/19/2020,106,77,5,188
TREUTLEN,8/20/2020,107,79,5,191
TREUTLEN,8/21/2020,108,79,5,192
TREUTLEN,8/22/2020,110,80,5,195
TREUTLEN,8/23/2020,113,80,5,198
TREUTLEN,8/24/2020,116,82,5,203
TREUTLEN,8/25/2020,120,83,5,208
TREUTLEN,8/26/2020,121,84,5,210
TREUTLEN,8/27/2020,123,86,5,214
TREUTLEN,8/28/2020,123,87,5,215
TREUTLEN,8/29/2020,128,90,5,223
TREUTLEN,8/30/2020,129,91,5,225
TREUTLEN,8/31/2020,131,92,5,228
TREUTLEN,9/1/2020,131,93,5,229
TREUTLEN,9/2/2020,133,93,5,231
TREUTLEN,9/3/2020,135,93,5,233
TREUTLEN,9/4/2020,137,94,5,236
TREUTLEN,9/5/2020,138,95,5,238
TREUTLEN,9/6/2020,138,96,5,239
TREUTLEN,9/7/2020,139,97,5,241
TREUTLEN,9/8/2020,140,97,5,242
TREUTLEN,9/9/2020,143,97,5,245
TREUTLEN,9/10/2020,143,97,5,245
TREUTLEN,9/11/2020,144,97,5,246
TREUTLEN,9/12/2020,144,97,5,246
TREUTLEN,9/13/2020,144,97,5,246
TREUTLEN,9/14/2020,145,97,5,247
TREUTLEN,9/15/2020,145,97,5,247
TREUTLEN,9/16/2020,146,98,5,249
TREUTLEN,9/17/2020,148,98,5,251
TREUTLEN,9/18/2020,150,98,5,253
TREUTLEN,9/19/2020,151,98,5,254
TREUTLEN,9/20/2020,152,98,5,255
TREUTLEN,9/21/2020,153,99,5,257
TREUTLEN,9/22/2020,155,99,5,259
TREUTLEN,9/23/2020,156,99,5,260
TREUTLEN,9/24/2020,156,100,5,261
TREUTLEN,9/25/2020,156,100,5,261
TREUTLEN,9/26/2020,156,101,5,262
TREUTLEN,9/27/2020,156,101,5,262
TREUTLEN,9/28/2020,160,101,5,266
TREUTLEN,9/29/2020,162,101,5,268
TREUTLEN,9/30/2020,162,101,5,268
TREUTLEN,10/1/2020,162,101,5,268
TREUTLEN,10/2/2020,162,101,5,268
TREUTLEN,10/3/2020,162,101,5,268
TREUTLEN,10/4/2020,162,102,5,269
TREUTLEN,10/5/2020,166,102,5,273
TREUTLEN,10/6/2020,167,102,5,274
TREUTLEN,10/7/2020,168,103,5,276
TREUTLEN,10/8/2020,169,106,5,280
TREUTLEN,10/9/2020,170,108,5,283
TREUTLEN,10/10/2020,171,108,5,284
TREUTLEN,10/11/2020,171,108,5,284
TREUTLEN,10/12/2020,172,109,5,286
TREUTLEN,10/13/2020,174,110,5,289
TREUTLEN,10/14/2020,177,111,5,293
TREUTLEN,10/15/2020,177,111,5,293
TREUTLEN,10/16/2020,177,111,5,293
TREUTLEN,10/17/2020,178,112,5,295
TREUTLEN,10/18/2020,178,112,5,295
TREUTLEN,10/19/2020,178,112,5,295
TREUTLEN,10/20/2020,178,112,5,295
TROUP,1/1/2020,0,0,0,0
TROUP,1/2/2020,0,0,0,0
TROUP,1/3/2020,0,0,0,0
TROUP,1/4/2020,0,0,0,0
TROUP,1/5/2020,0,0,0,0
TROUP,1/6/2020,0,0,0,0
TROUP,1/7/2020,0,0,0,0
TROUP,1/8/2020,0,0,0,0
TROUP,1/9/2020,0,0,0,0
TROUP,1/10/2020,0,0,0,0
TROUP,1/11/2020,0,0,0,0
TROUP,1/12/2020,0,0,0,0
TROUP,1/13/2020,0,0,0,0
TROUP,1/14/2020,0,0,0,0
TROUP,1/15/2020,0,0,0,0
TROUP,1/16/2020,0,0,0,0
TROUP,1/17/2020,0,0,0,0
TROUP,1/18/2020,0,0,0,0
TROUP,1/19/2020,0,0,0,0
TROUP,1/20/2020,0,0,0,0
TROUP,1/21/2020,0,0,0,0
TROUP,1/22/2020,0,0,0,0
TROUP,1/23/2020,0,0,0,0
TROUP,1/24/2020,0,0,0,0
TROUP,1/25/2020,0,0,0,0
TROUP,1/26/2020,0,0,0,0
TROUP,1/27/2020,0,0,0,0
TROUP,1/28/2020,0,0,0,0
TROUP,1/29/2020,0,0,0,0
TROUP,1/30/2020,0,0,0,0
TROUP,1/31/2020,0,0,0,0
TROUP,2/1/2020,0,0,0,0
TROUP,2/2/2020,0,0,0,0
TROUP,2/3/2020,0,0,0,0
TROUP,2/4/2020,0,0,0,0
TROUP,2/5/2020,0,0,0,0
TROUP,2/6/2020,0,0,0,0
TROUP,2/7/2020,0,0,0,0
TROUP,2/8/2020,0,0,0,0
TROUP,2/9/2020,0,0,0,0
TROUP,2/10/2020,0,0,0,0
TROUP,2/11/2020,0,0,0,0
TROUP,2/12/2020,0,0,0,0
TROUP,2/13/2020,0,0,0,0
TROUP,2/14/2020,0,0,0,0
TROUP,2/15/2020,0,0,0,0
TROUP,2/16/2020,0,0,0,0
TROUP,2/17/2020,0,0,0,0
TROUP,2/18/2020,0,0,0,0
TROUP,2/19/2020,0,0,0,0
TROUP,2/20/2020,0,0,0,0
TROUP,2/21/2020,0,0,0,0
TROUP,2/22/2020,0,0,0,0
TROUP,2/23/2020,0,0,0,0
TROUP,2/24/2020,0,0,0,0
TROUP,2/25/2020,0,0,0,0
TROUP,2/26/2020,0,0,0,0
TROUP,2/27/2020,0,0,0,0
TROUP,2/28/2020,0,0,0,0
TROUP,2/29/2020,1,0,0,1
TROUP,3/1/2020,1,0,0,1
TROUP,3/2/2020,6,1,0,7
TROUP,3/3/2020,6,1,0,7
TROUP,3/4/2020,6,1,0,7
TROUP,3/5/2020,7,1,0,8
TROUP,3/6/2020,7,1,0,8
TROUP,3/7/2020,7,1,0,8
TROUP,3/8/2020,7,2,0,9
TROUP,3/9/2020,8,2,0,10
TROUP,3/10/2020,8,3,0,11
TELFAIR,8/22/2020,173,164,3,340
TOOMBS,6/1/2020,52,44,0,96
TATTNALL,5/8/2020,4,9,0,13
TIFT,2/16/2020,0,0,0,0
TATTNALL,5/9/2020,4,9,0,13
TATTNALL,5/10/2020,4,9,0,13
TATTNALL,5/11/2020,5,9,0,14
TATTNALL,5/12/2020,5,10,0,15
TATTNALL,5/13/2020,6,12,0,18
TATTNALL,5/14/2020,8,12,0,20
TATTNALL,5/15/2020,8,13,0,21
TATTNALL,5/16/2020,8,13,0,21
TATTNALL,5/17/2020,8,14,0,22
TATTNALL,5/18/2020,8,15,0,23
TATTNALL,5/19/2020,8,16,0,24
TATTNALL,5/20/2020,8,16,0,24
TATTNALL,5/21/2020,8,16,0,24
TATTNALL,5/22/2020,10,16,0,26
TATTNALL,5/23/2020,10,18,0,28
TATTNALL,5/24/2020,11,18,0,29
TATTNALL,5/25/2020,11,18,0,29
TATTNALL,5/26/2020,12,19,0,31
TATTNALL,5/27/2020,13,20,0,33
TATTNALL,5/28/2020,15,21,0,36
TATTNALL,5/29/2020,15,21,0,36
TATTNALL,5/30/2020,15,21,0,36
TATTNALL,5/31/2020,15,21,0,36
TATTNALL,6/1/2020,17,21,0,38
TATTNALL,6/2/2020,18,21,0,39
TATTNALL,6/3/2020,21,23,0,44
TATTNALL,6/4/2020,21,24,0,45
TATTNALL,6/5/2020,23,26,0,49
TATTNALL,6/6/2020,23,27,0,50
TATTNALL,6/7/2020,25,27,0,52
TATTNALL,6/8/2020,28,29,0,57
TATTNALL,6/9/2020,31,31,0,62
TATTNALL,6/10/2020,33,35,0,68
TATTNALL,6/11/2020,39,43,0,82
TIFT,2/17/2020,0,0,0,0
TELFAIR,8/23/2020,174,165,3,342
TATTNALL,6/12/2020,42,49,0,91
TATTNALL,6/13/2020,45,51,0,96
TATTNALL,6/14/2020,51,51,0,102
TATTNALL,6/15/2020,55,55,0,110
TATTNALL,6/16/2020,57,55,0,112
TATTNALL,6/17/2020,63,58,0,121
TATTNALL,6/18/2020,71,62,0,133
TATTNALL,6/19/2020,71,64,0,135
TATTNALL,6/20/2020,72,66,0,138
TATTNALL,6/21/2020,73,67,0,140
TATTNALL,6/22/2020,81,73,0,154
TATTNALL,6/23/2020,84,74,0,158
TATTNALL,6/24/2020,85,78,0,163
TATTNALL,6/25/2020,85,82,0,167
TATTNALL,6/26/2020,90,84,0,174
TATTNALL,6/27/2020,92,88,0,180
TATTNALL,6/28/2020,92,88,0,180
TATTNALL,6/29/2020,94,94,0,188
TATTNALL,6/30/2020,99,97,1,197
TOOMBS,6/2/2020,56,45,0,101
TATTNALL,7/1/2020,107,103,2,212
TATTNALL,7/2/2020,109,103,2,214
TATTNALL,7/3/2020,110,104,2,216
TATTNALL,7/4/2020,110,107,2,219
TATTNALL,7/5/2020,110,111,2,223
TATTNALL,7/6/2020,112,117,2,231
TATTNALL,7/7/2020,116,122,2,240
TATTNALL,7/8/2020,121,127,2,250
TATTNALL,7/9/2020,127,130,2,259
TATTNALL,7/10/2020,130,137,2,269
TATTNALL,7/11/2020,131,139,2,272
TATTNALL,7/12/2020,133,142,2,277
TATTNALL,7/13/2020,143,150,3,296
TATTNALL,7/14/2020,151,158,4,313
TATTNALL,7/15/2020,161,168,6,335
TATTNALL,7/16/2020,168,176,6,350
TATTNALL,7/17/2020,176,186,6,368
TATTNALL,7/18/2020,179,186,6,371
TATTNALL,7/19/2020,185,188,6,379
TATTNALL,7/20/2020,189,196,6,391
TATTNALL,7/21/2020,194,201,6,401
TATTNALL,7/22/2020,202,203,6,411
TATTNALL,7/23/2020,207,207,6,420
TATTNALL,7/24/2020,210,211,6,427
TATTNALL,7/25/2020,212,215,6,433
TATTNALL,7/26/2020,214,217,6,437
TATTNALL,7/27/2020,219,223,6,448
TATTNALL,7/28/2020,228,226,6,460
TATTNALL,7/29/2020,234,233,6,473
TATTNALL,7/30/2020,237,236,7,480
TATTNALL,7/31/2020,242,241,7,490
TATTNALL,8/1/2020,246,243,7,496
TATTNALL,8/2/2020,249,246,7,502
TATTNALL,8/3/2020,255,256,8,519
TATTNALL,8/4/2020,261,265,8,534
TATTNALL,8/5/2020,267,276,9,552
TATTNALL,8/6/2020,272,281,10,563
TATTNALL,8/7/2020,281,285,11,577
TATTNALL,8/8/2020,283,290,11,584
TATTNALL,8/9/2020,286,293,11,590
TATTNALL,8/10/2020,292,301,12,605
TATTNALL,8/11/2020,300,303,13,616
TATTNALL,8/12/2020,304,308,13,625
TATTNALL,8/13/2020,307,313,13,633
TATTNALL,8/14/2020,308,319,13,640
TATTNALL,8/15/2020,312,320,13,645
TATTNALL,8/16/2020,312,320,13,645
TATTNALL,8/17/2020,316,329,13,658
TATTNALL,8/18/2020,319,332,13,664
TATTNALL,8/19/2020,320,332,13,665
TATTNALL,8/20/2020,321,334,13,668
TATTNALL,8/21/2020,323,338,13,674
TATTNALL,8/22/2020,327,338,13,678
TATTNALL,8/23/2020,329,338,13,680
TATTNALL,8/24/2020,332,340,13,685
TATTNALL,8/25/2020,338,342,13,693
TATTNALL,8/26/2020,341,343,13,697
TATTNALL,8/27/2020,343,344,13,700
TATTNALL,8/28/2020,345,349,13,707
TATTNALL,8/29/2020,349,351,13,713
TATTNALL,8/30/2020,350,352,13,715
TATTNALL,8/31/2020,353,355,13,721
TATTNALL,9/1/2020,354,358,13,725
TATTNALL,9/2/2020,356,360,13,729
TATTNALL,9/3/2020,357,363,13,733
TATTNALL,9/4/2020,361,365,13,739
TATTNALL,9/5/2020,364,368,13,745
TATTNALL,9/6/2020,365,371,13,749
TATTNALL,9/7/2020,366,374,13,753
TATTNALL,9/8/2020,368,377,13,758
TATTNALL,9/9/2020,371,381,13,765
TATTNALL,9/10/2020,376,382,13,771
TATTNALL,9/11/2020,381,386,13,780
TATTNALL,9/12/2020,381,388,13,782
TATTNALL,9/13/2020,382,389,13,784
TATTNALL,9/14/2020,383,390,13,786
TATTNALL,9/15/2020,385,395,13,793
TATTNALL,9/16/2020,389,399,13,801
TATTNALL,9/17/2020,397,404,13,814
TATTNALL,9/18/2020,399,407,13,819
TATTNALL,9/19/2020,401,408,13,822
TATTNALL,9/20/2020,403,408,13,824
TATTNALL,9/21/2020,412,412,13,837
TATTNALL,9/22/2020,413,413,13,839
TATTNALL,9/23/2020,415,416,13,844
TATTNALL,9/24/2020,416,416,13,845
TATTNALL,9/25/2020,416,417,13,846
TATTNALL,9/26/2020,416,417,13,846
TATTNALL,9/27/2020,417,417,13,847
TATTNALL,9/28/2020,420,418,13,851
TATTNALL,9/29/2020,420,418,13,851
TATTNALL,9/30/2020,422,422,13,857
TATTNALL,10/1/2020,422,424,13,859
TATTNALL,10/2/2020,423,426,13,862
TATTNALL,10/3/2020,423,427,13,863
TATTNALL,10/4/2020,424,428,13,865
TATTNALL,10/5/2020,424,433,13,870
TATTNALL,10/6/2020,425,437,13,875
TATTNALL,10/7/2020,427,437,13,877
TATTNALL,10/8/2020,428,439,13,880
TATTNALL,10/9/2020,428,440,13,881
TATTNALL,10/10/2020,428,442,13,883
TATTNALL,10/11/2020,429,442,13,884
TATTNALL,10/12/2020,429,442,13,884
TATTNALL,10/13/2020,430,455,13,898
TATTNALL,10/14/2020,431,457,13,901
TATTNALL,10/15/2020,431,461,13,905
TATTNALL,10/16/2020,432,463,13,908
TATTNALL,10/17/2020,432,463,13,908
TATTNALL,10/18/2020,432,463,13,908
TATTNALL,10/19/2020,432,463,13,908
TATTNALL,10/20/2020,432,463,13,908
TELFAIR,1/1/2020,0,0,0,0
TELFAIR,1/2/2020,0,0,0,0
TELFAIR,1/3/2020,0,0,0,0
TELFAIR,1/4/2020,0,0,0,0
TELFAIR,1/5/2020,0,0,0,0
TELFAIR,1/6/2020,0,0,0,0
TELFAIR,1/7/2020,0,0,0,0
TELFAIR,1/8/2020,0,0,0,0
TELFAIR,1/9/2020,0,0,0,0
TELFAIR,1/10/2020,0,0,0,0
TELFAIR,1/11/2020,0,0,0,0
TELFAIR,1/12/2020,0,0,0,0
TELFAIR,1/13/2020,0,0,0,0
TELFAIR,1/14/2020,0,0,0,0
TELFAIR,1/15/2020,0,0,0,0
TELFAIR,1/16/2020,0,0,0,0
TELFAIR,1/17/2020,0,0,0,0
TELFAIR,1/18/2020,0,0,0,0
TELFAIR,1/19/2020,0,0,0,0
TELFAIR,1/20/2020,0,0,0,0
TELFAIR,1/21/2020,0,0,0,0
TELFAIR,1/22/2020,0,0,0,0
TELFAIR,1/23/2020,0,0,0,0
TELFAIR,1/24/2020,0,0,0,0
TELFAIR,1/25/2020,0,0,0,0
TELFAIR,1/26/2020,0,0,0,0
TELFAIR,1/27/2020,0,0,0,0
TELFAIR,1/28/2020,0,0,0,0
TELFAIR,1/29/2020,0,0,0,0
TELFAIR,1/30/2020,0,0,0,0
TELFAIR,1/31/2020,0,0,0,0
TELFAIR,2/1/2020,0,0,0,0
TELFAIR,2/2/2020,0,0,0,0
TELFAIR,2/3/2020,0,0,0,0
TELFAIR,2/4/2020,0,0,0,0
TELFAIR,2/5/2020,0,0,0,0
TELFAIR,2/6/2020,0,0,0,0
TELFAIR,2/7/2020,0,0,0,0
TELFAIR,2/8/2020,0,0,0,0
TELFAIR,2/9/2020,0,0,0,0
TELFAIR,2/10/2020,0,0,0,0
TELFAIR,2/11/2020,0,0,0,0
TELFAIR,2/12/2020,0,0,0,0
TELFAIR,2/13/2020,0,0,0,0
TELFAIR,2/14/2020,0,0,0,0
TELFAIR,2/15/2020,0,0,0,0
TELFAIR,2/16/2020,0,0,0,0
TELFAIR,2/17/2020,0,0,0,0
TELFAIR,2/18/2020,0,0,0,0
TELFAIR,2/19/2020,0,0,0,0
TELFAIR,2/20/2020,0,0,0,0
TELFAIR,2/21/2020,0,0,0,0
TELFAIR,2/22/2020,0,0,0,0
TELFAIR,2/23/2020,0,0,0,0
TELFAIR,2/24/2020,0,0,0,0
TELFAIR,2/25/2020,0,0,0,0
TELFAIR,2/26/2020,0,0,0,0
TELFAIR,2/27/2020,0,0,0,0
TELFAIR,2/28/2020,0,0,0,0
TELFAIR,2/29/2020,0,0,0,0
TELFAIR,3/1/2020,0,0,0,0
TELFAIR,3/2/2020,0,0,0,0
TELFAIR,3/3/2020,0,0,0,0
TELFAIR,3/4/2020,0,0,0,0
TELFAIR,3/5/2020,0,0,0,0
TELFAIR,3/6/2020,0,0,0,0
TELFAIR,3/7/2020,0,0,0,0
TELFAIR,3/8/2020,0,0,0,0
TELFAIR,3/9/2020,0,0,0,0
TELFAIR,3/10/2020,0,0,0,0
TELFAIR,3/11/2020,0,0,0,0
TELFAIR,3/12/2020,0,0,0,0
TELFAIR,3/13/2020,0,0,0,0
TELFAIR,3/14/2020,0,0,0,0
TELFAIR,3/15/2020,0,0,0,0
TELFAIR,3/16/2020,0,0,0,0
TELFAIR,3/17/2020,0,0,0,0
TELFAIR,3/18/2020,0,0,0,0
TELFAIR,3/19/2020,0,0,0,0
TELFAIR,3/20/2020,0,0,0,0
TELFAIR,3/21/2020,0,0,0,0
TELFAIR,3/22/2020,0,0,0,0
TELFAIR,3/23/2020,0,0,0,0
TELFAIR,3/24/2020,0,0,0,0
TELFAIR,3/25/2020,0,0,0,0
TELFAIR,3/26/2020,0,2,0,2
TELFAIR,3/27/2020,0,2,0,2
TELFAIR,3/28/2020,0,2,0,2
TELFAIR,3/29/2020,1,2,0,3
TELFAIR,3/30/2020,1,2,0,3
TELFAIR,3/31/2020,1,2,0,3
TELFAIR,4/1/2020,1,3,0,4
TELFAIR,4/2/2020,1,4,0,5
TELFAIR,4/3/2020,1,5,0,6
TELFAIR,4/4/2020,1,5,0,6
TELFAIR,4/5/2020,1,5,0,6
TELFAIR,4/6/2020,3,7,0,10
TELFAIR,4/7/2020,4,7,0,11
TELFAIR,4/8/2020,4,8,0,12
TELFAIR,4/9/2020,4,8,0,12
TELFAIR,4/10/2020,5,9,0,14
TELFAIR,4/11/2020,5,9,0,14
TELFAIR,4/12/2020,5,9,0,14
TELFAIR,4/13/2020,5,12,0,17
TELFAIR,4/14/2020,6,13,0,19
TELFAIR,4/15/2020,6,13,0,19
TELFAIR,4/16/2020,6,13,0,19
TELFAIR,4/17/2020,6,13,0,19
TELFAIR,4/18/2020,6,14,0,20
TELFAIR,4/19/2020,6,14,0,20
TELFAIR,4/20/2020,6,16,0,22
TELFAIR,4/21/2020,6,16,0,22
TELFAIR,4/22/2020,6,16,0,22
TELFAIR,4/23/2020,6,16,0,22
TELFAIR,4/24/2020,8,16,0,24
TELFAIR,4/25/2020,10,16,0,26
TELFAIR,4/26/2020,10,16,0,26
TELFAIR,4/27/2020,11,16,0,27
TELFAIR,4/28/2020,11,16,0,27
TELFAIR,4/29/2020,11,16,0,27
TELFAIR,4/30/2020,11,16,0,27
TELFAIR,5/1/2020,11,16,0,27
TELFAIR,5/2/2020,11,17,0,28
TELFAIR,5/3/2020,11,17,0,28
TELFAIR,5/4/2020,12,17,0,29
TELFAIR,5/5/2020,13,17,0,30
TELFAIR,5/6/2020,13,17,0,30
TELFAIR,5/7/2020,13,19,0,32
TELFAIR,5/8/2020,13,19,0,32
TELFAIR,5/9/2020,13,19,0,32
TELFAIR,5/10/2020,13,19,0,32
TELFAIR,5/11/2020,14,19,0,33
TELFAIR,5/12/2020,15,19,0,34
TELFAIR,5/13/2020,15,19,0,34
TELFAIR,5/14/2020,15,19,0,34
TELFAIR,5/15/2020,15,19,0,34
TELFAIR,5/16/2020,15,19,0,34
TELFAIR,5/17/2020,15,19,0,34
TELFAIR,5/18/2020,15,19,0,34
TELFAIR,5/19/2020,16,19,0,35
TELFAIR,5/20/2020,16,19,0,35
TELFAIR,5/21/2020,16,19,0,35
TELFAIR,5/22/2020,16,20,0,36
TELFAIR,5/23/2020,16,20,0,36
TELFAIR,5/24/2020,16,20,0,36
TELFAIR,5/25/2020,16,20,0,36
TELFAIR,5/26/2020,17,21,0,38
TELFAIR,5/27/2020,17,21,0,38
TELFAIR,5/28/2020,18,21,0,39
TELFAIR,5/29/2020,18,21,0,39
TELFAIR,5/30/2020,18,22,0,40
TELFAIR,5/31/2020,18,22,0,40
TELFAIR,6/1/2020,18,23,0,41
TELFAIR,6/2/2020,18,23,0,41
TELFAIR,6/3/2020,18,23,0,41
TELFAIR,6/4/2020,19,23,0,42
TELFAIR,6/5/2020,20,23,0,43
TELFAIR,6/6/2020,21,23,0,44
TELFAIR,6/7/2020,21,24,0,45
TELFAIR,6/8/2020,22,25,0,47
TELFAIR,6/9/2020,26,29,0,55
TELFAIR,6/10/2020,26,32,0,58
TELFAIR,6/11/2020,29,32,0,61
TELFAIR,6/12/2020,31,33,0,64
TELFAIR,6/13/2020,31,33,0,64
TELFAIR,6/14/2020,32,33,0,65
TELFAIR,6/15/2020,33,33,0,66
TELFAIR,6/16/2020,33,33,0,66
TELFAIR,6/17/2020,33,35,0,68
TELFAIR,6/18/2020,33,36,0,69
TELFAIR,6/19/2020,36,38,0,74
TELFAIR,6/20/2020,39,40,0,79
TELFAIR,6/21/2020,40,41,0,81
TELFAIR,6/22/2020,43,41,0,84
TELFAIR,6/23/2020,48,42,0,90
TELFAIR,6/24/2020,56,54,0,110
TELFAIR,6/25/2020,59,59,0,118
TELFAIR,6/26/2020,62,59,0,121
TELFAIR,6/27/2020,65,61,0,126
TELFAIR,6/28/2020,66,62,0,128
TELFAIR,6/29/2020,66,65,0,131
TELFAIR,6/30/2020,68,67,0,135
TELFAIR,7/1/2020,70,67,0,137
TELFAIR,7/2/2020,72,67,0,139
TELFAIR,7/3/2020,74,68,0,142
TELFAIR,7/4/2020,74,70,0,144
TELFAIR,7/5/2020,78,70,0,148
TELFAIR,7/6/2020,87,83,0,170
TELFAIR,7/7/2020,95,85,0,180
TELFAIR,7/8/2020,97,85,0,182
TELFAIR,7/9/2020,100,88,0,188
TELFAIR,7/10/2020,106,90,0,196
TELFAIR,7/11/2020,108,93,0,201
TELFAIR,7/12/2020,110,97,0,207
TELFAIR,7/13/2020,113,97,0,210
TELFAIR,7/14/2020,120,101,2,223
TELFAIR,7/15/2020,122,102,2,226
TELFAIR,7/16/2020,122,102,2,226
TELFAIR,7/17/2020,122,103,2,227
TELFAIR,7/18/2020,124,103,2,229
TELFAIR,7/19/2020,124,104,2,230
TELFAIR,7/20/2020,125,107,2,234
TELFAIR,7/21/2020,126,107,2,235
TELFAIR,7/22/2020,127,114,2,243
TELFAIR,7/23/2020,128,115,2,245
TELFAIR,7/24/2020,130,116,2,248
TELFAIR,7/25/2020,130,116,2,248
TELFAIR,7/26/2020,131,118,2,251
TELFAIR,7/27/2020,134,120,2,256
TELFAIR,7/28/2020,135,121,2,258
TELFAIR,7/29/2020,138,121,2,261
TELFAIR,7/30/2020,140,122,2,264
TELFAIR,7/31/2020,150,132,3,285
TELFAIR,8/1/2020,153,133,3,289
TELFAIR,8/2/2020,153,134,3,290
TELFAIR,8/3/2020,154,136,3,293
TELFAIR,8/4/2020,154,139,3,296
TELFAIR,8/5/2020,155,141,3,299
TELFAIR,8/6/2020,155,141,3,299
TELFAIR,8/7/2020,160,143,3,306
TELFAIR,8/8/2020,160,144,3,307
TELFAIR,8/9/2020,160,145,3,308
TELFAIR,8/10/2020,162,145,3,310
TELFAIR,8/11/2020,164,148,3,315
TELFAIR,8/12/2020,166,148,3,317
TELFAIR,8/13/2020,167,148,3,318
TELFAIR,8/14/2020,167,150,3,320
TELFAIR,8/15/2020,169,150,3,322
TELFAIR,8/16/2020,169,152,3,324
TELFAIR,8/17/2020,169,154,3,326
TELFAIR,8/18/2020,169,154,3,326
TELFAIR,8/19/2020,169,156,3,328
TELFAIR,8/20/2020,170,158,3,331
TELFAIR,8/21/2020,171,163,3,337
TELFAIR,8/24/2020,174,167,3,344
TELFAIR,8/25/2020,175,167,3,345
TELFAIR,8/26/2020,176,169,3,348
TELFAIR,8/27/2020,179,170,3,352
TELFAIR,8/28/2020,181,170,3,354
TELFAIR,8/29/2020,181,170,3,354
TELFAIR,8/30/2020,182,170,3,355
TELFAIR,8/31/2020,184,172,3,359
TELFAIR,9/1/2020,184,173,3,360
TELFAIR,9/2/2020,185,175,3,363
TELFAIR,9/3/2020,188,176,3,367
TELFAIR,9/4/2020,188,176,3,367
TOOMBS,6/3/2020,61,48,0,109
TOOMBS,6/4/2020,63,54,0,117
TOOMBS,6/5/2020,64,60,0,124
TOOMBS,6/6/2020,65,64,0,129
TIFT,2/18/2020,0,0,0,0
TOOMBS,6/7/2020,66,66,0,132
TOOMBS,6/8/2020,67,72,0,139
TOOMBS,6/9/2020,71,81,1,153
TOOMBS,6/10/2020,76,95,1,172
TOOMBS,6/11/2020,79,96,1,176
TOOMBS,6/12/2020,82,97,1,180
TOOMBS,6/13/2020,84,101,1,186
TOOMBS,6/14/2020,84,105,1,190
TOOMBS,6/15/2020,87,107,1,195
TOOMBS,6/16/2020,103,136,1,240
TOOMBS,6/17/2020,104,138,1,243
TOOMBS,6/18/2020,106,142,1,249
TOOMBS,6/19/2020,108,142,1,251
TOOMBS,6/20/2020,109,142,1,252
TOOMBS,6/21/2020,111,145,1,257
TOOMBS,6/22/2020,118,150,2,270
TOOMBS,6/23/2020,123,156,2,281
TOOMBS,6/24/2020,130,159,2,291
TOOMBS,6/25/2020,138,163,2,303
TELFAIR,9/5/2020,188,176,3,367
TOOMBS,6/26/2020,140,163,2,305
TOOMBS,6/27/2020,142,167,2,311
TOOMBS,6/28/2020,142,169,2,313
TOOMBS,6/29/2020,145,173,2,320
TOOMBS,6/30/2020,154,179,2,335
TOOMBS,7/1/2020,160,187,2,349
TOOMBS,7/2/2020,163,189,2,354
TOOMBS,7/3/2020,166,193,2,361
TOOMBS,7/4/2020,171,195,2,368
TOOMBS,7/5/2020,174,199,2,375
TOOMBS,7/6/2020,184,202,2,388
TOOMBS,7/7/2020,187,209,2,398
TOOMBS,7/8/2020,191,211,2,404
TOOMBS,7/9/2020,199,217,2,418
TOOMBS,7/10/2020,206,219,2,427
TOOMBS,7/11/2020,209,224,2,435
TOOMBS,7/12/2020,212,230,2,444
TOOMBS,7/13/2020,224,237,2,463
TOOMBS,7/14/2020,234,240,2,476
TOOMBS,7/15/2020,254,251,3,508
TOOMBS,7/16/2020,259,254,3,516
TOOMBS,7/17/2020,267,257,4,528
TOOMBS,7/18/2020,270,257,4,531
TOOMBS,7/19/2020,277,257,4,538
TOOMBS,7/20/2020,291,267,4,562
TOOMBS,7/21/2020,302,274,4,580
TOOMBS,7/22/2020,316,283,4,603
TOOMBS,7/23/2020,325,289,4,618
TOOMBS,7/24/2020,331,291,6,628
TOOMBS,7/25/2020,337,294,7,638
TOOMBS,7/26/2020,341,296,7,644
TOOMBS,7/27/2020,348,304,7,659
TOOMBS,7/28/2020,358,313,7,678
TOOMBS,7/29/2020,372,324,7,703
TOOMBS,7/30/2020,384,331,7,722
TOOMBS,7/31/2020,404,339,7,750
TOOMBS,8/1/2020,411,344,7,762
TOOMBS,8/2/2020,414,347,7,768
TOOMBS,8/3/2020,423,357,7,787
TOOMBS,8/4/2020,429,363,7,799
TOOMBS,8/5/2020,444,373,7,824
TOOMBS,8/6/2020,448,378,7,833
TOOMBS,8/7/2020,452,383,7,842
TOOMBS,8/8/2020,461,386,7,854
TOOMBS,8/9/2020,471,388,7,866
TOOMBS,8/10/2020,480,394,7,881
TOOMBS,8/11/2020,495,399,7,901
TOOMBS,8/12/2020,519,406,9,934
TOOMBS,8/13/2020,528,415,9,952
TOOMBS,8/14/2020,535,420,9,964
TOOMBS,8/15/2020,540,426,9,975
TOOMBS,8/16/2020,545,430,9,984
TOOMBS,8/17/2020,552,437,9,998
TOOMBS,8/18/2020,558,443,9,1010
TOOMBS,8/19/2020,569,455,9,1033
TOOMBS,8/20/2020,572,461,10,1043
TOOMBS,8/21/2020,578,466,10,1054
TOOMBS,8/22/2020,590,468,11,1069
TOOMBS,8/23/2020,595,469,11,1075
TOOMBS,8/24/2020,600,474,11,1085
TOOMBS,8/25/2020,610,484,11,1105
TOOMBS,8/26/2020,613,490,11,1114
TOOMBS,8/27/2020,623,494,11,1128
TOOMBS,8/28/2020,626,499,11,1136
TOOMBS,8/29/2020,631,500,11,1142
TOOMBS,8/30/2020,636,502,11,1149
TOOMBS,8/31/2020,650,506,11,1167
TOOMBS,9/1/2020,663,512,11,1186
TOOMBS,9/2/2020,668,516,11,1195
TOOMBS,9/3/2020,676,519,11,1206
TOOMBS,9/4/2020,680,528,11,1219
TOOMBS,9/5/2020,688,533,11,1232
TOOMBS,9/6/2020,692,538,11,1241
TOOMBS,9/7/2020,696,539,11,1246
TOOMBS,9/8/2020,702,548,11,1261
TOOMBS,9/9/2020,705,552,11,1268
TOOMBS,9/10/2020,708,555,11,1274
TOOMBS,9/11/2020,708,558,11,1277
TOOMBS,9/12/2020,713,558,11,1282
TOOMBS,9/13/2020,715,561,11,1287
TOOMBS,9/14/2020,721,566,11,1298
TOOMBS,9/15/2020,727,568,11,1306
TOOMBS,9/16/2020,729,570,11,1310
TOOMBS,9/17/2020,730,573,11,1314
TOOMBS,9/18/2020,733,576,11,1320
TOOMBS,9/19/2020,736,578,11,1325
TOOMBS,9/20/2020,737,580,11,1328
TOOMBS,9/21/2020,738,586,11,1335
TOOMBS,9/22/2020,740,588,11,1339
TOOMBS,9/23/2020,741,589,11,1341
TOOMBS,9/24/2020,741,590,11,1342
TOOMBS,9/25/2020,742,592,11,1345
TOOMBS,9/26/2020,744,594,11,1349
TOOMBS,9/27/2020,751,597,11,1359
TOOMBS,9/28/2020,757,600,11,1368
TOOMBS,9/29/2020,759,601,11,1371
TOOMBS,9/30/2020,761,606,11,1378
TOOMBS,10/1/2020,765,610,11,1386
TOOMBS,10/2/2020,768,610,11,1389
TOOMBS,10/3/2020,772,612,11,1395
TOOMBS,10/4/2020,773,614,11,1398
TOOMBS,10/5/2020,777,617,11,1405
TOOMBS,10/6/2020,779,621,11,1411
TOOMBS,10/7/2020,783,625,11,1419
TOOMBS,10/8/2020,784,628,11,1423
TOOMBS,10/9/2020,787,629,11,1427
TOOMBS,10/10/2020,789,630,11,1430
TOOMBS,10/11/2020,789,630,11,1430
TOOMBS,10/12/2020,790,632,11,1433
TOOMBS,10/13/2020,792,635,11,1438
TOOMBS,10/14/2020,793,635,11,1439
TOOMBS,10/15/2020,795,638,11,1444
TOOMBS,10/16/2020,796,639,11,1446
TOOMBS,10/17/2020,798,639,11,1448
TOOMBS,10/18/2020,799,640,11,1450
TOOMBS,10/19/2020,799,643,11,1453
TOOMBS,10/20/2020,799,643,11,1453
TOWNS,1/1/2020,0,0,0,0
TOWNS,1/2/2020,0,0,0,0
TOWNS,1/3/2020,0,0,0,0
TOWNS,1/4/2020,0,0,0,0
TOWNS,1/5/2020,0,0,0,0
TOWNS,1/6/2020,0,0,0,0
TOWNS,1/7/2020,0,0,0,0
TOWNS,1/8/2020,0,0,0,0
TOWNS,1/9/2020,0,0,0,0
TOWNS,1/10/2020,0,0,0,0
TOWNS,1/11/2020,0,0,0,0
TOWNS,1/12/2020,0,0,0,0
TOWNS,1/13/2020,0,0,0,0
TOWNS,1/14/2020,0,0,0,0
TOWNS,1/15/2020,0,0,0,0
TOWNS,1/16/2020,0,0,0,0
TOWNS,1/17/2020,0,0,0,0
TOWNS,1/18/2020,0,0,0,0
TOWNS,1/19/2020,0,0,0,0
TOWNS,1/20/2020,0,0,0,0
TOWNS,1/21/2020,0,0,0,0
TOWNS,1/22/2020,0,0,0,0
TOWNS,1/23/2020,0,0,0,0
TOWNS,1/24/2020,0,0,0,0
TOWNS,1/25/2020,0,0,0,0
TOWNS,1/26/2020,0,0,0,0
TOWNS,1/27/2020,0,0,0,0
TOWNS,1/28/2020,0,0,0,0
TOWNS,1/29/2020,0,0,0,0
TOWNS,1/30/2020,0,0,0,0
TOWNS,1/31/2020,0,0,0,0
TOWNS,2/1/2020,0,0,0,0
TOWNS,2/2/2020,0,0,0,0
TOWNS,2/3/2020,0,0,0,0
TOWNS,2/4/2020,0,0,0,0
TOWNS,2/5/2020,0,0,0,0
TOWNS,2/6/2020,0,0,0,0
TOWNS,2/7/2020,0,0,0,0
TOWNS,2/8/2020,0,0,0,0
TOWNS,2/9/2020,0,0,0,0
TOWNS,2/10/2020,0,0,0,0
TOWNS,2/11/2020,0,0,0,0
TOWNS,2/12/2020,0,0,0,0
TOWNS,2/13/2020,0,0,0,0
TOWNS,2/14/2020,0,0,0,0
TOWNS,2/15/2020,0,0,0,0
TOWNS,2/16/2020,0,0,0,0
TOWNS,2/17/2020,0,0,0,0
TOWNS,2/18/2020,0,0,0,0
TOWNS,2/19/2020,0,0,0,0
TOWNS,2/20/2020,0,0,0,0
TOWNS,2/21/2020,0,0,0,0
TOWNS,2/22/2020,0,0,0,0
TOWNS,2/23/2020,0,0,0,0
TOWNS,2/24/2020,0,0,0,0
TOWNS,2/25/2020,0,0,0,0
TOWNS,2/26/2020,0,0,0,0
TOWNS,2/27/2020,0,0,0,0
TOWNS,2/28/2020,0,0,0,0
TOWNS,2/29/2020,0,0,0,0
TOWNS,3/1/2020,0,0,0,0
TOWNS,3/2/2020,0,0,0,0
TOWNS,3/3/2020,0,0,0,0
TOWNS,3/4/2020,0,0,0,0
TOWNS,3/5/2020,0,0,0,0
TOWNS,3/6/2020,0,0,0,0
TOWNS,3/7/2020,0,0,0,0
TOWNS,3/8/2020,0,1,0,1
TOWNS,3/9/2020,0,1,0,1
TOWNS,3/10/2020,0,1,0,1
TOWNS,3/11/2020,0,1,0,1
TOWNS,3/12/2020,0,1,0,1
TOWNS,3/13/2020,0,1,0,1
TOWNS,3/14/2020,0,1,0,1
TOWNS,3/15/2020,0,1,0,1
TOWNS,3/16/2020,0,2,0,2
TOWNS,3/17/2020,0,2,0,2
TOWNS,3/18/2020,1,2,0,3
TOWNS,3/19/2020,1,2,0,3
TOWNS,3/20/2020,1,2,0,3
TOWNS,3/21/2020,1,2,0,3
TOWNS,3/22/2020,1,2,0,3
TOWNS,3/23/2020,1,2,0,3
TOWNS,3/24/2020,1,2,0,3
TOWNS,3/25/2020,2,2,0,4
TOWNS,3/26/2020,2,2,0,4
TOWNS,3/27/2020,2,2,0,4
TOWNS,3/28/2020,2,3,0,5
TOWNS,3/29/2020,3,3,0,6
TOWNS,3/30/2020,4,3,0,7
TOWNS,3/31/2020,4,4,0,8
TOWNS,4/1/2020,4,4,0,8
TOWNS,4/2/2020,4,4,0,8
TOWNS,4/3/2020,4,4,0,8
TOWNS,4/4/2020,4,4,0,8
TOWNS,4/5/2020,4,4,0,8
TOWNS,4/6/2020,4,4,0,8
TOWNS,4/7/2020,4,4,0,8
TOWNS,4/8/2020,4,4,0,8
TOWNS,4/9/2020,5,4,0,9
TOWNS,4/10/2020,5,4,0,9
TOWNS,4/11/2020,5,6,0,11
TOWNS,4/12/2020,5,6,0,11
TOWNS,4/13/2020,5,6,0,11
TOWNS,4/14/2020,5,7,0,12
TOWNS,4/15/2020,5,7,0,12
TOWNS,4/16/2020,5,7,0,12
TOWNS,4/17/2020,9,8,0,17
TOWNS,4/18/2020,9,9,0,18
TOWNS,4/19/2020,9,10,0,19
TOWNS,4/20/2020,9,10,0,19
TOWNS,4/21/2020,9,10,0,19
TOWNS,4/22/2020,10,10,0,20
TOWNS,4/23/2020,10,10,0,20
TOWNS,4/24/2020,10,10,0,20
TOWNS,4/25/2020,10,10,0,20
TOWNS,4/26/2020,10,10,0,20
TOWNS,4/27/2020,10,10,0,20
TOWNS,4/28/2020,10,10,0,20
TOWNS,4/29/2020,10,10,0,20
TOWNS,4/30/2020,10,10,0,20
TOWNS,5/1/2020,10,11,0,21
TOWNS,5/2/2020,10,11,0,21
TOWNS,5/3/2020,10,11,0,21
TOWNS,5/4/2020,10,11,0,21
TOWNS,5/5/2020,10,11,0,21
TOWNS,5/6/2020,10,11,0,21
TOWNS,5/7/2020,10,11,0,21
TOWNS,5/8/2020,10,11,0,21
TOWNS,5/9/2020,10,11,0,21
TOWNS,5/10/2020,10,11,0,21
TOWNS,5/11/2020,10,11,0,21
TOWNS,5/12/2020,10,11,0,21
TOWNS,5/13/2020,11,11,0,22
TOWNS,5/14/2020,11,11,0,22
TOWNS,5/15/2020,11,11,0,22
TOWNS,5/16/2020,11,12,0,23
TOWNS,5/17/2020,11,12,0,23
TOWNS,5/18/2020,11,13,0,24
TOWNS,5/19/2020,11,13,0,24
TOWNS,5/20/2020,11,13,0,24
TOWNS,5/21/2020,11,14,0,25
TOWNS,5/22/2020,12,14,0,26
TOWNS,5/23/2020,12,14,0,26
TOWNS,5/24/2020,12,14,0,26
TOWNS,5/25/2020,12,14,0,26
TOWNS,5/26/2020,12,14,0,26
TOWNS,5/27/2020,12,14,0,26
TOWNS,5/28/2020,12,15,0,27
TOWNS,5/29/2020,12,15,0,27
TOWNS,5/30/2020,12,16,0,28
TOWNS,5/31/2020,12,16,0,28
TOWNS,6/1/2020,12,17,0,29
TOWNS,6/2/2020,13,17,0,30
TOWNS,6/3/2020,13,19,0,32
TOWNS,6/4/2020,13,19,0,32
TOWNS,6/5/2020,14,19,0,33
TOWNS,6/6/2020,14,20,0,34
TOWNS,6/7/2020,14,20,0,34
TOWNS,6/8/2020,14,20,0,34
TOWNS,6/9/2020,14,20,0,34
TOWNS,6/10/2020,14,21,0,35
TOWNS,6/11/2020,14,23,0,37
TOWNS,6/12/2020,14,23,0,37
TOWNS,6/13/2020,14,23,0,37
TOWNS,6/14/2020,14,23,0,37
TOWNS,6/15/2020,15,23,0,38
TOWNS,6/16/2020,15,24,0,39
TOWNS,6/17/2020,15,24,0,39
TOWNS,6/18/2020,15,24,0,39
TOWNS,6/19/2020,15,24,0,39
TOWNS,6/20/2020,15,24,0,39
TOWNS,6/21/2020,15,24,0,39
TOWNS,6/22/2020,15,25,0,40
TOWNS,6/23/2020,17,25,0,42
TOWNS,6/24/2020,18,25,0,43
TOWNS,6/25/2020,20,26,0,46
TOWNS,6/26/2020,21,28,0,49
TOWNS,6/27/2020,22,29,0,51
TOWNS,6/28/2020,23,29,0,52
TOWNS,6/29/2020,25,30,0,55
TOWNS,6/30/2020,26,31,0,57
TOWNS,7/1/2020,26,31,0,57
TOWNS,7/2/2020,26,34,0,60
TOWNS,7/3/2020,30,35,0,65
TOWNS,7/4/2020,30,36,0,66
TOWNS,7/5/2020,33,37,0,70
TOWNS,7/6/2020,34,38,0,72
TOWNS,7/7/2020,38,38,0,76
TOWNS,7/8/2020,41,39,0,80
TOWNS,7/9/2020,42,39,1,82
TOWNS,7/10/2020,42,40,1,83
TOWNS,7/11/2020,43,42,1,86
TOWNS,7/12/2020,44,44,1,89
TOWNS,7/13/2020,48,44,1,93
TOWNS,7/14/2020,50,46,1,97
TOWNS,7/15/2020,50,46,1,97
TOWNS,7/16/2020,51,47,1,99
TOWNS,7/17/2020,54,50,1,105
TOWNS,7/18/2020,55,51,1,107
TOWNS,7/19/2020,57,51,1,109
TOWNS,7/20/2020,60,52,1,113
TOWNS,7/21/2020,62,54,1,117
TOWNS,7/22/2020,66,55,1,122
TOWNS,7/23/2020,69,55,1,125
TOWNS,7/24/2020,72,57,1,130
TOWNS,7/25/2020,72,59,1,132
TOWNS,7/26/2020,72,59,1,132
TOWNS,7/27/2020,73,61,1,135
TOWNS,7/28/2020,73,63,1,137
TOWNS,7/29/2020,75,65,1,141
TOWNS,7/30/2020,80,65,1,146
TOWNS,7/31/2020,85,65,1,151
TOWNS,8/1/2020,86,67,1,154
TOWNS,8/2/2020,89,69,1,159
TOWNS,8/3/2020,93,72,1,166
TOWNS,8/4/2020,96,72,1,169
TOWNS,8/5/2020,99,72,1,172
TOWNS,8/6/2020,101,72,1,174
TOWNS,8/7/2020,105,74,1,180
TOWNS,8/8/2020,107,76,1,184
TOWNS,8/9/2020,107,78,1,186
TOWNS,8/10/2020,109,79,1,189
TOWNS,8/11/2020,110,81,1,192
TOWNS,8/12/2020,111,83,1,195
TOWNS,8/13/2020,113,84,1,198
TOWNS,8/14/2020,114,85,1,200
TOWNS,8/15/2020,114,87,1,202
TOWNS,8/16/2020,115,87,1,203
TOWNS,8/17/2020,117,87,1,205
TOWNS,8/18/2020,118,88,1,207
TOWNS,8/19/2020,118,89,1,208
TOWNS,8/20/2020,121,94,1,216
TOWNS,8/21/2020,121,94,1,216
TOWNS,8/22/2020,123,95,1,219
TOWNS,8/23/2020,124,95,1,220
TOWNS,8/24/2020,126,98,1,225
TOWNS,8/25/2020,127,100,1,228
TOWNS,8/26/2020,128,101,1,230
TOWNS,8/27/2020,129,101,1,231
TOWNS,8/28/2020,133,103,1,237
TOWNS,8/29/2020,134,104,2,240
TOWNS,8/30/2020,136,106,2,244
TOWNS,8/31/2020,139,109,2,250
TOWNS,9/1/2020,141,111,3,255
TOWNS,9/2/2020,143,115,3,261
TOWNS,9/3/2020,145,120,3,268
TOWNS,9/4/2020,148,121,3,272
TOWNS,9/5/2020,152,121,3,276
TOWNS,9/6/2020,154,125,3,282
TOWNS,9/7/2020,156,125,3,284
TOWNS,9/8/2020,160,126,3,289
TOWNS,9/9/2020,164,127,3,294
TOWNS,9/10/2020,167,128,3,298
TOWNS,9/11/2020,168,129,3,300
TOWNS,9/12/2020,169,129,3,301
TOWNS,9/13/2020,173,130,3,306
TOWNS,9/14/2020,178,133,3,314
TELFAIR,9/6/2020,188,178,3,369
TELFAIR,9/7/2020,188,178,3,369
TELFAIR,9/8/2020,189,178,3,370
TELFAIR,9/9/2020,189,180,3,372
TELFAIR,9/10/2020,190,183,3,376
TELFAIR,9/11/2020,192,183,3,378
TELFAIR,9/12/2020,192,183,3,378
TELFAIR,9/13/2020,192,183,3,378
TELFAIR,9/14/2020,193,188,3,384
TELFAIR,9/15/2020,193,188,3,384
TELFAIR,9/16/2020,193,188,3,384
TELFAIR,9/17/2020,193,189,3,385
TELFAIR,9/18/2020,193,189,3,385
TELFAIR,9/19/2020,194,189,3,386
TELFAIR,9/20/2020,194,190,3,387
TELFAIR,9/21/2020,194,190,3,387
TELFAIR,9/22/2020,194,190,3,387
TELFAIR,9/23/2020,195,192,3,390
TELFAIR,9/24/2020,195,192,3,390
TELFAIR,9/25/2020,196,192,3,391
TELFAIR,9/26/2020,197,193,3,393
TELFAIR,9/27/2020,197,194,3,394
TELFAIR,9/28/2020,197,195,3,395
TELFAIR,9/29/2020,199,196,3,398
TELFAIR,9/30/2020,199,196,3,398
TELFAIR,10/1/2020,200,198,3,401
TELFAIR,10/2/2020,200,198,3,401
TELFAIR,10/3/2020,200,198,3,401
TELFAIR,10/4/2020,200,198,3,401
TELFAIR,10/5/2020,201,199,3,403
TELFAIR,10/6/2020,204,199,3,406
TELFAIR,10/7/2020,207,199,3,409
TELFAIR,10/8/2020,208,199,3,410
TELFAIR,10/9/2020,209,203,3,415
TELFAIR,10/10/2020,210,203,3,416
TELFAIR,10/11/2020,211,204,3,418
TELFAIR,10/12/2020,213,207,3,423
TELFAIR,10/13/2020,214,208,3,425
TELFAIR,10/14/2020,216,208,3,427
TELFAIR,10/15/2020,217,209,3,429
TELFAIR,10/16/2020,217,210,3,430
TELFAIR,10/17/2020,217,210,3,430
TELFAIR,10/18/2020,217,210,3,430
TELFAIR,10/19/2020,217,210,3,430
TELFAIR,10/20/2020,217,210,3,430
THOMAS,1/1/2020,0,0,0,0
THOMAS,1/2/2020,0,0,0,0
THOMAS,1/3/2020,0,0,0,0
THOMAS,1/4/2020,0,0,0,0
THOMAS,1/5/2020,0,0,0,0
THOMAS,1/6/2020,0,0,0,0
THOMAS,1/7/2020,0,0,0,0
THOMAS,1/8/2020,0,0,0,0
THOMAS,1/9/2020,0,0,0,0
THOMAS,1/10/2020,0,0,0,0
THOMAS,1/11/2020,0,0,0,0
THOMAS,1/12/2020,0,0,0,0
THOMAS,1/13/2020,0,0,0,0
THOMAS,1/14/2020,0,0,0,0
THOMAS,1/15/2020,0,0,0,0
THOMAS,1/16/2020,0,0,0,0
THOMAS,1/17/2020,0,0,0,0
THOMAS,1/18/2020,0,0,0,0
THOMAS,1/19/2020,0,0,0,0
THOMAS,1/20/2020,0,0,0,0
THOMAS,1/21/2020,0,0,0,0
THOMAS,1/22/2020,0,0,0,0
THOMAS,1/23/2020,0,0,0,0
THOMAS,1/24/2020,0,0,0,0
THOMAS,1/25/2020,0,0,0,0
THOMAS,1/26/2020,0,0,0,0
THOMAS,1/27/2020,0,0,0,0
THOMAS,1/28/2020,0,0,0,0
THOMAS,1/29/2020,0,0,0,0
THOMAS,1/30/2020,0,0,0,0
THOMAS,1/31/2020,0,0,0,0
THOMAS,2/1/2020,0,0,0,0
THOMAS,2/2/2020,0,0,0,0
THOMAS,2/3/2020,0,0,0,0
THOMAS,2/4/2020,0,0,0,0
THOMAS,2/5/2020,0,0,0,0
THOMAS,2/6/2020,0,0,0,0
THOMAS,2/7/2020,0,0,0,0
THOMAS,2/8/2020,0,0,0,0
THOMAS,2/9/2020,0,0,0,0
THOMAS,2/10/2020,0,0,0,0
THOMAS,2/11/2020,0,0,0,0
THOMAS,2/12/2020,0,0,0,0
THOMAS,2/13/2020,0,0,0,0
THOMAS,2/14/2020,0,0,0,0
THOMAS,2/15/2020,0,0,0,0
THOMAS,2/16/2020,0,0,0,0
THOMAS,2/17/2020,0,0,0,0
THOMAS,2/18/2020,0,0,0,0
THOMAS,2/19/2020,0,0,0,0
THOMAS,2/20/2020,0,0,0,0
THOMAS,2/21/2020,0,0,0,0
THOMAS,2/22/2020,0,0,0,0
THOMAS,2/23/2020,0,0,0,0
THOMAS,2/24/2020,0,0,0,0
THOMAS,2/25/2020,0,0,0,0
THOMAS,2/26/2020,0,0,0,0
THOMAS,2/27/2020,0,0,0,0
THOMAS,2/28/2020,0,0,0,0
THOMAS,2/29/2020,0,0,0,0
THOMAS,3/1/2020,0,0,0,0
THOMAS,3/2/2020,0,0,0,0
THOMAS,3/3/2020,1,0,0,1
THOMAS,3/4/2020,1,0,0,1
THOMAS,3/5/2020,1,0,0,1
THOMAS,3/6/2020,1,0,0,1
THOMAS,3/7/2020,1,0,0,1
THOMAS,3/8/2020,1,0,0,1
THOMAS,3/9/2020,1,0,0,1
THOMAS,3/10/2020,1,0,0,1
THOMAS,3/11/2020,1,0,0,1
THOMAS,3/12/2020,1,0,0,1
THOMAS,3/13/2020,1,1,0,2
THOMAS,3/14/2020,1,1,0,2
THOMAS,3/15/2020,2,1,0,3
THOMAS,3/16/2020,2,1,0,3
THOMAS,3/17/2020,2,1,0,3
THOMAS,3/18/2020,3,2,0,5
THOMAS,3/19/2020,3,2,0,5
THOMAS,3/20/2020,4,2,0,6
THOMAS,3/21/2020,5,3,0,8
THOMAS,3/22/2020,5,4,0,9
THOMAS,3/23/2020,7,4,0,11
THOMAS,3/24/2020,7,5,0,12
THOMAS,3/25/2020,8,5,0,13
THOMAS,3/26/2020,8,5,0,13
THOMAS,3/27/2020,12,7,0,19
THOMAS,3/28/2020,15,7,0,22
THOMAS,3/29/2020,16,12,0,28
THOMAS,3/30/2020,20,14,0,34
THOMAS,3/31/2020,24,16,0,40
THOMAS,4/1/2020,34,18,0,52
THOMAS,4/2/2020,35,18,0,53
THOMAS,4/3/2020,40,20,1,61
THOMAS,4/4/2020,44,22,1,67
THOMAS,4/5/2020,48,22,1,71
THOMAS,4/6/2020,52,24,1,77
THOMAS,4/7/2020,57,24,1,82
THOMAS,4/8/2020,65,31,1,97
THOMAS,4/9/2020,69,36,1,106
THOMAS,4/10/2020,74,41,1,116
THOMAS,4/11/2020,79,44,1,124
THOMAS,4/12/2020,84,44,1,129
THOMAS,4/13/2020,92,47,1,140
THOMAS,4/14/2020,96,52,1,149
THOMAS,4/15/2020,101,56,1,158
THOMAS,4/16/2020,109,60,1,170
THOMAS,4/17/2020,115,65,1,181
THOMAS,4/18/2020,117,65,1,183
THOMAS,4/19/2020,119,65,1,185
THOMAS,4/20/2020,125,67,1,193
THOMAS,4/21/2020,127,69,2,198
THOMAS,4/22/2020,134,73,3,210
THOMAS,4/23/2020,136,75,3,214
THOMAS,4/24/2020,141,81,3,225
THOMAS,4/25/2020,143,81,3,227
THOMAS,4/26/2020,145,84,3,232
THOMAS,4/27/2020,147,86,4,237
THOMAS,4/28/2020,151,88,4,243
THOMAS,4/29/2020,154,90,4,248
THOMAS,4/30/2020,158,94,4,256
THOMAS,5/1/2020,166,102,4,272
THOMAS,5/2/2020,166,103,4,273
THOMAS,5/3/2020,170,104,4,278
THOMAS,5/4/2020,170,104,4,278
THOMAS,5/5/2020,171,105,4,280
THOMAS,5/6/2020,171,105,4,280
THOMAS,5/7/2020,173,105,4,282
THOMAS,5/8/2020,179,108,4,291
THOMAS,5/9/2020,181,108,4,293
THOMAS,5/10/2020,181,109,4,294
THOMAS,5/11/2020,183,112,4,299
THOMAS,5/12/2020,185,112,4,301
THOMAS,5/13/2020,187,113,4,304
THOMAS,5/14/2020,188,113,4,305
THOMAS,5/15/2020,189,114,4,307
THOMAS,5/16/2020,189,115,4,308
THOMAS,5/17/2020,189,116,4,309
THOMAS,5/18/2020,191,118,4,313
THOMAS,5/19/2020,195,119,4,318
THOMAS,5/20/2020,196,121,4,321
THOMAS,5/21/2020,197,122,4,323
THOMAS,5/22/2020,199,125,4,328
THOMAS,5/23/2020,201,125,4,330
THOMAS,5/24/2020,201,127,4,332
THOMAS,5/25/2020,202,128,4,334
THOMAS,5/26/2020,205,128,4,337
THOMAS,5/27/2020,211,131,4,346
THOMAS,5/28/2020,212,131,4,347
THOMAS,5/29/2020,213,131,4,348
THOMAS,5/30/2020,217,134,4,355
THOMAS,5/31/2020,218,134,4,356
THOMAS,6/1/2020,220,134,4,358
THOMAS,6/2/2020,222,136,4,362
THOMAS,6/3/2020,228,136,4,368
THOMAS,6/4/2020,230,136,4,370
THOMAS,6/5/2020,232,137,4,373
THOMAS,6/6/2020,233,137,4,374
THOMAS,6/7/2020,233,137,4,374
THOMAS,6/8/2020,237,140,4,381
THOMAS,6/9/2020,238,141,4,383
THOMAS,6/10/2020,239,142,4,385
THOMAS,6/11/2020,239,142,4,385
THOMAS,6/12/2020,240,143,4,387
THOMAS,6/13/2020,243,144,4,391
THOMAS,6/14/2020,245,146,4,395
THOMAS,6/15/2020,245,147,4,396
THOMAS,6/16/2020,248,153,4,405
THOMAS,6/17/2020,248,158,4,410
THOMAS,6/18/2020,251,162,4,417
THOMAS,6/19/2020,254,166,4,424
THOMAS,6/20/2020,258,168,4,430
THOMAS,6/21/2020,260,172,4,436
THOMAS,6/22/2020,264,175,5,444
THOMAS,6/23/2020,265,184,5,454
THOMAS,6/24/2020,268,194,5,467
THOMAS,6/25/2020,277,199,5,481
THOMAS,6/26/2020,287,205,5,497
THOMAS,6/27/2020,291,212,5,508
THOMAS,6/28/2020,295,215,5,515
THOMAS,6/29/2020,308,223,5,536
THOMAS,6/30/2020,315,229,5,549
THOMAS,7/1/2020,327,233,5,565
THOMAS,7/2/2020,331,237,6,574
THOMAS,7/3/2020,335,242,6,583
THOMAS,7/4/2020,337,247,6,590
THOMAS,7/5/2020,341,251,6,598
THOMAS,7/6/2020,356,257,6,619
THOMAS,7/7/2020,365,263,6,634
THOMAS,7/8/2020,372,272,6,650
THOMAS,7/9/2020,384,279,6,669
THOMAS,7/10/2020,393,284,6,683
THOMAS,7/11/2020,400,294,6,700
THOMAS,7/12/2020,406,297,6,709
THOMAS,7/13/2020,423,308,6,737
THOMAS,7/14/2020,442,324,6,772
THOMAS,7/15/2020,455,331,6,792
THOMAS,7/16/2020,461,335,6,802
THOMAS,7/17/2020,468,340,6,814
THOMAS,7/18/2020,473,344,6,823
THOMAS,7/19/2020,485,350,6,841
THOMAS,7/20/2020,497,359,6,862
THOMAS,7/21/2020,507,368,6,881
THOMAS,7/22/2020,519,372,6,897
THOMAS,7/23/2020,530,376,6,912
THOMAS,7/24/2020,536,382,6,924
THOMAS,7/25/2020,547,390,6,943
TIFT,2/19/2020,0,0,0,0
THOMAS,7/26/2020,556,395,6,957
THOMAS,7/27/2020,570,405,6,981
THOMAS,7/28/2020,584,413,6,1003
THOMAS,7/29/2020,595,422,6,1023
THOMAS,7/30/2020,603,432,6,1041
THOMAS,7/31/2020,606,439,6,1051
THOMAS,8/1/2020,612,443,6,1061
THOMAS,8/2/2020,615,450,6,1071
THOMAS,8/3/2020,629,460,6,1095
THOMAS,8/4/2020,636,468,6,1110
THOMAS,8/5/2020,644,475,6,1125
THOMAS,8/6/2020,644,479,6,1129
THOMAS,8/7/2020,650,488,6,1144
THOMAS,8/8/2020,653,490,6,1149
THOMAS,8/9/2020,659,490,6,1155
THOMAS,8/10/2020,664,499,6,1169
THOMAS,8/11/2020,674,503,6,1183
THOMAS,8/12/2020,676,509,6,1191
THOMAS,8/13/2020,686,512,7,1205
THOMAS,8/14/2020,693,515,7,1215
THOMAS,8/15/2020,698,518,7,1223
THOMAS,8/16/2020,706,526,7,1239
THOMAS,8/17/2020,718,530,7,1255
THOMAS,8/18/2020,727,535,7,1269
THOMAS,8/19/2020,732,538,7,1277
THOMAS,8/20/2020,733,541,7,1281
THOMAS,8/21/2020,739,547,7,1293
THOMAS,8/22/2020,739,549,7,1295
THOMAS,8/23/2020,746,550,7,1303
THOMAS,8/24/2020,750,556,7,1313
THOMAS,8/25/2020,757,559,8,1324
THOMAS,8/26/2020,764,566,8,1338
THOMAS,8/27/2020,766,571,8,1345
THOMAS,8/28/2020,776,574,8,1358
THOMAS,8/29/2020,785,574,8,1367
THOMAS,8/30/2020,786,575,8,1369
THOMAS,8/31/2020,787,578,8,1373
THOMAS,9/1/2020,793,582,8,1383
THOMAS,9/2/2020,797,582,8,1387
THOMAS,9/3/2020,800,582,8,1390
THOMAS,9/4/2020,802,587,8,1397
THOMAS,9/5/2020,804,587,8,1399
THOMAS,9/6/2020,805,587,8,1400
THOMAS,9/7/2020,808,589,8,1405
THOMAS,9/8/2020,809,591,8,1408
THOMAS,9/9/2020,811,596,8,1415
THOMAS,9/10/2020,816,599,8,1423
THOMAS,9/11/2020,821,604,8,1433
THOMAS,9/12/2020,827,606,8,1441
THOMAS,9/13/2020,828,608,8,1444
THOMAS,9/14/2020,833,613,8,1454
THOMAS,9/15/2020,838,616,8,1462
THOMAS,9/16/2020,842,618,8,1468
THOMAS,9/17/2020,844,620,8,1472
THOMAS,9/18/2020,846,625,8,1479
THOMAS,9/19/2020,847,627,8,1482
THOMAS,9/20/2020,849,627,8,1484
THOMAS,9/21/2020,853,632,8,1493
THOMAS,9/22/2020,854,633,8,1495
THOMAS,9/23/2020,856,634,8,1498
THOMAS,9/24/2020,858,634,8,1500
THOMAS,9/25/2020,859,636,8,1503
THOMAS,9/26/2020,859,640,8,1507
THOMAS,9/27/2020,859,641,8,1508
THOMAS,9/28/2020,859,643,8,1510
THOMAS,9/29/2020,861,645,8,1514
THOMAS,9/30/2020,863,646,8,1517
THOMAS,10/1/2020,865,649,8,1522
THOMAS,10/2/2020,867,650,8,1525
THOMAS,10/3/2020,870,653,8,1531
THOMAS,10/4/2020,870,653,8,1531
THOMAS,10/5/2020,873,655,8,1536
THOMAS,10/6/2020,875,655,8,1538
THOMAS,10/7/2020,878,656,8,1542
THOMAS,10/8/2020,879,656,8,1543
THOMAS,10/9/2020,883,659,8,1550
THOMAS,10/10/2020,887,662,8,1557
THOMAS,10/11/2020,888,663,8,1559
THOMAS,10/12/2020,892,666,8,1566
THOMAS,10/13/2020,894,667,8,1569
THOMAS,10/14/2020,898,668,8,1574
THOMAS,10/15/2020,899,668,8,1575
THOMAS,10/16/2020,899,668,8,1575
THOMAS,10/17/2020,899,669,8,1576
THOMAS,10/18/2020,899,669,8,1576
THOMAS,10/19/2020,899,669,8,1576
THOMAS,10/20/2020,899,669,8,1576
TIFT,1/1/2020,0,0,0,0
TIFT,1/2/2020,0,0,0,0
TIFT,1/3/2020,0,0,0,0
TIFT,1/4/2020,0,0,0,0
TIFT,1/5/2020,0,0,0,0
TIFT,1/6/2020,0,0,0,0
TIFT,1/7/2020,0,0,0,0
TIFT,1/8/2020,0,0,0,0
TIFT,1/9/2020,0,0,0,0
TIFT,1/10/2020,0,0,0,0
TIFT,1/11/2020,0,0,0,0
TIFT,1/12/2020,0,0,0,0
TIFT,1/13/2020,0,0,0,0
TIFT,1/14/2020,0,0,0,0
TIFT,1/15/2020,0,0,0,0
TIFT,1/16/2020,0,0,0,0
TIFT,1/17/2020,0,0,0,0
TIFT,1/18/2020,0,0,0,0
TIFT,1/19/2020,0,0,0,0
TIFT,1/20/2020,0,0,0,0
TIFT,1/21/2020,0,0,0,0
TIFT,1/22/2020,0,0,0,0
TIFT,1/23/2020,0,0,0,0
TIFT,1/24/2020,0,0,0,0
TIFT,1/25/2020,0,0,0,0
TIFT,1/26/2020,0,0,0,0
TIFT,1/27/2020,0,0,0,0
TIFT,1/28/2020,0,0,0,0
TIFT,1/29/2020,0,0,0,0
TIFT,1/30/2020,0,0,0,0
TIFT,1/31/2020,0,0,0,0
TIFT,2/1/2020,0,0,0,0
TIFT,2/2/2020,0,0,0,0
TIFT,2/3/2020,0,0,0,0
TIFT,2/4/2020,0,0,0,0
TIFT,2/5/2020,0,0,0,0
TIFT,2/6/2020,0,0,0,0
TIFT,2/7/2020,0,0,0,0
TIFT,2/8/2020,0,0,0,0
TIFT,2/9/2020,0,0,0,0
TIFT,2/10/2020,0,0,0,0
TIFT,2/11/2020,0,0,0,0
TIFT,2/12/2020,0,0,0,0
TIFT,2/13/2020,0,0,0,0
TIFT,2/14/2020,0,0,0,0
TIFT,2/15/2020,0,0,0,0
TIFT,2/20/2020,0,0,0,0
TIFT,2/21/2020,0,0,0,0
TIFT,2/22/2020,0,0,0,0
TIFT,2/23/2020,0,0,0,0
TIFT,2/24/2020,0,0,0,0
TIFT,2/25/2020,0,0,0,0
TIFT,2/26/2020,0,0,0,0
TIFT,2/27/2020,0,0,0,0
TIFT,2/28/2020,0,0,0,0
TIFT,2/29/2020,0,0,0,0
TIFT,3/1/2020,0,0,0,0
TIFT,3/2/2020,0,0,0,0
TIFT,3/3/2020,0,0,0,0
TIFT,3/4/2020,0,0,0,0
TIFT,3/5/2020,0,0,0,0
TIFT,3/6/2020,0,0,0,0
TIFT,3/7/2020,0,0,0,0
TIFT,3/8/2020,0,0,0,0
TIFT,3/9/2020,0,0,0,0
TIFT,3/10/2020,0,0,0,0
TIFT,3/11/2020,0,0,0,0
TIFT,3/12/2020,1,0,0,1
TIFT,3/13/2020,1,0,0,1
TIFT,3/14/2020,1,0,0,1
TIFT,3/15/2020,1,0,0,1
TIFT,3/16/2020,3,0,0,3
TIFT,3/17/2020,3,1,0,4
TIFT,3/18/2020,5,1,0,6
TIFT,3/19/2020,7,1,0,8
TIFT,3/20/2020,10,1,0,11
TIFT,3/21/2020,11,1,0,12
TIFT,3/22/2020,13,2,0,15
TIFT,3/23/2020,16,3,0,19
TIFT,3/24/2020,18,4,0,22
TIFT,3/25/2020,21,4,0,25
TIFT,3/26/2020,23,6,0,29
TIFT,3/27/2020,25,7,0,32
TIFT,3/28/2020,26,7,0,33
TIFT,3/29/2020,26,7,0,33
TIFT,3/30/2020,27,9,0,36
TIFT,3/31/2020,27,11,0,38
TIFT,4/1/2020,27,14,0,41
TIFT,4/2/2020,28,15,0,43
TIFT,4/3/2020,30,15,0,45
TIFT,4/4/2020,32,15,0,47
TIFT,4/5/2020,33,15,0,48
TIFT,4/6/2020,35,17,0,52
TIFT,4/7/2020,38,17,0,55
TIFT,4/8/2020,41,19,0,60
TIFT,4/9/2020,43,21,0,64
TIFT,4/10/2020,46,21,0,67
TIFT,4/11/2020,48,21,0,69
TIFT,4/12/2020,48,21,0,69
TIFT,4/13/2020,51,23,0,74
TIFT,4/14/2020,52,25,0,77
TIFT,4/15/2020,53,25,0,78
TIFT,4/16/2020,58,26,0,84
TIFT,4/17/2020,61,28,0,89
TIFT,4/18/2020,63,28,0,91
TIFT,4/19/2020,64,29,0,93
TIFT,4/20/2020,65,31,0,96
TIFT,4/21/2020,67,33,0,100
TIFT,4/22/2020,69,36,0,105
TIFT,4/23/2020,69,37,0,106
TIFT,4/24/2020,72,41,0,113
TIFT,4/25/2020,73,42,0,115
TIFT,4/26/2020,75,43,0,118
TIFT,4/27/2020,77,44,0,121
TIFT,4/28/2020,80,45,0,125
TIFT,4/29/2020,84,45,0,129
TIFT,4/30/2020,93,47,0,140
TIFT,5/1/2020,99,49,0,148
TIFT,5/2/2020,99,49,0,148
TIFT,5/3/2020,99,50,0,149
TIFT,5/4/2020,102,50,0,152
TIFT,5/5/2020,105,52,0,157
TIFT,5/6/2020,108,54,0,162
TIFT,5/7/2020,114,55,0,169
TIFT,5/8/2020,114,55,0,169
TIFT,5/9/2020,115,57,0,172
TIFT,5/10/2020,116,58,0,174
TIFT,5/11/2020,119,59,0,178
TIFT,5/12/2020,119,60,0,179
TIFT,5/13/2020,127,62,0,189
TIFT,5/14/2020,130,68,0,198
TIFT,5/15/2020,133,71,0,204
TIFT,5/16/2020,137,72,0,209
TIFT,5/17/2020,139,73,0,212
TIFT,5/18/2020,141,76,0,217
TIFT,5/19/2020,145,79,0,224
TIFT,5/20/2020,148,82,0,230
TIFT,5/21/2020,151,83,0,234
TIFT,5/22/2020,152,90,0,242
TIFT,5/23/2020,154,92,0,246
TIFT,5/24/2020,155,92,0,247
TIFT,5/25/2020,158,92,0,250
TIFT,5/26/2020,161,96,0,257
TIFT,5/27/2020,163,97,0,260
TIFT,5/28/2020,169,101,0,270
TIFT,5/29/2020,171,102,1,274
TIFT,5/30/2020,172,103,1,276
TIFT,5/31/2020,174,104,1,279
TIFT,6/1/2020,183,112,1,296
TIFT,6/2/2020,194,115,1,310
TIFT,6/3/2020,202,119,1,322
TIFT,6/4/2020,210,128,1,339
TIFT,6/5/2020,218,139,1,358
TIFT,6/6/2020,221,145,1,367
TIFT,6/7/2020,223,148,1,372
TIFT,6/8/2020,231,159,1,391
TIFT,6/9/2020,237,165,2,404
TIFT,6/10/2020,241,176,7,424
TIFT,6/11/2020,253,188,8,449
TIFT,6/12/2020,264,190,9,463
TIFT,6/13/2020,267,193,9,469
TIFT,6/14/2020,273,197,9,479
TIFT,6/15/2020,293,207,9,509
TIFT,6/16/2020,311,222,9,542
TIFT,6/17/2020,322,240,11,573
TIFT,6/18/2020,328,254,11,593
TIFT,6/19/2020,337,265,11,613
TIFT,6/20/2020,341,273,11,625
TIFT,6/21/2020,346,275,11,632
TIFT,6/22/2020,376,293,12,681
TIFT,6/23/2020,385,320,15,720
TIFT,6/24/2020,398,328,15,741
TIFT,6/25/2020,409,335,17,761
TIFT,6/26/2020,424,347,17,788
TIFT,6/27/2020,431,354,17,802
TIFT,6/28/2020,436,356,17,809
TIFT,6/29/2020,449,371,18,838
TIFT,6/30/2020,465,380,18,863
TIFT,7/1/2020,471,387,18,876
TIFT,7/2/2020,486,395,19,900
TIFT,7/3/2020,496,397,19,912
TIFT,7/4/2020,499,401,19,919
TIFT,7/5/2020,501,404,19,924
TIFT,7/6/2020,511,412,21,944
TIFT,7/7/2020,519,422,23,964
TIFT,7/8/2020,525,427,24,976
TIFT,7/9/2020,535,437,26,998
TIFT,7/10/2020,545,448,26,1019
TIFT,7/11/2020,550,451,26,1027
TIFT,7/12/2020,553,454,26,1033
TIFT,7/13/2020,567,464,26,1057
TIFT,7/14/2020,574,470,26,1070
TIFT,7/15/2020,582,476,26,1084
TIFT,7/16/2020,592,478,27,1097
TIFT,7/17/2020,601,484,27,1112
TIFT,7/18/2020,605,487,27,1119
TIFT,7/19/2020,612,487,27,1126
TIFT,7/20/2020,620,499,28,1147
TIFT,7/21/2020,626,510,28,1164
TIFT,7/22/2020,634,513,29,1176
TIFT,7/23/2020,642,518,29,1189
TIFT,7/24/2020,655,522,29,1206
TIFT,7/25/2020,657,525,29,1211
TIFT,7/26/2020,665,529,29,1223
TIFT,7/27/2020,680,535,29,1244
TIFT,7/28/2020,685,538,29,1252
TIFT,7/29/2020,693,543,29,1265
TIFT,7/30/2020,699,548,29,1276
TIFT,7/31/2020,706,553,29,1288
TIFT,8/1/2020,713,556,29,1298
TIFT,8/2/2020,715,559,29,1303
TIFT,8/3/2020,724,565,29,1318
TIFT,8/4/2020,729,569,29,1327
TIFT,8/5/2020,731,573,36,1340
TIFT,8/6/2020,735,577,37,1349
TIFT,8/7/2020,739,581,37,1357
TIFT,8/8/2020,741,584,37,1362
TIFT,8/9/2020,747,589,38,1374
TIFT,8/10/2020,751,591,38,1380
TIFT,8/11/2020,756,594,38,1388
TIFT,8/12/2020,761,599,38,1398
TIFT,8/13/2020,766,600,38,1404
TIFT,8/14/2020,773,601,38,1412
TIFT,8/15/2020,776,602,38,1416
TIFT,8/16/2020,776,602,38,1416
TIFT,8/17/2020,779,605,38,1422
TIFT,8/18/2020,784,614,39,1437
TIFT,8/19/2020,788,617,39,1444
TIFT,8/20/2020,794,623,41,1458
TIFT,8/21/2020,797,626,41,1464
TIFT,8/22/2020,798,630,41,1469
TIFT,8/23/2020,801,632,41,1474
TIFT,8/24/2020,805,641,41,1487
TIFT,8/25/2020,808,646,41,1495
TIFT,8/26/2020,813,648,41,1502
TIFT,8/27/2020,818,651,41,1510
TIFT,8/28/2020,822,662,41,1525
TIFT,8/29/2020,823,664,41,1528
TIFT,8/30/2020,829,670,41,1540
TIFT,8/31/2020,838,674,41,1553
TIFT,9/1/2020,841,680,41,1562
TIFT,9/2/2020,848,682,41,1571
TIFT,9/3/2020,854,687,41,1582
TIFT,9/4/2020,859,688,41,1588
TIFT,9/5/2020,860,689,41,1590
TIFT,9/6/2020,861,692,41,1594
TIFT,9/7/2020,864,700,41,1605
TIFT,9/8/2020,866,709,41,1616
TIFT,9/9/2020,874,713,41,1628
TIFT,9/10/2020,880,717,42,1639
TIFT,9/11/2020,881,727,42,1650
TIFT,9/12/2020,884,732,42,1658
TIFT,9/13/2020,887,737,42,1666
TIFT,9/14/2020,890,745,42,1677
TIFT,9/15/2020,896,751,43,1690
TIFT,9/16/2020,903,758,43,1704
TIFT,9/17/2020,916,762,43,1721
TIFT,9/18/2020,921,766,43,1730
TIFT,9/19/2020,924,770,43,1737
TIFT,9/20/2020,928,779,43,1750
TIFT,9/21/2020,935,784,43,1762
TIFT,9/22/2020,936,787,43,1766
TIFT,9/23/2020,944,791,43,1778
TIFT,9/24/2020,949,793,43,1785
TIFT,9/25/2020,957,796,43,1796
TIFT,9/26/2020,959,796,43,1798
TIFT,9/27/2020,962,797,43,1802
TIFT,9/28/2020,968,803,43,1814
TIFT,9/29/2020,971,805,43,1819
TIFT,9/30/2020,975,809,43,1827
TIFT,10/1/2020,976,816,43,1835
TIFT,10/2/2020,980,822,43,1845
TIFT,10/3/2020,981,825,43,1849
TIFT,10/4/2020,983,825,43,1851
TIFT,10/5/2020,984,829,43,1856
TIFT,10/6/2020,988,829,43,1860
TIFT,10/7/2020,995,833,43,1871
TIFT,10/8/2020,1000,834,43,1877
TIFT,10/9/2020,1002,836,43,1881
TIFT,10/10/2020,1005,836,43,1884
TIFT,10/11/2020,1007,837,43,1887
TIFT,10/12/2020,1008,841,43,1892
TIFT,10/13/2020,1010,842,43,1895
TIFT,10/14/2020,1012,842,43,1897
TIFT,10/15/2020,1017,842,43,1902
TIFT,10/16/2020,1020,843,43,1906
TIFT,10/17/2020,1021,843,43,1907
TIFT,10/18/2020,1021,845,43,1909
TIFT,10/19/2020,1021,845,43,1909
TIFT,10/20/2020,1021,845,43,1909
TOOMBS,1/1/2020,0,0,0,0
TOOMBS,1/2/2020,0,0,0,0
TOOMBS,1/3/2020,0,0,0,0
TOOMBS,1/4/2020,0,0,0,0
TOOMBS,1/5/2020,0,0,0,0
TOOMBS,1/6/2020,0,0,0,0
TOOMBS,1/7/2020,0,0,0,0
TOOMBS,1/8/2020,0,0,0,0
TOOMBS,1/9/2020,0,0,0,0
TOOMBS,1/10/2020,0,0,0,0
TOOMBS,1/11/2020,0,0,0,0
TOOMBS,1/12/2020,0,0,0,0
TOOMBS,1/13/2020,0,0,0,0
TOOMBS,1/14/2020,0,0,0,0
TOOMBS,1/15/2020,0,0,0,0
TOOMBS,1/16/2020,0,0,0,0
TOOMBS,1/17/2020,0,0,0,0
TOOMBS,1/18/2020,0,0,0,0
TOOMBS,1/19/2020,0,0,0,0
TOOMBS,1/20/2020,0,0,0,0
TOOMBS,1/21/2020,0,0,0,0
TOOMBS,1/22/2020,0,0,0,0
TOOMBS,1/23/2020,0,0,0,0
TOOMBS,1/24/2020,0,0,0,0
TOOMBS,1/25/2020,0,0,0,0
TOOMBS,1/26/2020,0,0,0,0
TOOMBS,1/27/2020,0,0,0,0
TOOMBS,1/28/2020,0,0,0,0
TOOMBS,1/29/2020,0,0,0,0
TOOMBS,1/30/2020,0,0,0,0
TOOMBS,1/31/2020,0,0,0,0
TOOMBS,2/1/2020,1,0,0,1
TOOMBS,2/2/2020,1,0,0,1
TOOMBS,2/3/2020,1,0,0,1
TOOMBS,2/4/2020,1,0,0,1
TOOMBS,2/5/2020,1,0,0,1
TOOMBS,2/6/2020,1,0,0,1
TOOMBS,2/7/2020,1,0,0,1
TOOMBS,2/8/2020,1,0,0,1
TOOMBS,2/9/2020,1,0,0,1
TOOMBS,2/10/2020,1,0,0,1
TOOMBS,2/11/2020,1,0,0,1
TOOMBS,2/12/2020,1,0,0,1
TOOMBS,2/13/2020,1,0,0,1
TOOMBS,2/14/2020,1,0,0,1
TOOMBS,2/15/2020,1,0,0,1
TOOMBS,2/16/2020,1,0,0,1
TOOMBS,2/17/2020,1,0,0,1
TOOMBS,2/18/2020,1,0,0,1
TOOMBS,2/19/2020,1,0,0,1
TOOMBS,2/20/2020,1,0,0,1
TOOMBS,2/21/2020,1,0,0,1
TOOMBS,2/22/2020,1,0,0,1
TOOMBS,2/23/2020,1,0,0,1
TOOMBS,2/24/2020,1,0,0,1
TOOMBS,2/25/2020,1,0,0,1
TOOMBS,2/26/2020,1,0,0,1
TOOMBS,2/27/2020,1,0,0,1
TOOMBS,2/28/2020,1,0,0,1
TOOMBS,2/29/2020,1,0,0,1
TOOMBS,3/1/2020,1,0,0,1
TOOMBS,3/2/2020,1,0,0,1
TOOMBS,3/3/2020,1,0,0,1
TOOMBS,3/4/2020,1,0,0,1
TOOMBS,3/5/2020,1,0,0,1
TOOMBS,3/6/2020,1,0,0,1
TOOMBS,3/7/2020,1,0,0,1
TOOMBS,3/8/2020,1,0,0,1
TOOMBS,3/9/2020,1,0,0,1
TOOMBS,3/10/2020,1,0,0,1
TOOMBS,3/11/2020,1,0,0,1
TOOMBS,3/12/2020,1,0,0,1
TOOMBS,3/13/2020,1,1,0,2
TOOMBS,3/14/2020,1,1,0,2
TOOMBS,3/15/2020,1,1,0,2
TOOMBS,3/16/2020,1,1,0,2
TOOMBS,3/17/2020,1,1,0,2
TOOMBS,3/18/2020,2,2,0,4
TOOMBS,3/19/2020,3,2,0,5
TOOMBS,3/20/2020,3,3,0,6
TOOMBS,3/21/2020,3,4,0,7
TOOMBS,3/22/2020,3,4,0,7
TOOMBS,3/23/2020,3,4,0,7
TOOMBS,3/24/2020,4,4,0,8
TOOMBS,3/25/2020,4,4,0,8
TOOMBS,3/26/2020,4,4,0,8
TOOMBS,3/27/2020,4,4,0,8
TOOMBS,3/28/2020,4,4,0,8
TOOMBS,3/29/2020,4,4,0,8
TOOMBS,3/30/2020,4,4,0,8
TOOMBS,3/31/2020,5,4,0,9
TOOMBS,4/1/2020,8,4,0,12
TOOMBS,4/2/2020,8,5,0,13
TOOMBS,4/3/2020,9,5,0,14
TOOMBS,4/4/2020,9,5,0,14
TOOMBS,4/5/2020,10,5,0,15
TOOMBS,4/6/2020,11,5,0,16
TOOMBS,4/7/2020,12,6,0,18
TOOMBS,4/8/2020,13,6,0,19
TOOMBS,4/9/2020,14,6,0,20
TOOMBS,4/10/2020,15,8,0,23
TOOMBS,4/11/2020,16,9,0,25
TOOMBS,4/12/2020,16,9,0,25
TOOMBS,4/13/2020,17,9,0,26
TOOMBS,4/14/2020,17,10,0,27
TOOMBS,4/15/2020,17,11,0,28
TOOMBS,4/16/2020,18,11,0,29
TOOMBS,4/17/2020,19,11,0,30
TOOMBS,4/18/2020,20,11,0,31
TOOMBS,4/19/2020,20,11,0,31
TOOMBS,4/20/2020,21,13,0,34
TOOMBS,4/21/2020,23,13,0,36
TOOMBS,4/22/2020,23,13,0,36
TOOMBS,4/23/2020,23,13,0,36
TOOMBS,4/24/2020,24,13,0,37
TOOMBS,4/25/2020,24,14,0,38
TOOMBS,4/26/2020,24,14,0,38
TOOMBS,4/27/2020,25,14,0,39
TOOMBS,4/28/2020,25,15,0,40
TOOMBS,4/29/2020,25,16,0,41
TOOMBS,4/30/2020,26,17,0,43
TOOMBS,5/1/2020,26,17,0,43
TOOMBS,5/2/2020,26,18,0,44
TOOMBS,5/3/2020,27,19,0,46
TOOMBS,5/4/2020,28,20,0,48
TOOMBS,5/5/2020,28,20,0,48
TOOMBS,5/6/2020,28,21,0,49
TOOMBS,5/7/2020,28,21,0,49
TOOMBS,5/8/2020,28,23,0,51
TOOMBS,5/9/2020,29,23,0,52
TOOMBS,5/10/2020,29,23,0,52
TOOMBS,5/11/2020,31,23,0,54
TOOMBS,5/12/2020,32,24,0,56
TOOMBS,5/13/2020,32,24,0,56
TOOMBS,5/14/2020,32,24,0,56
TOOMBS,5/15/2020,32,24,0,56
TOOMBS,5/16/2020,32,24,0,56
TOOMBS,5/17/2020,33,24,0,57
TOOMBS,5/18/2020,33,24,0,57
TOOMBS,5/19/2020,34,25,0,59
TOOMBS,5/20/2020,34,26,0,60
TOOMBS,5/21/2020,35,26,0,61
TOOMBS,5/22/2020,35,26,0,61
TOOMBS,5/23/2020,35,26,0,61
TOOMBS,5/24/2020,35,26,0,61
TOOMBS,5/25/2020,35,26,0,61
TOOMBS,5/26/2020,35,26,0,61
TOOMBS,5/27/2020,36,27,0,63
TOOMBS,5/28/2020,42,30,0,72
TOOMBS,5/29/2020,50,37,0,87
TOOMBS,5/30/2020,51,38,0,89
TOOMBS,5/31/2020,51,38,0,89
TROUP,3/11/2020,9,3,0,12
TROUP,3/12/2020,9,3,0,12
TROUP,3/13/2020,10,3,0,13
TROUP,3/14/2020,10,3,0,13
TROUP,3/15/2020,10,4,0,14
TROUP,3/16/2020,11,5,0,16
TROUP,3/17/2020,12,5,0,17
TROUP,3/18/2020,13,6,0,19
TROUP,3/19/2020,16,8,0,24
TROUP,3/20/2020,17,8,0,25
TROUP,3/21/2020,19,8,0,27
TROUP,3/22/2020,19,8,0,27
TROUP,3/23/2020,21,8,0,29
TROUP,3/24/2020,21,8,0,29
TROUP,3/25/2020,25,9,0,34
TROUP,3/26/2020,26,9,0,35
TROUP,3/27/2020,26,10,0,36
TROUP,3/28/2020,26,10,0,36
TROUP,3/29/2020,27,11,0,38
TROUP,3/30/2020,35,17,0,52
TROUP,3/31/2020,37,18,0,55
TROUP,4/1/2020,39,19,0,58
TROUP,4/2/2020,40,19,0,59
TROUP,4/3/2020,41,20,0,61
TROUP,4/4/2020,44,20,0,64
TROUP,4/5/2020,44,21,0,65
TROUP,4/6/2020,49,22,0,71
TROUP,4/7/2020,61,27,0,88
TROUP,4/8/2020,61,27,0,88
TROUP,4/9/2020,64,31,0,95
TROUP,4/10/2020,65,31,0,96
TROUP,4/11/2020,66,31,0,97
TROUP,4/12/2020,69,31,0,100
TROUP,4/13/2020,72,33,0,105
TROUP,4/14/2020,74,37,0,111
TROUP,4/15/2020,78,37,0,115
TROUP,4/16/2020,82,37,0,119
TROUP,4/17/2020,87,40,0,127
TROUP,4/18/2020,88,41,0,129
TROUP,4/19/2020,90,42,0,132
TROUP,4/20/2020,94,44,0,138
TROUP,4/21/2020,98,48,0,146
TROUP,4/22/2020,103,50,0,153
TROUP,4/23/2020,106,51,0,157
TROUP,4/24/2020,108,54,0,162
TROUP,4/25/2020,108,58,0,166
TROUP,4/26/2020,110,59,0,169
TROUP,4/27/2020,112,60,0,172
TROUP,4/28/2020,115,62,0,177
TROUP,4/29/2020,116,63,0,179
TROUP,4/30/2020,120,64,0,184
TROUP,5/1/2020,126,66,0,192
TROUP,5/2/2020,127,68,0,195
TROUP,5/3/2020,127,68,0,195
TROUP,5/4/2020,128,70,0,198
TROUP,5/5/2020,132,74,0,206
TROUP,5/6/2020,136,74,0,210
TROUP,5/7/2020,136,77,0,213
TROUP,5/8/2020,138,79,0,217
TROUP,5/9/2020,138,79,0,217
TROUP,5/10/2020,139,80,0,219
TROUP,5/11/2020,145,82,0,227
TROUP,5/12/2020,149,84,0,233
TROUP,5/13/2020,153,85,0,238
TROUP,5/14/2020,160,87,0,247
TROUP,5/15/2020,164,90,0,254
TROUP,5/16/2020,168,91,0,259
TROUP,5/17/2020,170,93,0,263
TROUP,5/18/2020,177,94,0,271
TROUP,5/19/2020,184,95,0,279
TROUP,5/20/2020,192,97,0,289
TROUP,5/21/2020,198,98,0,296
TROUP,5/22/2020,201,103,0,304
TROUP,5/23/2020,203,107,0,310
TROUP,5/24/2020,209,111,0,320
TROUP,5/25/2020,216,114,0,330
TROUP,5/26/2020,232,128,0,360
TROUP,5/27/2020,246,132,0,378
TROUP,5/28/2020,262,139,0,401
TROUP,5/29/2020,268,140,0,408
TROUP,5/30/2020,273,146,0,419
TROUP,5/31/2020,282,151,0,433
TROUP,6/1/2020,297,158,0,455
TROUP,6/2/2020,316,168,0,484
TROUP,6/3/2020,336,179,1,516
TROUP,6/4/2020,363,193,4,560
TROUP,6/5/2020,392,234,4,630
TROUP,6/6/2020,407,244,7,658
TROUP,6/7/2020,420,252,9,681
TROUP,6/8/2020,457,267,9,733
TROUP,6/9/2020,483,281,11,775
TROUP,6/10/2020,507,298,13,818
TROUP,6/11/2020,532,316,16,864
TROUP,6/12/2020,556,338,21,915
TROUP,6/13/2020,570,344,23,937
TROUP,6/14/2020,580,354,23,957
TROUP,6/15/2020,612,379,24,1015
TROUP,6/16/2020,639,396,32,1067
TROUP,6/17/2020,661,419,42,1122
TROUP,6/18/2020,685,431,49,1165
TROUP,6/19/2020,709,447,56,1212
TROUP,6/20/2020,723,519,59,1301
TROUP,6/21/2020,736,523,63,1322
TROUP,6/22/2020,777,542,64,1383
TROUP,6/23/2020,799,562,66,1427
TROUP,6/24/2020,824,571,68,1463
TROUP,6/25/2020,845,588,75,1508
TROUP,6/26/2020,868,617,78,1563
TROUP,6/27/2020,878,625,81,1584
TROUP,6/28/2020,887,630,84,1601
TROUP,6/29/2020,901,644,87,1632
TROUP,6/30/2020,914,663,90,1667
TROUP,7/1/2020,931,681,90,1702
TROUP,7/2/2020,954,691,90,1735
TROUP,7/3/2020,989,716,90,1795
TROUP,7/4/2020,1001,721,90,1812
TROUP,7/5/2020,1015,728,90,1833
TROUP,7/6/2020,1033,745,90,1868
TROUP,7/7/2020,1053,761,90,1904
TROUP,7/8/2020,1075,782,90,1947
TROUP,7/9/2020,1087,793,90,1970
TROUP,7/10/2020,1100,799,96,1995
TROUP,7/11/2020,1111,806,96,2013
TROUP,7/12/2020,1118,810,96,2024
TROUP,7/13/2020,1128,818,97,2043
TROUP,7/14/2020,1148,829,97,2074
TROUP,7/15/2020,1161,834,99,2094
TROUP,7/16/2020,1172,838,100,2110
TROUP,7/17/2020,1184,849,100,2133
TROUP,7/18/2020,1192,856,101,2149
TROUP,7/19/2020,1195,857,101,2153
TROUP,7/20/2020,1207,866,101,2174
TROUP,7/21/2020,1216,877,101,2194
TROUP,7/22/2020,1222,885,103,2210
TROUP,7/23/2020,1234,893,103,2230
TROUP,7/24/2020,1247,898,103,2248
TROUP,7/25/2020,1258,900,103,2261
TROUP,7/26/2020,1261,902,103,2266
TROUP,7/27/2020,1274,910,103,2287
TROUP,7/28/2020,1279,917,103,2299
TROUP,7/29/2020,1289,927,103,2319
TROUP,7/30/2020,1295,934,103,2332
TROUP,7/31/2020,1296,940,103,2339
TROUP,8/1/2020,1303,944,103,2350
TROUP,8/2/2020,1312,947,103,2362
TROUP,8/3/2020,1322,953,103,2378
TROUP,8/4/2020,1328,959,103,2390
TROUP,8/5/2020,1335,965,103,2403
TROUP,8/6/2020,1338,970,103,2411
TROUP,8/7/2020,1345,975,103,2423
TROUP,8/8/2020,1353,985,103,2441
TROUP,8/9/2020,1358,987,103,2448
TROUP,8/10/2020,1367,995,103,2465
TROUP,8/11/2020,1379,1002,103,2484
TROUP,8/12/2020,1389,1008,103,2500
TROUP,8/13/2020,1398,1013,103,2514
TROUP,8/14/2020,1408,1019,103,2530
TROUP,8/15/2020,1416,1023,103,2542
TROUP,8/16/2020,1418,1025,103,2546
TROUP,8/17/2020,1430,1033,103,2566
TROUP,8/18/2020,1444,1040,103,2587
TROUP,8/19/2020,1447,1042,103,2592
TROUP,8/20/2020,1454,1046,104,2604
TROUP,8/21/2020,1459,1052,104,2615
TROUP,8/22/2020,1462,1054,104,2620
TROUP,8/23/2020,1466,1057,104,2627
TROUP,8/24/2020,1473,1061,104,2638
TROUP,8/25/2020,1479,1064,104,2647
TROUP,8/26/2020,1482,1073,104,2659
TROUP,8/27/2020,1484,1077,104,2665
TROUP,8/28/2020,1488,1085,104,2677
TROUP,8/29/2020,1492,1089,104,2685
TROUP,8/30/2020,1496,1093,104,2693
TROUP,8/31/2020,1504,1095,104,2703
TROUP,9/1/2020,1510,1099,104,2713
TROUP,9/2/2020,1513,1102,104,2719
TROUP,9/3/2020,1517,1104,104,2725
TROUP,9/4/2020,1519,1106,104,2729
TROUP,9/5/2020,1522,1107,104,2733
TROUP,9/6/2020,1523,1107,104,2734
TROUP,9/7/2020,1525,1107,104,2736
TROUP,9/8/2020,1534,1111,104,2749
TROUP,9/9/2020,1536,1116,104,2756
TROUP,9/10/2020,1544,1121,104,2769
TROUP,9/11/2020,1546,1126,104,2776
TROUP,9/12/2020,1547,1128,104,2779
TROUP,9/13/2020,1548,1132,104,2784
TROUP,9/14/2020,1553,1136,104,2793
TROUP,9/15/2020,1557,1138,104,2799
TROUP,9/16/2020,1562,1139,104,2805
TROUP,9/17/2020,1566,1144,104,2814
TROUP,9/18/2020,1570,1149,104,2823
TROUP,9/19/2020,1572,1149,104,2825
TROUP,9/20/2020,1573,1149,104,2826
TROUP,9/21/2020,1578,1152,104,2834
TROUP,9/22/2020,1583,1155,104,2842
TROUP,9/23/2020,1585,1158,104,2847
TROUP,9/24/2020,1587,1160,104,2851
TROUP,9/25/2020,1591,1163,104,2858
TROUP,9/26/2020,1594,1166,104,2864
TROUP,9/27/2020,1597,1166,104,2867
TROUP,9/28/2020,1601,1167,104,2872
TROUP,9/29/2020,1606,1168,104,2878
TROUP,9/30/2020,1609,1168,104,2881
TROUP,10/1/2020,1612,1170,105,2887
TROUP,10/2/2020,1614,1174,105,2893
TROUP,10/3/2020,1618,1178,105,2901
TROUP,10/4/2020,1620,1181,105,2906
TROUP,10/5/2020,1628,1184,105,2917
TROUP,10/6/2020,1628,1188,105,2921
TROUP,10/7/2020,1634,1191,105,2930
TROUP,10/8/2020,1637,1193,105,2935
TROUP,10/9/2020,1640,1196,105,2941
TROUP,10/10/2020,1640,1200,105,2945
TROUP,10/11/2020,1642,1204,105,2951
TROUP,10/12/2020,1647,1208,105,2960
TROUP,10/13/2020,1648,1210,105,2963
TROUP,10/14/2020,1649,1213,105,2967
TROUP,10/15/2020,1650,1214,106,2970
TROUP,10/16/2020,1654,1215,106,2975
TROUP,10/17/2020,1656,1218,106,2980
TROUP,10/18/2020,1656,1218,106,2980
TROUP,10/19/2020,1656,1218,106,2980
TROUP,10/20/2020,1656,1218,106,2980
TWIGGS,1/1/2020,0,0,0,0
TWIGGS,1/2/2020,0,0,0,0
TWIGGS,1/3/2020,0,0,0,0
TWIGGS,1/4/2020,0,0,0,0
TWIGGS,1/5/2020,0,0,0,0
TWIGGS,1/6/2020,0,0,0,0
TWIGGS,1/7/2020,0,0,0,0
TWIGGS,1/8/2020,0,0,0,0
TWIGGS,1/9/2020,0,0,0,0
TWIGGS,1/10/2020,0,0,0,0
TWIGGS,1/11/2020,0,0,0,0
TWIGGS,1/12/2020,0,0,0,0
TWIGGS,1/13/2020,0,0,0,0
TWIGGS,1/14/2020,0,0,0,0
TWIGGS,1/15/2020,0,0,0,0
TWIGGS,1/16/2020,0,0,0,0
TWIGGS,1/17/2020,0,0,0,0
TWIGGS,1/18/2020,0,0,0,0
TWIGGS,1/19/2020,0,0,0,0
TWIGGS,1/20/2020,0,0,0,0
TWIGGS,1/21/2020,0,0,0,0
TWIGGS,1/22/2020,0,0,0,0
TWIGGS,1/23/2020,0,0,0,0
TWIGGS,1/24/2020,0,0,0,0
TWIGGS,1/25/2020,0,0,0,0
TWIGGS,1/26/2020,0,0,0,0
TWIGGS,1/27/2020,0,0,0,0
TWIGGS,1/28/2020,0,0,0,0
TWIGGS,1/29/2020,0,0,0,0
TWIGGS,1/30/2020,0,0,0,0
TWIGGS,1/31/2020,0,0,0,0
TWIGGS,2/1/2020,0,0,0,0
TWIGGS,2/2/2020,0,0,0,0
TWIGGS,2/3/2020,0,0,0,0
TWIGGS,2/4/2020,0,0,0,0
TWIGGS,2/5/2020,0,0,0,0
TWIGGS,2/6/2020,0,0,0,0
TWIGGS,2/7/2020,0,0,0,0
TWIGGS,2/8/2020,0,0,0,0
TWIGGS,2/9/2020,0,0,0,0
TWIGGS,2/10/2020,0,0,0,0
TWIGGS,2/11/2020,0,0,0,0
TWIGGS,2/12/2020,0,0,0,0
TWIGGS,2/13/2020,0,0,0,0
TWIGGS,2/14/2020,0,0,0,0
TWIGGS,2/15/2020,0,0,0,0
TWIGGS,2/16/2020,0,0,0,0
TWIGGS,2/17/2020,0,0,0,0
TWIGGS,2/18/2020,0,0,0,0
TWIGGS,2/19/2020,0,0,0,0
TWIGGS,2/20/2020,0,0,0,0
TWIGGS,2/21/2020,0,0,0,0
TWIGGS,2/22/2020,0,0,0,0
TWIGGS,2/23/2020,0,0,0,0
TWIGGS,2/24/2020,0,0,0,0
TWIGGS,2/25/2020,0,0,0,0
TWIGGS,2/26/2020,0,0,0,0
TWIGGS,2/27/2020,0,0,0,0
TWIGGS,2/28/2020,0,0,0,0
TWIGGS,2/29/2020,0,0,0,0
TWIGGS,3/1/2020,0,0,0,0
TWIGGS,3/2/2020,0,0,0,0
TWIGGS,3/3/2020,0,0,0,0
TWIGGS,3/4/2020,0,0,0,0
TWIGGS,3/5/2020,0,0,0,0
TWIGGS,3/6/2020,0,0,0,0
TWIGGS,3/7/2020,0,0,0,0
TWIGGS,3/8/2020,0,0,0,0
TWIGGS,3/9/2020,0,0,0,0
TWIGGS,3/10/2020,0,0,0,0
TWIGGS,3/11/2020,0,0,0,0
TWIGGS,3/12/2020,0,0,0,0
TWIGGS,3/13/2020,0,0,0,0
TWIGGS,3/14/2020,1,0,0,1
TWIGGS,3/15/2020,1,0,0,1
TWIGGS,3/16/2020,1,0,0,1
TWIGGS,3/17/2020,1,0,0,1
TWIGGS,3/18/2020,1,1,0,2
TWIGGS,3/19/2020,1,1,0,2
TWIGGS,3/20/2020,1,1,0,2
TWIGGS,3/21/2020,1,1,0,2
TWIGGS,3/22/2020,1,1,0,2
TWIGGS,3/23/2020,2,1,0,3
TWIGGS,3/24/2020,2,1,0,3
TWIGGS,3/25/2020,2,1,0,3
TWIGGS,3/26/2020,2,1,0,3
TWIGGS,3/27/2020,2,1,0,3
TWIGGS,3/28/2020,2,1,0,3
TWIGGS,3/29/2020,2,1,0,3
TWIGGS,3/30/2020,2,1,0,3
TWIGGS,3/31/2020,2,1,0,3
TWIGGS,4/1/2020,2,1,0,3
TWIGGS,4/2/2020,2,1,0,3
TWIGGS,4/3/2020,2,2,0,4
TWIGGS,4/4/2020,2,2,0,4
TWIGGS,4/5/2020,2,2,0,4
TWIGGS,4/6/2020,2,2,0,4
TWIGGS,4/7/2020,2,2,0,4
TWIGGS,4/8/2020,3,2,0,5
TWIGGS,4/9/2020,4,2,0,6
TWIGGS,4/10/2020,4,2,0,6
TWIGGS,4/11/2020,4,2,0,6
TWIGGS,4/12/2020,4,2,0,6
TWIGGS,4/13/2020,4,2,0,6
TWIGGS,4/14/2020,4,2,0,6
TWIGGS,4/15/2020,4,2,0,6
TWIGGS,4/16/2020,4,2,0,6
TWIGGS,4/17/2020,4,2,0,6
TWIGGS,4/18/2020,5,3,0,8
TWIGGS,4/19/2020,5,3,0,8
TWIGGS,4/20/2020,5,3,0,8
TWIGGS,4/21/2020,5,4,0,9
TWIGGS,4/22/2020,5,4,0,9
TWIGGS,4/23/2020,5,4,0,9
TWIGGS,4/24/2020,6,4,0,10
TWIGGS,4/25/2020,6,4,0,10
TWIGGS,4/26/2020,6,4,0,10
TWIGGS,4/27/2020,6,4,0,10
TWIGGS,4/28/2020,6,4,0,10
TWIGGS,4/29/2020,6,4,0,10
TWIGGS,4/30/2020,7,4,0,11
TWIGGS,5/1/2020,7,4,0,11
TWIGGS,5/2/2020,7,4,0,11
TWIGGS,5/3/2020,7,4,0,11
TWIGGS,5/4/2020,7,4,0,11
TWIGGS,5/5/2020,7,4,0,11
TWIGGS,5/6/2020,7,4,0,11
TWIGGS,5/7/2020,7,4,0,11
TWIGGS,5/8/2020,7,5,0,12
TWIGGS,5/9/2020,7,5,0,12
TWIGGS,5/10/2020,7,5,0,12
TWIGGS,5/11/2020,7,5,0,12
TWIGGS,5/12/2020,7,5,0,12
TWIGGS,5/13/2020,7,5,0,12
TWIGGS,5/14/2020,8,5,0,13
TWIGGS,5/15/2020,8,5,0,13
TWIGGS,5/16/2020,9,5,0,14
TWIGGS,5/17/2020,9,5,0,14
TWIGGS,5/18/2020,10,6,0,16
TWIGGS,5/19/2020,11,6,0,17
TWIGGS,5/20/2020,11,6,0,17
TWIGGS,5/21/2020,11,6,0,17
TWIGGS,5/22/2020,11,7,0,18
TWIGGS,5/23/2020,12,7,0,19
TWIGGS,5/24/2020,12,7,0,19
TWIGGS,5/25/2020,12,7,0,19
TWIGGS,5/26/2020,12,7,0,19
TWIGGS,5/27/2020,12,7,0,19
TWIGGS,5/28/2020,12,7,0,19
TWIGGS,5/29/2020,12,7,0,19
TWIGGS,5/30/2020,12,7,0,19
TWIGGS,5/31/2020,12,8,0,20
TWIGGS,6/1/2020,12,8,0,20
TWIGGS,6/2/2020,12,8,0,20
TWIGGS,6/3/2020,12,8,0,20
TWIGGS,6/4/2020,13,8,0,21
TWIGGS,6/5/2020,13,8,0,21
TWIGGS,6/6/2020,13,8,0,21
TWIGGS,6/7/2020,13,8,0,21
TWIGGS,6/8/2020,13,8,0,21
TWIGGS,6/9/2020,13,8,0,21
TWIGGS,6/10/2020,14,8,0,22
TWIGGS,6/11/2020,14,8,0,22
TWIGGS,6/12/2020,14,8,0,22
TWIGGS,6/13/2020,14,9,0,23
TWIGGS,6/14/2020,14,9,0,23
TWIGGS,6/15/2020,15,9,0,24
TWIGGS,6/16/2020,15,9,0,24
TWIGGS,6/17/2020,16,9,0,25
TWIGGS,6/18/2020,16,9,0,25
TWIGGS,6/19/2020,16,9,0,25
TWIGGS,6/20/2020,16,9,0,25
TWIGGS,6/21/2020,16,9,0,25
TWIGGS,6/22/2020,16,10,0,26
TWIGGS,6/23/2020,16,10,0,26
TWIGGS,6/24/2020,16,11,0,27
UPSON,10/9/2020,468,346,5,819
TWIGGS,6/25/2020,18,11,0,29
WHITFIELD,4/4/2020,19,21,0,40
WILKES,7/19/2020,92,72,0,164
UPSON,10/10/2020,469,347,5,821
WHITFIELD,4/5/2020,19,21,0,40
WHITFIELD,4/6/2020,21,22,0,43
WHITFIELD,4/7/2020,21,24,0,45
WHITFIELD,4/8/2020,24,24,0,48
WHITFIELD,4/9/2020,24,24,0,48
WHITFIELD,4/10/2020,24,25,0,49
WHITFIELD,4/11/2020,24,27,0,51
WHITFIELD,4/12/2020,25,30,0,55
WHITFIELD,4/13/2020,26,31,0,57
WHITFIELD,4/14/2020,26,33,0,59
WHITFIELD,4/15/2020,30,34,0,64
WHITFIELD,4/16/2020,31,34,0,65
WHITFIELD,4/17/2020,33,38,0,71
WHITFIELD,4/18/2020,34,41,0,75
WHITFIELD,4/19/2020,36,41,0,77
WHITFIELD,4/20/2020,37,42,0,79
WHITFIELD,4/21/2020,41,47,0,88
WHITFIELD,4/22/2020,44,53,0,97
WHITFIELD,4/23/2020,47,58,1,106
WHITFIELD,4/24/2020,50,62,1,113
WHITFIELD,4/25/2020,55,66,1,122
WHITFIELD,4/26/2020,58,67,1,126
WHITFIELD,4/27/2020,67,72,1,140
WHITFIELD,4/28/2020,72,75,1,148
WHITFIELD,4/29/2020,76,79,1,156
WHITFIELD,4/30/2020,80,84,1,165
WHITFIELD,5/1/2020,85,88,1,174
WHITFIELD,5/2/2020,87,91,1,179
WHITFIELD,5/3/2020,91,93,1,185
WHITFIELD,5/4/2020,94,95,1,190
WHITFIELD,5/5/2020,95,96,1,192
WHITFIELD,5/6/2020,98,101,1,200
WHITFIELD,5/7/2020,102,104,1,207
WHITFIELD,5/8/2020,105,105,1,211
WHITFIELD,5/9/2020,106,106,1,213
WHITFIELD,5/10/2020,107,108,1,216
WHITFIELD,5/11/2020,116,114,1,231
WHITFIELD,5/12/2020,120,119,1,240
WHITFIELD,5/13/2020,124,123,1,248
WHITFIELD,5/14/2020,126,128,1,255
WHITFIELD,5/15/2020,135,139,1,275
WHITFIELD,5/16/2020,138,144,1,283
WHITFIELD,5/17/2020,140,149,2,291
WHITFIELD,5/18/2020,148,161,2,311
WHITFIELD,5/19/2020,158,165,2,325
WHITFIELD,5/20/2020,163,169,2,334
WHITFIELD,5/21/2020,171,173,2,346
WHITFIELD,5/22/2020,174,180,2,356
WHITFIELD,5/23/2020,185,188,2,375
WHITFIELD,5/24/2020,189,190,2,381
WHITFIELD,5/25/2020,200,196,2,398
WHITFIELD,5/26/2020,206,209,2,417
WHITFIELD,5/27/2020,220,220,2,442
WHITFIELD,5/28/2020,229,230,2,461
WHITFIELD,5/29/2020,235,239,2,476
WHITFIELD,5/30/2020,244,247,2,493
WHITFIELD,5/31/2020,250,251,2,503
WHITFIELD,6/1/2020,266,258,2,526
WHITFIELD,6/2/2020,274,264,2,540
WHITFIELD,6/3/2020,288,273,2,563
WHITFIELD,6/4/2020,292,277,2,571
WHITFIELD,6/5/2020,298,286,3,587
WHITFIELD,6/6/2020,303,293,3,599
WHITFIELD,6/7/2020,312,303,3,618
WHITFIELD,6/8/2020,324,315,3,642
WHITFIELD,6/9/2020,333,330,3,666
WHITFIELD,6/10/2020,342,343,3,688
WHITFIELD,6/11/2020,354,353,3,710
WHITFIELD,6/12/2020,363,365,3,731
WHITFIELD,6/13/2020,374,379,3,756
WHITFIELD,6/14/2020,387,391,3,781
WHITFIELD,6/15/2020,408,414,3,825
WHITFIELD,6/16/2020,423,428,3,854
WHITFIELD,6/17/2020,436,453,3,892
WHITFIELD,6/18/2020,450,466,3,919
WHITFIELD,6/19/2020,461,484,3,948
WHITFIELD,6/20/2020,474,503,3,980
WHITFIELD,6/21/2020,487,515,3,1005
WHITFIELD,6/22/2020,511,543,3,1057
WHITFIELD,6/23/2020,557,569,3,1129
WHITFIELD,6/24/2020,589,593,3,1185
WHITFIELD,6/25/2020,612,608,3,1223
WHITFIELD,6/26/2020,648,645,3,1296
WHITFIELD,6/27/2020,686,665,3,1354
WHITFIELD,6/28/2020,703,676,3,1382
WHITFIELD,6/29/2020,730,699,3,1432
WHITFIELD,6/30/2020,780,728,4,1512
WHITFIELD,7/1/2020,826,762,4,1592
WHITFIELD,7/2/2020,869,806,4,1679
WHITFIELD,7/3/2020,914,839,5,1758
WHITFIELD,7/4/2020,950,860,6,1816
WHITFIELD,7/5/2020,975,881,6,1862
WHITFIELD,7/6/2020,1047,927,8,1982
WHITFIELD,7/7/2020,1090,979,9,2078
WHITFIELD,7/8/2020,1131,1027,9,2167
WHITFIELD,7/9/2020,1174,1064,9,2247
WHITFIELD,7/10/2020,1209,1112,9,2330
WHITFIELD,7/11/2020,1250,1144,10,2404
WHITFIELD,7/12/2020,1271,1174,10,2455
WHITFIELD,7/13/2020,1315,1217,12,2544
WHITFIELD,7/14/2020,1343,1256,12,2611
WHITFIELD,7/15/2020,1378,1298,12,2688
WHITFIELD,7/16/2020,1418,1329,13,2760
WHITFIELD,7/17/2020,1451,1355,13,2819
WHITFIELD,7/18/2020,1480,1386,13,2879
WHITFIELD,7/19/2020,1505,1406,13,2924
WHITFIELD,7/20/2020,1539,1444,13,2996
WHITFIELD,7/21/2020,1569,1469,13,3051
WHITFIELD,7/22/2020,1603,1483,13,3099
WHITFIELD,7/23/2020,1638,1502,13,3153
WHITFIELD,7/24/2020,1657,1531,13,3201
WHITFIELD,7/25/2020,1689,1566,13,3268
WHITFIELD,7/26/2020,1709,1576,13,3298
WHITFIELD,7/27/2020,1745,1601,13,3359
WHITFIELD,7/28/2020,1768,1626,13,3407
WHITFIELD,7/29/2020,1796,1641,13,3450
WHITFIELD,7/30/2020,1813,1651,13,3477
WHITFIELD,7/31/2020,1828,1664,13,3505
WHITFIELD,8/1/2020,1849,1672,13,3534
WHITFIELD,8/2/2020,1856,1682,13,3551
WHITFIELD,8/3/2020,1869,1694,13,3576
WHITFIELD,8/4/2020,1894,1709,14,3617
WHITFIELD,8/5/2020,1907,1722,15,3644
WHITFIELD,8/6/2020,1919,1734,15,3668
WHITFIELD,8/7/2020,1935,1749,15,3699
WHITFIELD,8/8/2020,1944,1760,15,3719
WHITFIELD,8/9/2020,1954,1769,15,3738
WHITFIELD,8/10/2020,1978,1783,15,3776
WHITFIELD,8/11/2020,1989,1793,15,3797
WHITFIELD,8/12/2020,1996,1800,15,3811
WHITFIELD,8/13/2020,2010,1802,15,3827
WHITFIELD,8/14/2020,2022,1805,15,3842
WHITFIELD,8/15/2020,2029,1814,15,3858
WHITFIELD,8/16/2020,2034,1819,15,3868
WHITFIELD,8/17/2020,2044,1832,15,3891
WHITFIELD,8/18/2020,2056,1837,15,3908
WHITFIELD,8/19/2020,2062,1848,15,3925
WHITFIELD,8/20/2020,2072,1851,15,3938
WHITFIELD,8/21/2020,2079,1864,15,3958
WHITFIELD,8/22/2020,2085,1864,15,3964
WHITFIELD,8/23/2020,2093,1867,15,3975
WHITFIELD,8/24/2020,2118,1877,15,4010
WHITFIELD,8/25/2020,2134,1884,15,4033
WHITFIELD,8/26/2020,2141,1894,15,4050
WHITFIELD,8/27/2020,2150,1902,15,4067
WHITFIELD,8/28/2020,2162,1912,15,4089
WHITFIELD,8/29/2020,2169,1920,15,4104
WHITFIELD,8/30/2020,2177,1925,16,4118
WHITFIELD,8/31/2020,2197,1939,17,4153
WHITFIELD,9/1/2020,2205,1959,17,4181
WHITFIELD,9/2/2020,2220,1967,17,4204
WHITFIELD,9/3/2020,2229,1978,17,4224
WHITFIELD,9/4/2020,2240,1993,17,4250
WHITFIELD,9/5/2020,2246,1995,17,4258
WHITFIELD,9/6/2020,2255,2006,17,4278
WHITFIELD,9/7/2020,2263,2020,17,4300
WHITFIELD,9/8/2020,2280,2033,17,4330
WHITFIELD,9/9/2020,2296,2043,18,4357
WHITFIELD,9/10/2020,2304,2053,18,4375
WHITFIELD,9/11/2020,2313,2062,18,4393
WHITFIELD,9/12/2020,2323,2068,18,4409
WHITFIELD,9/13/2020,2332,2077,18,4427
WHITFIELD,9/14/2020,2342,2091,18,4451
WHITFIELD,9/15/2020,2352,2105,18,4475
WHITFIELD,9/16/2020,2360,2114,18,4492
WHITFIELD,9/17/2020,2369,2123,18,4510
WHITFIELD,9/18/2020,2379,2131,18,4528
WHITFIELD,9/19/2020,2384,2135,19,4538
WHITFIELD,9/20/2020,2394,2142,19,4555
WHITFIELD,9/21/2020,2404,2155,19,4578
WHITFIELD,9/22/2020,2414,2164,19,4597
WHITFIELD,9/23/2020,2421,2170,19,4610
WHITFIELD,9/24/2020,2429,2180,19,4628
WHITFIELD,9/25/2020,2441,2186,19,4646
WHITFIELD,9/26/2020,2452,2194,19,4665
WHITFIELD,9/27/2020,2467,2202,19,4688
WHITFIELD,9/28/2020,2484,2210,20,4714
WHITFIELD,9/29/2020,2493,2218,21,4732
WHITFIELD,9/30/2020,2500,2228,22,4750
WHITFIELD,10/1/2020,2513,2241,22,4776
WHITFIELD,10/2/2020,2523,2248,23,4794
WHITFIELD,10/3/2020,2530,2260,23,4813
WHITFIELD,10/4/2020,2537,2264,23,4824
WHITFIELD,10/5/2020,2550,2278,23,4851
WHITFIELD,10/6/2020,2562,2289,23,4874
WHITFIELD,10/7/2020,2571,2301,23,4895
WHITFIELD,10/8/2020,2588,2309,23,4920
WHITFIELD,10/9/2020,2600,2326,23,4949
WHITFIELD,10/10/2020,2608,2341,23,4972
WHITFIELD,10/11/2020,2617,2347,23,4987
WHITFIELD,10/12/2020,2639,2362,23,5024
WHITFIELD,10/13/2020,2657,2376,23,5056
WHITFIELD,10/14/2020,2668,2382,23,5073
WHITFIELD,10/15/2020,2678,2391,23,5092
WHITFIELD,10/16/2020,2688,2398,23,5109
WHITFIELD,10/17/2020,2690,2398,23,5111
WHITFIELD,10/18/2020,2692,2400,23,5115
WHITFIELD,10/19/2020,2695,2400,23,5118
WHITFIELD,10/20/2020,2695,2400,23,5118
WILKES,1/1/2020,0,0,0,0
WILKES,1/2/2020,0,0,0,0
WILKES,1/3/2020,0,0,0,0
WILKES,1/4/2020,0,0,0,0
WILKES,1/5/2020,0,0,0,0
WILKES,1/6/2020,0,0,0,0
WILKES,1/7/2020,0,0,0,0
WILKES,1/8/2020,0,0,0,0
WILKES,1/9/2020,0,0,0,0
WILKES,1/10/2020,0,0,0,0
WILKES,1/11/2020,0,0,0,0
WILKES,1/12/2020,0,0,0,0
WILKES,1/13/2020,0,0,0,0
WILKES,1/14/2020,0,0,0,0
WILKES,1/15/2020,0,0,0,0
WILKES,1/16/2020,0,0,0,0
WILKES,1/17/2020,0,0,0,0
WILKES,1/18/2020,0,0,0,0
WILKES,1/19/2020,0,0,0,0
WILKES,1/20/2020,0,0,0,0
WILKES,1/21/2020,0,0,0,0
WILKES,1/22/2020,0,0,0,0
WILKES,1/23/2020,0,0,0,0
WILKES,1/24/2020,0,0,0,0
WILKES,1/25/2020,0,0,0,0
WILKES,1/26/2020,0,0,0,0
WILKES,1/27/2020,0,0,0,0
WILKES,1/28/2020,0,0,0,0
WILKES,1/29/2020,0,0,0,0
WILKES,1/30/2020,0,0,0,0
WILKES,1/31/2020,0,0,0,0
WILKES,2/1/2020,0,0,0,0
WILKES,2/2/2020,0,0,0,0
WILKES,2/3/2020,0,0,0,0
WILKES,2/4/2020,0,0,0,0
WILKES,2/5/2020,0,0,0,0
WILKES,2/6/2020,0,0,0,0
WILKES,2/7/2020,0,0,0,0
WILKES,2/8/2020,0,0,0,0
WILKES,2/9/2020,0,0,0,0
WILKES,2/10/2020,0,0,0,0
WILKES,2/11/2020,0,0,0,0
WILKES,2/12/2020,0,0,0,0
WILKES,2/13/2020,0,0,0,0
WILKES,2/14/2020,0,0,0,0
WILKES,2/15/2020,0,0,0,0
WILKES,2/16/2020,0,0,0,0
WILKES,2/17/2020,0,0,0,0
WILKES,2/18/2020,0,0,0,0
WILKES,2/19/2020,0,0,0,0
WILKES,2/20/2020,0,0,0,0
WILKES,2/21/2020,0,0,0,0
WILKES,2/22/2020,0,0,0,0
WILKES,2/23/2020,0,0,0,0
WILKES,2/24/2020,0,0,0,0
WILKES,2/25/2020,0,0,0,0
WILKES,2/26/2020,0,0,0,0
WILKES,2/27/2020,0,0,0,0
WILKES,2/28/2020,0,0,0,0
WILKES,2/29/2020,0,0,0,0
WILKES,3/1/2020,0,0,0,0
WILKES,3/2/2020,0,0,0,0
WILKES,3/3/2020,0,0,0,0
WILKES,3/4/2020,0,0,0,0
WILKES,3/5/2020,0,0,0,0
WILKES,3/6/2020,0,0,0,0
WILKES,3/7/2020,0,0,0,0
WILKES,3/8/2020,0,0,0,0
WILKES,3/9/2020,0,0,0,0
WILKES,3/10/2020,0,0,0,0
WILKES,3/11/2020,0,0,0,0
WILKES,3/12/2020,0,0,0,0
WILKES,3/13/2020,0,0,0,0
WILKES,3/14/2020,0,0,0,0
WILKES,3/15/2020,0,0,0,0
WILKES,3/16/2020,0,0,0,0
WILKES,3/17/2020,1,0,0,1
WILKES,3/18/2020,2,0,0,2
WILKES,3/19/2020,2,0,0,2
WILKES,3/20/2020,2,1,0,3
WILKES,3/21/2020,2,1,0,3
WILKES,3/22/2020,2,1,0,3
WILKES,3/23/2020,2,1,0,3
WILKES,3/24/2020,3,1,0,4
WILKES,3/25/2020,3,1,0,4
WILKES,3/26/2020,3,1,0,4
WILKES,3/27/2020,3,1,0,4
WILKES,3/28/2020,3,1,0,4
WILKES,3/29/2020,3,1,0,4
WILKES,3/30/2020,3,1,0,4
WILKES,3/31/2020,4,1,0,5
WILKES,4/1/2020,4,1,0,5
WILKES,4/2/2020,4,2,0,6
WILKES,4/3/2020,4,2,0,6
WILKES,4/4/2020,4,2,0,6
WILKES,4/5/2020,4,2,0,6
WILKES,4/6/2020,4,2,0,6
WILKES,4/7/2020,4,2,0,6
WILKES,4/8/2020,5,4,0,9
WILKES,4/9/2020,5,4,0,9
WILKES,4/10/2020,5,4,0,9
WILKES,4/11/2020,5,4,0,9
WILKES,4/12/2020,5,4,0,9
WILKES,4/13/2020,7,5,0,12
WILKES,4/14/2020,8,5,0,13
WILKES,4/15/2020,10,7,0,17
WILKES,4/16/2020,15,8,0,23
WILKES,4/17/2020,16,9,0,25
WILKES,4/18/2020,16,9,0,25
WILKES,4/19/2020,17,9,0,26
WILKES,4/20/2020,18,10,0,28
WILKES,4/21/2020,18,10,0,28
WILKES,4/22/2020,18,10,0,28
WILKES,4/23/2020,18,10,0,28
WILKES,4/24/2020,18,12,0,30
WILKES,4/25/2020,18,12,0,30
WILKES,4/26/2020,18,12,0,30
WILKES,4/27/2020,18,12,0,30
WILKES,4/28/2020,19,12,0,31
WILKES,4/29/2020,19,12,0,31
WILKES,4/30/2020,19,12,0,31
WILKES,5/1/2020,19,12,0,31
WILKES,5/2/2020,19,12,0,31
WILKES,5/3/2020,19,12,0,31
WILKES,5/4/2020,19,12,0,31
WILKES,5/5/2020,19,12,0,31
WILKES,5/6/2020,19,12,0,31
WILKES,5/7/2020,19,12,0,31
WILKES,5/8/2020,19,12,0,31
WILKES,5/9/2020,19,12,0,31
WILKES,5/10/2020,20,12,0,32
WILKES,5/11/2020,20,12,0,32
WILKES,5/12/2020,20,12,0,32
WILKES,5/13/2020,21,12,0,33
WILKES,5/14/2020,22,12,0,34
WILKES,5/15/2020,22,12,0,34
WILKES,5/16/2020,22,12,0,34
WILKES,5/17/2020,22,12,0,34
WILKES,5/18/2020,23,12,0,35
WILKES,5/19/2020,24,12,0,36
WILKES,5/20/2020,24,12,0,36
WILKES,5/21/2020,24,12,0,36
WILKES,5/22/2020,24,12,0,36
WILKES,5/23/2020,24,12,0,36
WILKES,5/24/2020,24,12,0,36
WILKES,5/25/2020,24,12,0,36
WILKES,5/26/2020,24,12,0,36
WILKES,5/27/2020,24,12,0,36
WILKES,5/28/2020,24,12,0,36
WILKES,5/29/2020,24,12,0,36
WILKES,5/30/2020,24,12,0,36
WILKES,5/31/2020,24,12,0,36
WILKES,6/1/2020,24,12,0,36
WILKES,6/2/2020,24,12,0,36
WILKES,6/3/2020,24,12,0,36
WILKES,6/4/2020,25,12,0,37
WILKES,6/5/2020,25,12,0,37
WILKES,6/6/2020,26,12,0,38
WILKES,6/7/2020,26,12,0,38
WILKES,6/8/2020,28,12,0,40
WILKES,6/9/2020,28,12,0,40
WILKES,6/10/2020,28,12,0,40
WILKES,6/11/2020,30,13,0,43
WILKES,6/12/2020,31,14,0,45
WILKES,6/13/2020,31,14,0,45
WILKES,6/14/2020,31,14,0,45
WILKES,6/15/2020,32,14,0,46
WILKES,6/16/2020,32,16,0,48
WILKES,6/17/2020,33,16,0,49
WILKES,6/18/2020,36,16,0,52
WILKES,6/19/2020,36,17,0,53
WILKES,6/20/2020,37,17,0,54
WILKES,6/21/2020,37,17,0,54
WILKES,6/22/2020,39,18,0,57
WILKES,6/23/2020,39,20,0,59
WILKES,6/24/2020,41,20,0,61
WILKES,6/25/2020,42,20,0,62
WILKES,6/26/2020,43,21,0,64
WILKES,6/27/2020,44,21,0,65
WILKES,6/28/2020,45,22,0,67
WILKES,6/29/2020,49,25,0,74
WILKES,6/30/2020,55,32,0,87
WILKES,7/1/2020,59,36,0,95
WILKES,7/2/2020,61,39,0,100
WILKES,7/3/2020,63,41,0,104
WILKES,7/4/2020,64,41,0,105
WILKES,7/5/2020,64,41,0,105
WILKES,7/6/2020,73,46,0,119
WILKES,7/7/2020,75,50,0,125
WILKES,7/8/2020,75,53,0,128
WILKES,7/9/2020,77,55,0,132
WILKES,7/10/2020,80,59,0,139
WILKES,7/11/2020,82,60,0,142
WILKES,7/12/2020,83,60,0,143
WILKES,7/13/2020,85,63,0,148
WILKES,7/14/2020,86,63,0,149
WILKES,7/15/2020,89,67,0,156
WILKES,7/16/2020,91,69,0,160
WILKES,7/17/2020,92,71,0,163
WILKES,7/18/2020,92,71,0,163
TWIGGS,6/26/2020,19,12,0,31
UPSON,10/11/2020,473,347,5,825
TWIGGS,6/27/2020,19,13,0,32
UPSON,10/12/2020,474,347,5,826
UPSON,10/13/2020,474,348,5,827
UPSON,10/14/2020,474,348,5,827
WILKES,7/20/2020,95,74,0,169
UPSON,10/15/2020,474,348,5,827
WILKES,7/21/2020,96,75,0,171
UPSON,10/16/2020,475,348,5,828
WILKES,7/22/2020,98,78,0,176
TWIGGS,6/28/2020,19,14,0,33
UPSON,10/17/2020,475,348,5,828
WILKES,7/23/2020,98,79,0,177
TWIGGS,6/29/2020,19,15,0,34
UPSON,10/18/2020,475,348,5,828
WILKES,7/24/2020,100,80,0,180
TWIGGS,6/30/2020,20,15,0,35
WILKES,7/25/2020,101,80,0,181
TWIGGS,7/1/2020,20,17,0,37
UPSON,10/19/2020,475,348,5,828
WILKES,7/26/2020,101,80,0,181
WILKES,7/27/2020,102,80,0,182
WILKES,7/28/2020,104,83,0,187
WILKES,7/29/2020,105,85,0,190
WILKES,7/30/2020,106,85,0,191
WILKES,7/31/2020,107,86,0,193
WILKES,8/1/2020,109,88,0,197
WILKES,8/2/2020,109,88,0,197
WILKES,8/3/2020,109,88,0,197
WILKES,8/4/2020,113,89,0,202
WILKES,8/5/2020,114,90,0,204
WILKES,8/6/2020,114,90,0,204
WILKES,8/7/2020,115,91,0,206
WILKES,8/8/2020,115,91,0,206
WILKES,8/9/2020,115,91,0,206
WILKES,8/10/2020,116,93,0,209
WILKES,8/11/2020,117,93,0,210
WILKES,8/12/2020,117,93,0,210
WILKES,8/13/2020,117,95,0,212
WILKES,8/14/2020,117,97,0,214
WILKES,8/15/2020,117,98,0,215
WILKES,8/16/2020,117,98,0,215
WILKES,8/17/2020,117,98,0,215
WILKES,8/18/2020,118,98,0,216
WILKES,8/19/2020,119,99,0,218
WILKES,8/20/2020,122,99,0,221
WILKES,8/21/2020,123,99,0,222
WILKES,8/22/2020,123,99,0,222
WILKES,8/23/2020,123,100,0,223
WILKES,8/24/2020,123,101,0,224
WILKES,8/25/2020,124,102,0,226
WILKES,8/26/2020,125,103,0,228
WILKES,8/27/2020,126,105,0,231
WILKES,8/28/2020,126,106,0,232
WILKES,8/29/2020,126,106,0,232
WILKES,8/30/2020,129,107,0,236
WILKES,8/31/2020,131,107,0,238
WILKES,9/1/2020,133,108,1,242
WILKES,9/2/2020,133,108,1,242
WILKES,9/3/2020,133,108,1,242
WILKES,9/4/2020,133,109,1,243
WILKES,9/5/2020,133,110,1,244
WILKES,9/6/2020,133,111,1,245
WILKES,9/7/2020,135,114,1,250
WILKES,9/8/2020,135,116,1,252
WILKES,9/9/2020,135,116,1,252
WILKES,9/10/2020,135,117,1,253
WILKES,9/11/2020,136,119,1,256
WILKES,9/12/2020,136,119,1,256
WILKES,9/13/2020,136,119,1,256
WILKES,9/14/2020,137,123,1,261
WILKES,9/15/2020,138,123,1,262
WILKES,9/16/2020,138,124,1,263
WILKES,9/17/2020,138,125,1,264
WILKES,9/18/2020,139,125,1,265
WILKES,9/19/2020,139,125,1,265
WILKES,9/20/2020,140,125,1,266
WILKES,9/21/2020,140,125,1,266
WILKES,9/22/2020,140,125,1,266
WILKES,9/23/2020,140,125,1,266
WILKES,9/24/2020,142,126,1,269
WILKES,9/25/2020,142,126,1,269
WILKES,9/26/2020,142,126,1,269
WILKES,9/27/2020,142,126,1,269
WILKES,9/28/2020,142,126,1,269
WILKES,9/29/2020,142,126,1,269
WILKES,9/30/2020,142,126,1,269
WILKES,10/1/2020,142,126,1,269
WILKES,10/2/2020,142,126,1,269
WILKES,10/3/2020,143,126,1,270
WILKES,10/4/2020,143,127,1,271
WILKES,10/5/2020,143,128,1,272
WILKES,10/6/2020,143,128,1,272
WILKES,10/7/2020,143,128,1,272
WILKES,10/8/2020,143,128,1,272
WILKES,10/9/2020,143,128,1,272
WILKES,10/10/2020,143,129,1,273
WILKES,10/11/2020,144,131,1,276
WILKES,10/12/2020,145,131,1,277
WILKES,10/13/2020,145,131,1,277
WILKES,10/14/2020,145,132,1,278
WILKES,10/15/2020,146,133,1,280
WILKES,10/16/2020,147,134,1,282
WILKES,10/17/2020,147,134,1,282
WILKES,10/18/2020,147,134,1,282
WILKES,10/19/2020,147,134,1,282
WILKES,10/20/2020,147,134,1,282
FRANKLIN,1/1/2020,0,0,0,0
FRANKLIN,1/2/2020,0,0,0,0
FRANKLIN,1/3/2020,0,0,0,0
FRANKLIN,1/4/2020,0,0,0,0
FRANKLIN,1/5/2020,0,0,0,0
FRANKLIN,1/6/2020,0,0,0,0
FRANKLIN,1/7/2020,0,0,0,0
FRANKLIN,1/8/2020,0,0,0,0
FRANKLIN,1/9/2020,0,0,0,0
FRANKLIN,1/10/2020,0,0,0,0
FRANKLIN,1/11/2020,0,0,0,0
FRANKLIN,1/12/2020,0,0,0,0
FRANKLIN,1/13/2020,0,0,0,0
FRANKLIN,1/14/2020,0,0,0,0
FRANKLIN,1/15/2020,0,0,0,0
FRANKLIN,1/16/2020,0,0,0,0
FRANKLIN,1/17/2020,0,0,0,0
FRANKLIN,1/18/2020,0,0,0,0
FRANKLIN,1/19/2020,0,0,0,0
FRANKLIN,1/20/2020,0,0,0,0
FRANKLIN,1/21/2020,0,0,0,0
FRANKLIN,1/22/2020,0,0,0,0
FRANKLIN,1/23/2020,0,0,0,0
FRANKLIN,1/24/2020,0,0,0,0
FRANKLIN,1/25/2020,0,0,0,0
FRANKLIN,1/26/2020,0,0,0,0
FRANKLIN,1/27/2020,0,0,0,0
FRANKLIN,1/28/2020,0,0,0,0
FRANKLIN,1/29/2020,0,0,0,0
FRANKLIN,1/30/2020,0,0,0,0
FRANKLIN,1/31/2020,0,0,0,0
FRANKLIN,2/1/2020,0,0,0,0
FRANKLIN,2/2/2020,0,0,0,0
FRANKLIN,2/3/2020,0,0,0,0
FRANKLIN,2/4/2020,0,0,0,0
FRANKLIN,2/5/2020,0,0,0,0
FRANKLIN,2/6/2020,0,0,0,0
FRANKLIN,2/7/2020,0,0,0,0
FRANKLIN,2/8/2020,0,0,0,0
FRANKLIN,2/9/2020,0,0,0,0
FRANKLIN,2/10/2020,0,0,0,0
FRANKLIN,2/11/2020,0,0,0,0
FRANKLIN,2/12/2020,0,0,0,0
FRANKLIN,2/13/2020,0,0,0,0
FRANKLIN,2/14/2020,0,0,0,0
FRANKLIN,2/15/2020,0,0,0,0
FRANKLIN,2/16/2020,0,0,0,0
FRANKLIN,2/17/2020,0,0,0,0
FRANKLIN,2/18/2020,0,0,0,0
FRANKLIN,2/19/2020,0,0,0,0
FRANKLIN,2/20/2020,0,0,0,0
FRANKLIN,2/21/2020,0,0,0,0
FRANKLIN,2/22/2020,0,0,0,0
FRANKLIN,2/23/2020,0,0,0,0
FRANKLIN,2/24/2020,0,0,0,0
FRANKLIN,2/25/2020,0,0,0,0
FRANKLIN,2/26/2020,0,0,0,0
FRANKLIN,2/27/2020,0,0,0,0
FRANKLIN,2/28/2020,0,0,0,0
FRANKLIN,2/29/2020,0,0,0,0
FRANKLIN,3/1/2020,0,0,0,0
FRANKLIN,3/2/2020,0,0,0,0
FRANKLIN,3/3/2020,0,0,0,0
FRANKLIN,3/4/2020,0,0,0,0
FRANKLIN,3/5/2020,0,0,0,0
FRANKLIN,3/6/2020,0,0,0,0
FRANKLIN,3/7/2020,0,0,0,0
FRANKLIN,3/8/2020,0,0,0,0
FRANKLIN,3/9/2020,0,0,0,0
FRANKLIN,3/10/2020,0,0,0,0
FRANKLIN,3/11/2020,0,0,0,0
FRANKLIN,3/12/2020,0,0,0,0
FRANKLIN,3/13/2020,0,0,0,0
FRANKLIN,3/14/2020,0,0,0,0
FRANKLIN,3/15/2020,0,0,0,0
FRANKLIN,3/16/2020,0,0,0,0
FRANKLIN,3/17/2020,0,0,0,0
FRANKLIN,3/18/2020,0,0,0,0
FRANKLIN,3/19/2020,1,0,0,1
FRANKLIN,3/20/2020,1,0,0,1
FRANKLIN,3/21/2020,1,0,0,1
FRANKLIN,3/22/2020,1,0,0,1
FRANKLIN,3/23/2020,3,0,0,3
FRANKLIN,3/24/2020,3,0,0,3
FRANKLIN,3/25/2020,3,1,0,4
FRANKLIN,3/26/2020,3,1,0,4
FRANKLIN,3/27/2020,3,1,0,4
FRANKLIN,3/28/2020,3,1,0,4
FRANKLIN,3/29/2020,3,1,0,4
FRANKLIN,3/30/2020,3,2,0,5
FRANKLIN,3/31/2020,3,2,0,5
FRANKLIN,4/1/2020,3,2,0,5
FRANKLIN,4/2/2020,3,2,0,5
FRANKLIN,4/3/2020,3,2,0,5
FRANKLIN,4/4/2020,4,3,0,7
FRANKLIN,4/5/2020,4,3,0,7
FRANKLIN,4/6/2020,4,3,0,7
FRANKLIN,4/7/2020,4,3,0,7
FRANKLIN,4/8/2020,4,3,0,7
FRANKLIN,4/9/2020,6,3,0,9
FRANKLIN,4/10/2020,6,4,0,10
FRANKLIN,4/11/2020,6,4,0,10
FRANKLIN,4/12/2020,6,4,0,10
FRANKLIN,4/13/2020,6,4,0,10
FRANKLIN,4/14/2020,7,5,0,12
FRANKLIN,4/15/2020,7,5,0,12
FRANKLIN,4/16/2020,8,5,0,13
FRANKLIN,4/17/2020,9,5,0,14
FRANKLIN,4/18/2020,10,5,0,15
FRANKLIN,4/19/2020,10,6,0,16
FRANKLIN,4/20/2020,10,6,0,16
FRANKLIN,4/21/2020,11,6,0,17
FRANKLIN,4/22/2020,12,6,0,18
FRANKLIN,4/23/2020,14,6,0,20
FRANKLIN,4/24/2020,15,6,0,21
FRANKLIN,4/25/2020,15,6,0,21
FRANKLIN,4/26/2020,15,6,0,21
FRANKLIN,4/27/2020,15,6,0,21
FRANKLIN,4/28/2020,15,6,0,21
FRANKLIN,4/29/2020,15,7,0,22
FRANKLIN,4/30/2020,16,7,0,23
FRANKLIN,5/1/2020,18,9,0,27
FRANKLIN,5/2/2020,18,9,0,27
FRANKLIN,5/3/2020,19,9,0,28
FRANKLIN,5/4/2020,19,9,0,28
FRANKLIN,5/5/2020,20,9,0,29
FRANKLIN,5/6/2020,20,9,0,29
FRANKLIN,5/7/2020,20,9,0,29
FRANKLIN,5/8/2020,20,10,0,30
FRANKLIN,5/9/2020,20,10,0,30
FRANKLIN,5/10/2020,20,10,0,30
FRANKLIN,5/11/2020,22,11,0,33
FRANKLIN,5/12/2020,22,14,0,36
FRANKLIN,5/13/2020,25,15,0,40
FRANKLIN,5/14/2020,25,15,0,40
FRANKLIN,5/15/2020,25,15,0,40
FRANKLIN,5/16/2020,25,15,0,40
FRANKLIN,5/17/2020,25,15,0,40
FRANKLIN,5/18/2020,25,15,0,40
FRANKLIN,5/19/2020,26,15,0,41
FRANKLIN,5/20/2020,29,15,0,44
FRANKLIN,5/21/2020,31,15,0,46
FRANKLIN,5/22/2020,38,20,0,58
FRANKLIN,5/23/2020,44,20,0,64
FRANKLIN,5/24/2020,56,20,0,76
FRANKLIN,5/25/2020,64,20,0,84
FRANKLIN,5/26/2020,73,23,0,96
FRANKLIN,5/27/2020,76,23,0,99
FRANKLIN,5/28/2020,79,23,0,102
FRANKLIN,5/29/2020,95,24,0,119
FRANKLIN,5/30/2020,100,24,0,124
FRANKLIN,5/31/2020,101,25,0,126
FRANKLIN,6/1/2020,113,26,0,139
FRANKLIN,6/2/2020,115,29,0,144
FRANKLIN,6/3/2020,117,29,0,146
FRANKLIN,6/4/2020,117,29,0,146
FRANKLIN,6/5/2020,118,34,0,152
FRANKLIN,6/6/2020,124,34,0,158
FRANKLIN,6/7/2020,125,34,0,159
FRANKLIN,6/8/2020,126,34,0,160
FRANKLIN,6/9/2020,127,34,0,161
FRANKLIN,6/10/2020,127,34,0,161
FRANKLIN,6/11/2020,128,35,0,163
FRANKLIN,6/12/2020,129,36,0,165
FRANKLIN,6/13/2020,129,38,0,167
FRANKLIN,6/14/2020,130,38,0,168
FRANKLIN,6/15/2020,132,43,0,175
FRANKLIN,6/16/2020,135,45,0,180
FRANKLIN,6/17/2020,137,45,0,182
FRANKLIN,6/18/2020,138,46,0,184
FRANKLIN,6/19/2020,138,46,0,184
FRANKLIN,6/20/2020,140,48,0,188
FRANKLIN,6/21/2020,141,49,0,190
FRANKLIN,6/22/2020,142,52,1,195
FRANKLIN,6/23/2020,149,56,1,206
FRANKLIN,6/24/2020,152,62,1,215
FRANKLIN,6/25/2020,154,65,1,220
FRANKLIN,6/26/2020,155,66,1,222
FRANKLIN,6/27/2020,158,68,1,227
FRANKLIN,6/28/2020,159,70,1,230
FRANKLIN,6/29/2020,163,73,1,237
FRANKLIN,6/30/2020,169,75,1,245
FRANKLIN,7/1/2020,171,76,1,248
FRANKLIN,7/2/2020,174,78,1,253
FRANKLIN,7/3/2020,175,81,1,257
FRANKLIN,7/4/2020,175,83,1,259
FRANKLIN,7/5/2020,179,84,1,264
FRANKLIN,7/6/2020,188,88,2,278
FRANKLIN,7/7/2020,194,90,2,286
FRANKLIN,7/8/2020,200,96,2,298
FRANKLIN,7/9/2020,203,99,2,304
FRANKLIN,7/10/2020,209,105,2,316
FRANKLIN,7/11/2020,209,105,3,317
FRANKLIN,7/12/2020,215,107,3,325
FRANKLIN,7/13/2020,224,108,3,335
FRANKLIN,7/14/2020,227,115,3,345
FRANKLIN,7/15/2020,230,118,4,352
FRANKLIN,7/16/2020,233,120,4,357
FRANKLIN,7/17/2020,235,120,4,359
FRANKLIN,7/18/2020,238,120,4,362
FRANKLIN,7/19/2020,242,122,4,368
FRANKLIN,7/20/2020,243,126,5,374
FRANKLIN,7/21/2020,248,133,5,386
FRANKLIN,7/22/2020,249,134,6,389
FRANKLIN,7/23/2020,251,138,6,395
FRANKLIN,7/24/2020,255,141,6,402
FRANKLIN,7/25/2020,260,145,6,411
FRANKLIN,7/26/2020,264,145,6,415
FRANKLIN,7/27/2020,266,146,6,418
FRANKLIN,7/28/2020,274,147,6,427
FRANKLIN,7/29/2020,275,148,6,429
FRANKLIN,7/30/2020,275,151,6,432
FRANKLIN,7/31/2020,275,153,6,434
FRANKLIN,8/1/2020,277,160,6,443
FRANKLIN,8/2/2020,279,161,6,446
FRANKLIN,8/3/2020,281,167,6,454
FRANKLIN,8/4/2020,283,174,6,463
FRANKLIN,8/5/2020,290,176,6,472
FRANKLIN,8/6/2020,295,181,6,482
FRANKLIN,8/7/2020,298,182,6,486
FRANKLIN,8/8/2020,302,182,6,490
FRANKLIN,8/9/2020,304,183,6,493
FRANKLIN,8/10/2020,309,184,6,499
FRANKLIN,8/11/2020,314,189,6,509
FRANKLIN,8/12/2020,316,191,6,513
FRANKLIN,8/13/2020,317,192,6,515
FRANKLIN,8/14/2020,320,193,6,519
FRANKLIN,8/15/2020,322,193,6,521
FRANKLIN,8/16/2020,327,195,6,528
FRANKLIN,8/17/2020,330,197,6,533
FRANKLIN,8/18/2020,334,199,6,539
FRANKLIN,8/19/2020,336,200,6,542
FRANKLIN,8/20/2020,343,200,6,549
FRANKLIN,8/21/2020,350,200,6,556
FRANKLIN,8/22/2020,354,200,6,560
FRANKLIN,8/23/2020,359,204,6,569
FRANKLIN,8/24/2020,361,207,6,574
FRANKLIN,8/25/2020,365,212,6,583
FRANKLIN,8/26/2020,366,215,6,587
FRANKLIN,8/27/2020,371,219,6,596
FRANKLIN,8/28/2020,375,222,6,603
FRANKLIN,8/29/2020,375,225,6,606
FRANKLIN,8/30/2020,379,226,6,611
FRANKLIN,8/31/2020,386,231,6,623
FRANKLIN,9/1/2020,391,238,6,635
FRANKLIN,9/2/2020,398,242,6,646
FRANKLIN,9/3/2020,402,245,6,653
FRANKLIN,9/4/2020,405,250,6,661
FRANKLIN,9/5/2020,406,252,6,664
FRANKLIN,9/6/2020,406,255,6,667
FRANKLIN,9/7/2020,409,256,6,671
FRANKLIN,9/8/2020,416,258,6,680
FRANKLIN,9/9/2020,421,263,6,690
FRANKLIN,9/10/2020,425,263,6,694
FRANKLIN,9/11/2020,427,265,7,699
FRANKLIN,9/12/2020,429,266,7,702
FRANKLIN,9/13/2020,431,267,7,705
FRANKLIN,9/14/2020,435,270,7,712
FRANKLIN,9/15/2020,437,272,7,716
FRANKLIN,9/16/2020,441,273,7,721
FRANKLIN,9/17/2020,443,277,7,727
FRANKLIN,9/18/2020,446,284,7,737
FRANKLIN,9/19/2020,447,285,7,739
FRANKLIN,9/20/2020,448,287,7,742
FRANKLIN,9/21/2020,449,288,7,744
FRANKLIN,9/22/2020,453,290,7,750
FRANKLIN,9/23/2020,455,291,7,753
FRANKLIN,9/24/2020,457,292,7,756
FRANKLIN,9/25/2020,458,293,7,758
FRANKLIN,9/26/2020,458,295,7,760
FRANKLIN,9/27/2020,458,295,7,760
FRANKLIN,9/28/2020,458,300,7,765
FRANKLIN,9/29/2020,463,300,7,770
FRANKLIN,9/30/2020,467,302,7,776
FRANKLIN,10/1/2020,468,304,7,779
FRANKLIN,10/2/2020,474,308,7,789
FRANKLIN,10/3/2020,480,312,7,799
FRANKLIN,10/4/2020,484,313,7,804
FRANKLIN,10/5/2020,488,316,7,811
FRANKLIN,10/6/2020,489,316,7,812
FRANKLIN,10/7/2020,489,317,7,813
FRANKLIN,10/8/2020,490,318,7,815
FRANKLIN,10/9/2020,496,321,8,825
FRANKLIN,10/10/2020,498,322,8,828
FRANKLIN,10/11/2020,498,323,8,829
FRANKLIN,10/12/2020,502,324,8,834
FRANKLIN,10/13/2020,503,325,8,836
FRANKLIN,10/14/2020,505,327,8,840
FRANKLIN,10/15/2020,507,331,8,846
FRANKLIN,10/16/2020,509,334,8,851
FRANKLIN,10/17/2020,510,335,8,853
FRANKLIN,10/18/2020,510,336,8,854
FRANKLIN,10/19/2020,510,336,8,854
FRANKLIN,10/20/2020,510,336,8,854
MADISON,1/1/2020,0,0,0,0
MADISON,1/2/2020,0,0,0,0
MADISON,1/3/2020,0,0,0,0
MADISON,1/4/2020,0,0,0,0
MADISON,1/5/2020,0,0,0,0
MADISON,1/6/2020,0,0,0,0
MADISON,1/7/2020,0,0,0,0
MADISON,1/8/2020,0,0,0,0
MADISON,1/9/2020,0,0,0,0
MADISON,1/10/2020,0,0,0,0
MADISON,1/11/2020,0,0,0,0
MADISON,1/12/2020,0,0,0,0
UPSON,10/20/2020,475,348,5,828
WARE,1/1/2020,0,0,0,0
WARE,1/2/2020,0,0,0,0
WARE,1/3/2020,0,0,0,0
WARE,1/4/2020,0,0,0,0
WARE,1/5/2020,0,0,0,0
WARE,1/6/2020,0,0,0,0
WARE,1/7/2020,0,0,0,0
WARE,1/8/2020,0,0,0,0
TWIGGS,7/2/2020,21,19,0,40
WARE,1/9/2020,0,0,0,0
WARE,1/10/2020,0,0,0,0
WARE,1/11/2020,0,0,0,0
WARE,1/12/2020,0,0,0,0
WARE,1/13/2020,0,0,0,0
WARE,1/14/2020,0,0,0,0
WARE,1/15/2020,0,0,0,0
WARE,1/16/2020,0,0,0,0
WARE,1/17/2020,0,0,0,0
WARE,1/18/2020,0,0,0,0
WARE,1/19/2020,0,0,0,0
WARE,1/20/2020,0,0,0,0
WARE,1/21/2020,0,0,0,0
WARE,1/22/2020,0,0,0,0
WARE,1/23/2020,0,0,0,0
WARE,1/24/2020,0,0,0,0
WARE,1/25/2020,0,0,0,0
WARE,1/26/2020,0,0,0,0
WARE,1/27/2020,0,0,0,0
WARE,1/28/2020,0,0,0,0
WARE,1/29/2020,0,0,0,0
WARE,1/30/2020,0,0,0,0
WARE,1/31/2020,1,0,0,1
WARE,2/1/2020,1,0,0,1
WARE,2/2/2020,1,0,0,1
WARE,2/3/2020,1,0,0,1
WARE,2/4/2020,1,0,0,1
WARE,2/5/2020,1,0,0,1
WARE,2/6/2020,2,0,0,2
WARE,2/7/2020,2,0,0,2
WARE,2/8/2020,2,0,0,2
WARE,2/9/2020,2,0,0,2
WARE,2/10/2020,2,0,0,2
WARE,2/11/2020,2,0,0,2
WARE,2/12/2020,2,0,0,2
WARE,2/13/2020,2,0,0,2
WARE,2/14/2020,2,0,0,2
WARE,2/15/2020,2,0,0,2
WARE,2/16/2020,2,0,0,2
WARE,2/17/2020,2,0,0,2
WARE,2/18/2020,2,0,0,2
WARE,2/19/2020,2,0,0,2
WARE,2/20/2020,2,0,0,2
WARE,2/21/2020,2,0,0,2
WARE,2/22/2020,2,0,0,2
WARE,2/23/2020,2,0,0,2
WARE,2/24/2020,2,0,0,2
WARE,2/25/2020,2,0,0,2
WARE,2/26/2020,2,0,0,2
WARE,2/27/2020,2,0,0,2
WARE,2/28/2020,2,0,0,2
WARE,2/29/2020,2,0,0,2
WARE,3/1/2020,2,0,0,2
WARE,3/2/2020,3,0,0,3
WARE,3/3/2020,3,0,0,3
WARE,3/4/2020,3,0,0,3
WARE,3/5/2020,4,0,0,4
WARE,3/6/2020,4,0,0,4
WARE,3/7/2020,4,0,0,4
WARE,3/8/2020,4,0,0,4
WARE,3/9/2020,4,0,0,4
WARE,3/10/2020,4,0,0,4
WARE,3/11/2020,4,0,0,4
WARE,3/12/2020,4,0,0,4
WARE,3/13/2020,5,0,0,5
WARE,3/14/2020,5,0,0,5
WARE,3/15/2020,5,0,0,5
WARE,3/16/2020,6,0,0,6
WARE,3/17/2020,6,0,0,6
WARE,3/18/2020,8,0,0,8
WARE,3/19/2020,9,3,0,12
WARE,3/20/2020,10,4,0,14
WARE,3/21/2020,10,4,0,14
WARE,3/22/2020,11,4,0,15
WARE,3/23/2020,15,5,0,20
WARE,3/24/2020,17,8,0,25
WARE,3/25/2020,18,9,0,27
WARE,3/26/2020,22,9,0,31
WARE,3/27/2020,24,9,0,33
WARE,3/28/2020,24,9,0,33
WARE,3/29/2020,25,9,0,34
WARE,3/30/2020,30,12,0,42
WARE,3/31/2020,31,13,0,44
WARE,4/1/2020,35,16,0,51
WARE,4/2/2020,38,19,0,57
WARE,4/3/2020,38,20,0,58
WARE,4/4/2020,40,21,0,61
WARE,4/5/2020,40,22,0,62
WARE,4/6/2020,46,25,0,71
WARE,4/7/2020,46,27,0,73
WARE,4/8/2020,47,29,0,76
WARE,4/9/2020,50,30,0,80
WARE,4/10/2020,52,32,0,84
WARE,4/11/2020,54,32,0,86
WARE,4/12/2020,58,33,0,91
WARE,4/13/2020,58,33,0,91
WARE,4/14/2020,62,35,0,97
WARE,4/15/2020,65,37,0,102
WARE,4/16/2020,67,39,0,106
WARE,4/17/2020,69,40,0,109
WARE,4/18/2020,71,41,0,112
WARE,4/19/2020,71,41,0,112
WARE,4/20/2020,73,44,0,117
WARE,4/21/2020,75,44,0,119
WARE,4/22/2020,76,46,0,122
WARE,4/23/2020,76,47,0,123
WARE,4/24/2020,79,51,0,130
WARE,4/25/2020,79,53,0,132
WARE,4/26/2020,81,55,0,136
WARE,4/27/2020,87,57,0,144
WARE,4/28/2020,90,58,0,148
WARE,4/29/2020,93,61,0,154
WARE,4/30/2020,94,63,0,157
WARE,5/1/2020,95,65,0,160
WARE,5/2/2020,95,65,0,160
WARE,5/3/2020,97,66,0,163
WARE,5/4/2020,98,66,0,164
WARE,5/5/2020,103,69,0,172
WARE,5/6/2020,103,69,0,172
WARE,5/7/2020,108,71,0,179
WARE,5/8/2020,108,72,0,180
WARE,5/9/2020,109,73,0,182
WARE,5/10/2020,110,74,0,184
WARE,5/11/2020,112,76,0,188
WARE,5/12/2020,115,77,0,192
WARE,5/13/2020,118,79,0,197
WARE,5/14/2020,120,82,0,202
WARE,5/15/2020,121,86,0,207
WARE,5/16/2020,121,88,0,209
WARE,5/17/2020,121,88,0,209
WARE,5/18/2020,123,94,0,217
WARE,5/19/2020,125,99,0,224
WARE,5/20/2020,127,101,0,228
WARE,5/21/2020,133,103,0,236
WARE,5/22/2020,133,103,0,236
WARE,5/23/2020,134,104,0,238
WARE,5/24/2020,134,105,0,239
WARE,5/25/2020,134,105,0,239
WARE,5/26/2020,135,106,0,241
WARE,5/27/2020,137,106,0,243
WARE,5/28/2020,139,108,0,247
WARE,5/29/2020,139,108,0,247
WARE,5/30/2020,140,109,0,249
WARE,5/31/2020,140,109,0,249
WARE,6/1/2020,140,111,0,251
WARE,6/2/2020,141,113,0,254
WARE,6/3/2020,144,113,0,257
WARE,6/4/2020,151,114,0,265
WARE,6/5/2020,153,115,0,268
WARE,6/6/2020,155,116,0,271
WARE,6/7/2020,159,117,0,276
WARE,6/8/2020,166,120,0,286
WARE,6/9/2020,174,123,1,298
WARE,6/10/2020,175,124,1,300
WARE,6/11/2020,184,131,1,316
WARE,6/12/2020,190,135,1,326
WARE,6/13/2020,198,136,1,335
WARE,6/14/2020,204,137,1,342
WARE,6/15/2020,215,143,1,359
WARE,6/16/2020,223,147,1,371
WARE,6/17/2020,234,154,2,390
WARE,6/18/2020,250,159,2,411
WARE,6/19/2020,257,163,2,422
WARE,6/20/2020,265,165,2,432
WARE,6/21/2020,270,168,2,440
WARE,6/22/2020,284,178,2,464
WARE,6/23/2020,296,201,2,499
WARE,6/24/2020,302,209,3,514
WARE,6/25/2020,314,217,3,534
WARE,6/26/2020,321,223,3,547
WARE,6/27/2020,325,226,3,554
WARE,6/28/2020,329,231,3,563
WARE,6/29/2020,346,250,3,599
WARE,6/30/2020,362,260,3,625
WARE,7/1/2020,376,274,3,653
WARE,7/2/2020,386,281,3,670
WARE,7/3/2020,390,289,3,682
WARE,7/4/2020,400,291,3,694
WARE,7/5/2020,409,293,3,705
WARE,7/6/2020,428,306,4,738
WARE,7/7/2020,445,322,4,771
WARE,7/8/2020,457,333,6,796
WARE,7/9/2020,474,348,6,828
WARE,7/10/2020,489,356,6,851
WARE,7/11/2020,494,360,7,861
WARE,7/12/2020,502,367,7,876
WARE,7/13/2020,525,385,7,917
WARE,7/14/2020,546,402,7,955
WARE,7/15/2020,567,416,7,990
WARE,7/16/2020,584,423,7,1014
WARE,7/17/2020,592,434,7,1033
WARE,7/18/2020,598,438,7,1043
WARE,7/19/2020,601,442,7,1050
WARE,7/20/2020,611,447,7,1065
WARE,7/21/2020,618,454,7,1079
WARE,7/22/2020,623,461,7,1091
WARE,7/23/2020,627,467,8,1102
WARE,7/24/2020,629,470,8,1107
WARE,7/25/2020,633,474,8,1115
WARE,7/26/2020,638,475,8,1121
WARE,7/27/2020,643,477,8,1128
WARE,7/28/2020,654,483,8,1145
WARE,7/29/2020,657,484,8,1149
WARE,7/30/2020,661,486,8,1155
WARE,7/31/2020,664,488,8,1160
WARE,8/1/2020,669,491,8,1168
WARE,8/2/2020,673,492,8,1173
WARE,8/3/2020,683,497,8,1188
WARE,8/4/2020,689,502,8,1199
WARE,8/5/2020,694,505,8,1207
WARE,8/6/2020,696,508,8,1212
WARE,8/7/2020,702,511,8,1221
WARE,8/8/2020,705,519,8,1232
WARE,8/9/2020,712,521,8,1241
WARE,8/10/2020,714,525,8,1247
WARE,8/11/2020,717,530,8,1255
WARE,8/12/2020,721,534,8,1263
WARE,8/13/2020,724,538,8,1270
WARE,8/14/2020,727,547,9,1283
WARE,8/15/2020,728,553,9,1290
WARE,8/16/2020,733,555,9,1297
WARE,8/17/2020,742,559,9,1310
WARE,8/18/2020,748,563,9,1320
WARE,8/19/2020,752,566,10,1328
WARE,8/20/2020,757,567,10,1334
WARE,8/21/2020,762,570,10,1342
WARE,8/22/2020,765,573,10,1348
WARE,8/23/2020,766,576,10,1352
WARE,8/24/2020,772,578,11,1361
WARE,8/25/2020,774,580,11,1365
WARE,8/26/2020,778,584,11,1373
WARE,8/27/2020,778,587,12,1377
WARE,8/28/2020,780,588,12,1380
WARE,8/29/2020,783,588,12,1383
WARE,8/30/2020,783,590,12,1385
WARE,8/31/2020,787,592,12,1391
WARE,9/1/2020,790,594,12,1396
WARE,9/2/2020,794,601,12,1407
WARE,9/3/2020,794,601,12,1407
WARE,9/4/2020,798,604,12,1414
WARE,9/5/2020,801,606,12,1419
WARE,9/6/2020,807,608,12,1427
WARE,9/7/2020,809,608,12,1429
WARE,9/8/2020,813,610,12,1435
WARE,9/9/2020,819,614,12,1445
WARE,9/10/2020,821,617,12,1450
WARE,9/11/2020,824,623,12,1459
WARE,9/12/2020,826,625,12,1463
WARE,9/13/2020,827,626,12,1465
WARE,9/14/2020,833,627,12,1472
WARE,9/15/2020,837,628,13,1478
WARE,9/16/2020,841,629,14,1484
WARE,9/17/2020,843,631,14,1488
WARE,9/18/2020,844,632,14,1490
WARE,9/19/2020,845,632,14,1491
WARE,9/20/2020,846,632,14,1492
WARE,9/21/2020,847,633,14,1494
WARE,9/22/2020,852,634,14,1500
WARE,9/23/2020,855,635,14,1504
WARE,9/24/2020,858,635,14,1507
WARE,9/25/2020,861,637,14,1512
WARE,9/26/2020,862,639,14,1515
WARE,9/27/2020,863,640,15,1518
WARE,9/28/2020,867,641,15,1523
WARE,9/29/2020,869,642,15,1526
WARE,9/30/2020,872,642,15,1529
WARE,10/1/2020,873,644,15,1532
WARE,10/2/2020,874,645,15,1534
WARE,10/3/2020,875,645,15,1535
WARE,10/4/2020,875,646,15,1536
WARE,10/5/2020,877,680,17,1574
WARE,10/6/2020,879,713,17,1609
WARE,10/7/2020,880,713,17,1610
WARE,10/8/2020,881,719,18,1618
WARE,10/9/2020,882,719,18,1619
WARE,10/10/2020,883,720,18,1621
WARE,10/11/2020,890,723,18,1631
WARE,10/12/2020,892,778,18,1688
WARE,10/13/2020,894,781,18,1693
WARE,10/14/2020,894,783,19,1696
WARE,10/15/2020,895,785,19,1699
WARE,10/16/2020,896,787,19,1702
WARE,10/17/2020,897,794,23,1714
WARE,10/18/2020,897,794,23,1714
WARE,10/19/2020,897,795,23,1715
WARE,10/20/2020,897,795,23,1715
WHITFIELD,1/1/2020,0,0,0,0
WHITFIELD,1/2/2020,0,0,0,0
WHITFIELD,1/3/2020,0,0,0,0
WHITFIELD,1/4/2020,0,0,0,0
WHITFIELD,1/5/2020,0,0,0,0
WHITFIELD,1/6/2020,0,0,0,0
WHITFIELD,1/7/2020,0,0,0,0
WHITFIELD,1/8/2020,0,0,0,0
WHITFIELD,1/9/2020,0,0,0,0
WHITFIELD,1/10/2020,0,0,0,0
WHITFIELD,1/11/2020,0,0,0,0
WHITFIELD,1/12/2020,0,0,0,0
WHITFIELD,1/13/2020,0,0,0,0
WHITFIELD,1/14/2020,0,0,0,0
WHITFIELD,1/15/2020,0,0,0,0
WHITFIELD,1/16/2020,0,0,0,0
WHITFIELD,1/17/2020,0,0,0,0
WHITFIELD,1/18/2020,0,0,0,0
WHITFIELD,1/19/2020,0,0,0,0
WHITFIELD,1/20/2020,0,0,0,0
WHITFIELD,1/21/2020,0,0,0,0
WHITFIELD,1/22/2020,0,0,0,0
WHITFIELD,1/23/2020,0,0,0,0
WHITFIELD,1/24/2020,0,0,0,0
WHITFIELD,1/25/2020,0,0,0,0
WHITFIELD,1/26/2020,0,0,0,0
WHITFIELD,1/27/2020,0,0,0,0
WHITFIELD,1/28/2020,0,0,0,0
WHITFIELD,1/29/2020,0,0,0,0
WHITFIELD,1/30/2020,0,0,0,0
WHITFIELD,1/31/2020,0,0,0,0
WHITFIELD,2/1/2020,0,0,0,0
WHITFIELD,2/2/2020,0,0,0,0
WHITFIELD,2/3/2020,0,0,0,0
WHITFIELD,2/4/2020,0,0,0,0
WHITFIELD,2/5/2020,0,0,0,0
WHITFIELD,2/6/2020,0,0,0,0
WHITFIELD,2/7/2020,0,0,0,0
WHITFIELD,2/8/2020,0,0,0,0
WHITFIELD,2/9/2020,0,0,0,0
WHITFIELD,2/10/2020,0,0,0,0
WHITFIELD,2/11/2020,0,0,0,0
WHITFIELD,2/12/2020,0,0,0,0
WHITFIELD,2/13/2020,0,0,0,0
WHITFIELD,2/14/2020,0,0,0,0
WHITFIELD,2/15/2020,0,0,0,0
WHITFIELD,2/16/2020,0,0,0,0
WHITFIELD,2/17/2020,0,0,0,0
WHITFIELD,2/18/2020,0,0,0,0
WHITFIELD,2/19/2020,0,0,0,0
WHITFIELD,2/20/2020,0,0,0,0
WHITFIELD,2/21/2020,0,0,0,0
WHITFIELD,2/22/2020,0,0,0,0
WHITFIELD,2/23/2020,0,0,0,0
WHITFIELD,2/24/2020,0,0,0,0
WHITFIELD,2/25/2020,0,0,0,0
WHITFIELD,2/26/2020,0,0,0,0
WHITFIELD,2/27/2020,0,0,0,0
WHITFIELD,2/28/2020,0,0,0,0
WHITFIELD,2/29/2020,0,0,0,0
WHITFIELD,3/1/2020,1,0,0,1
WHITFIELD,3/2/2020,1,0,0,1
WHITFIELD,3/3/2020,1,0,0,1
WHITFIELD,3/4/2020,1,0,0,1
WHITFIELD,3/5/2020,1,0,0,1
WHITFIELD,3/6/2020,1,0,0,1
WHITFIELD,3/7/2020,2,0,0,2
WHITFIELD,3/8/2020,2,0,0,2
WHITFIELD,3/9/2020,2,0,0,2
WHITFIELD,3/10/2020,2,1,0,3
WHITFIELD,3/11/2020,3,1,0,4
WHITFIELD,3/12/2020,3,1,0,4
WHITFIELD,3/13/2020,3,1,0,4
WHITFIELD,3/14/2020,5,2,0,7
WHITFIELD,3/15/2020,5,3,0,8
WHITFIELD,3/16/2020,6,5,0,11
WHITFIELD,3/17/2020,7,5,0,12
WHITFIELD,3/18/2020,7,6,0,13
WHITFIELD,3/19/2020,9,7,0,16
WHITFIELD,3/20/2020,9,7,0,16
WHITFIELD,3/21/2020,9,9,0,18
WHITFIELD,3/22/2020,9,9,0,18
WHITFIELD,3/23/2020,9,9,0,18
WHITFIELD,3/24/2020,10,9,0,19
WHITFIELD,3/25/2020,10,10,0,20
WHITFIELD,3/26/2020,11,12,0,23
WHITFIELD,3/27/2020,14,14,0,28
WHITFIELD,3/28/2020,15,15,0,30
WHITFIELD,3/29/2020,15,15,0,30
WHITFIELD,3/30/2020,16,16,0,32
WHITFIELD,3/31/2020,17,16,0,33
WHITFIELD,4/1/2020,17,19,0,36
WHITFIELD,4/2/2020,17,19,0,36
WHITFIELD,4/3/2020,19,20,0,39
TWIGGS,7/3/2020,21,19,0,40
TWIGGS,7/4/2020,21,19,0,40
TWIGGS,7/5/2020,25,19,0,44
TWIGGS,7/6/2020,26,19,0,45
TWIGGS,7/7/2020,27,19,0,46
TWIGGS,7/8/2020,29,21,0,50
TWIGGS,7/9/2020,31,24,0,55
TWIGGS,7/10/2020,31,25,0,56
TWIGGS,7/11/2020,32,25,0,57
TWIGGS,7/12/2020,32,26,0,58
TWIGGS,7/13/2020,32,28,0,60
TWIGGS,7/14/2020,34,30,0,64
TWIGGS,7/15/2020,37,31,0,68
TWIGGS,7/16/2020,39,33,0,72
TWIGGS,7/17/2020,41,35,0,76
TWIGGS,7/18/2020,42,36,0,78
TWIGGS,7/19/2020,42,37,0,79
TWIGGS,7/20/2020,43,38,0,81
TWIGGS,7/21/2020,48,41,0,89
TWIGGS,7/22/2020,48,44,0,92
TWIGGS,7/23/2020,51,46,0,97
TWIGGS,7/24/2020,57,48,0,105
TWIGGS,7/25/2020,59,48,0,107
TWIGGS,7/26/2020,60,50,0,110
TWIGGS,7/27/2020,63,50,0,113
TWIGGS,7/28/2020,66,52,0,118
TWIGGS,7/29/2020,69,52,0,121
TWIGGS,7/30/2020,70,53,0,123
TWIGGS,7/31/2020,71,53,0,124
TWIGGS,8/1/2020,72,53,0,125
TWIGGS,8/2/2020,74,53,1,128
TWIGGS,8/3/2020,74,59,1,134
TWIGGS,8/4/2020,75,59,1,135
TWIGGS,8/5/2020,77,59,1,137
TWIGGS,8/6/2020,77,60,1,138
TWIGGS,8/7/2020,79,63,1,143
TWIGGS,8/8/2020,80,63,1,144
TWIGGS,8/9/2020,81,63,1,145
TWIGGS,8/10/2020,81,64,1,146
TWIGGS,8/11/2020,82,65,1,148
TWIGGS,8/12/2020,82,66,1,149
TWIGGS,8/13/2020,84,67,1,152
TWIGGS,8/14/2020,84,68,1,153
TWIGGS,8/15/2020,85,69,1,155
TWIGGS,8/16/2020,86,69,1,156
TWIGGS,8/17/2020,88,70,1,159
TWIGGS,8/18/2020,89,70,1,160
TWIGGS,8/19/2020,90,70,1,161
TWIGGS,8/20/2020,90,70,1,161
TWIGGS,8/21/2020,90,70,1,161
TWIGGS,8/22/2020,91,70,1,162
TWIGGS,8/23/2020,91,70,1,162
TWIGGS,8/24/2020,92,70,1,163
TWIGGS,8/25/2020,92,70,1,163
TWIGGS,8/26/2020,92,70,1,163
TWIGGS,8/27/2020,92,70,1,163
TWIGGS,8/28/2020,92,70,1,163
TWIGGS,8/29/2020,92,70,1,163
TWIGGS,8/30/2020,93,70,1,164
TWIGGS,8/31/2020,94,71,1,166
TWIGGS,9/1/2020,96,72,1,169
TWIGGS,9/2/2020,96,72,1,169
TWIGGS,9/3/2020,96,74,1,171
TWIGGS,9/4/2020,96,74,1,171
TWIGGS,9/5/2020,96,74,1,171
TWIGGS,9/6/2020,96,74,1,171
TWIGGS,9/7/2020,96,75,1,172
TWIGGS,9/8/2020,98,75,1,174
TWIGGS,9/9/2020,99,75,1,175
TWIGGS,9/10/2020,99,76,1,176
TWIGGS,9/11/2020,100,78,1,179
TWIGGS,9/12/2020,100,78,1,179
TWIGGS,9/13/2020,100,79,1,180
TWIGGS,9/14/2020,103,79,1,183
TWIGGS,9/15/2020,105,79,1,185
TWIGGS,9/16/2020,106,79,1,186
TWIGGS,9/17/2020,107,81,1,189
TWIGGS,9/18/2020,108,81,1,190
TWIGGS,9/19/2020,108,81,1,190
TWIGGS,9/20/2020,108,82,1,191
TWIGGS,9/21/2020,108,83,1,192
TWIGGS,9/22/2020,108,83,1,192
TWIGGS,9/23/2020,108,83,1,192
TWIGGS,9/24/2020,108,84,1,193
TWIGGS,9/25/2020,109,84,1,194
TWIGGS,9/26/2020,110,85,1,196
TWIGGS,9/27/2020,111,88,1,200
TWIGGS,9/28/2020,111,89,1,201
TWIGGS,9/29/2020,111,89,1,201
TWIGGS,9/30/2020,111,89,1,201
TWIGGS,10/1/2020,111,89,1,201
TWIGGS,10/2/2020,111,89,1,201
TWIGGS,10/3/2020,112,89,1,202
TWIGGS,10/4/2020,113,90,1,204
TWIGGS,10/5/2020,113,90,1,204
TWIGGS,10/6/2020,114,90,1,205
TWIGGS,10/7/2020,114,92,1,207
TWIGGS,10/8/2020,114,92,1,207
TWIGGS,10/9/2020,114,92,1,207
TWIGGS,10/10/2020,114,92,1,207
TWIGGS,10/11/2020,114,92,1,207
TWIGGS,10/12/2020,114,93,1,208
TWIGGS,10/13/2020,115,93,1,209
TWIGGS,10/14/2020,116,93,1,210
TWIGGS,10/15/2020,116,93,1,210
TWIGGS,10/16/2020,117,93,1,211
TWIGGS,10/17/2020,117,93,1,211
TWIGGS,10/18/2020,117,93,1,211
TWIGGS,10/19/2020,117,93,1,211
TWIGGS,10/20/2020,117,93,1,211
UPSON,1/1/2020,0,0,0,0
UPSON,1/2/2020,0,0,0,0
UPSON,1/3/2020,0,0,0,0
UPSON,1/4/2020,0,0,0,0
UPSON,1/5/2020,0,0,0,0
UPSON,1/6/2020,0,0,0,0
UPSON,1/7/2020,0,0,0,0
UPSON,1/8/2020,0,0,0,0
UPSON,1/9/2020,0,0,0,0
UPSON,1/10/2020,0,0,0,0
UPSON,1/11/2020,0,0,0,0
UPSON,1/12/2020,0,0,0,0
UPSON,1/13/2020,0,0,0,0
UPSON,1/14/2020,0,0,0,0
UPSON,1/15/2020,0,0,0,0
UPSON,1/16/2020,0,0,0,0
UPSON,1/17/2020,0,0,0,0
UPSON,1/18/2020,0,0,0,0
UPSON,1/19/2020,0,0,0,0
UPSON,1/20/2020,0,0,0,0
UPSON,1/21/2020,0,0,0,0
UPSON,1/22/2020,0,0,0,0
UPSON,1/23/2020,0,0,0,0
UPSON,1/24/2020,0,0,0,0
UPSON,1/25/2020,0,0,0,0
UPSON,1/26/2020,0,0,0,0
UPSON,1/27/2020,0,0,0,0
UPSON,1/28/2020,0,0,0,0
UPSON,1/29/2020,0,0,0,0
UPSON,1/30/2020,0,0,0,0
UPSON,1/31/2020,0,0,0,0
UPSON,2/1/2020,0,0,0,0
UPSON,2/2/2020,0,0,0,0
UPSON,2/3/2020,0,0,0,0
UPSON,2/4/2020,0,0,0,0
UPSON,2/5/2020,0,0,0,0
UPSON,2/6/2020,0,0,0,0
UPSON,2/7/2020,0,0,0,0
UPSON,2/8/2020,0,0,0,0
UPSON,2/9/2020,0,0,0,0
UPSON,2/10/2020,0,0,0,0
UPSON,2/11/2020,0,0,0,0
UPSON,2/12/2020,0,0,0,0
UPSON,2/13/2020,0,0,0,0
UPSON,2/14/2020,0,0,0,0
UPSON,2/15/2020,0,0,0,0
UPSON,2/16/2020,0,0,0,0
UPSON,2/17/2020,0,0,0,0
UPSON,2/18/2020,0,0,0,0
UPSON,2/19/2020,0,0,0,0
UPSON,2/20/2020,0,0,0,0
UPSON,2/21/2020,0,0,0,0
UPSON,2/22/2020,0,0,0,0
UPSON,2/23/2020,0,0,0,0
UPSON,2/24/2020,0,0,0,0
UPSON,2/25/2020,0,0,0,0
UPSON,2/26/2020,0,0,0,0
UPSON,2/27/2020,0,0,0,0
UPSON,2/28/2020,0,0,0,0
UPSON,2/29/2020,0,0,0,0
UPSON,3/1/2020,0,0,0,0
UPSON,3/2/2020,0,0,0,0
UPSON,3/3/2020,0,0,0,0
UPSON,3/4/2020,0,0,0,0
UPSON,3/5/2020,0,0,0,0
UPSON,3/6/2020,0,0,0,0
UPSON,3/7/2020,0,1,0,1
UPSON,3/8/2020,0,1,0,1
UPSON,3/9/2020,1,2,0,3
UPSON,3/10/2020,1,2,0,3
UPSON,3/11/2020,1,2,0,3
UPSON,3/12/2020,1,3,0,4
UPSON,3/13/2020,1,3,0,4
UPSON,3/14/2020,1,3,0,4
UPSON,3/15/2020,1,3,0,4
UPSON,3/16/2020,1,4,0,5
UPSON,3/17/2020,1,4,0,5
UPSON,3/18/2020,2,5,0,7
UPSON,3/19/2020,2,5,0,7
UPSON,3/20/2020,2,5,0,7
UPSON,3/21/2020,2,8,0,10
UPSON,3/22/2020,2,8,0,10
UPSON,3/23/2020,3,10,0,13
UPSON,3/24/2020,3,11,0,14
UPSON,3/25/2020,3,12,0,15
UPSON,3/26/2020,5,12,0,17
UPSON,3/27/2020,6,12,0,18
UPSON,3/28/2020,9,12,0,21
UPSON,3/29/2020,9,12,0,21
UPSON,3/30/2020,11,14,0,25
UPSON,3/31/2020,11,15,0,26
UPSON,4/1/2020,17,17,0,34
UPSON,4/2/2020,19,20,0,39
UPSON,4/3/2020,19,21,0,40
UPSON,4/4/2020,22,22,0,44
UPSON,4/5/2020,23,23,0,46
UPSON,4/6/2020,27,26,0,53
UPSON,4/7/2020,32,28,0,60
UPSON,4/8/2020,38,29,0,67
UPSON,4/9/2020,40,32,0,72
UPSON,4/10/2020,76,66,0,142
UPSON,4/11/2020,81,67,0,148
UPSON,4/12/2020,83,68,0,151
UPSON,4/13/2020,86,69,0,155
UPSON,4/14/2020,94,69,0,163
UPSON,4/15/2020,99,71,0,170
UPSON,4/16/2020,101,73,0,174
UPSON,4/17/2020,104,76,0,180
UPSON,4/18/2020,105,78,0,183
UPSON,4/19/2020,107,80,0,187
UPSON,4/20/2020,110,81,0,191
UPSON,4/21/2020,111,84,0,195
UPSON,4/22/2020,118,84,0,202
UPSON,4/23/2020,119,84,0,203
UPSON,4/24/2020,123,91,0,214
UPSON,4/25/2020,124,93,0,217
UPSON,4/26/2020,126,93,0,219
UPSON,4/27/2020,128,95,0,223
UPSON,4/28/2020,131,97,0,228
UPSON,4/29/2020,136,103,0,239
UPSON,4/30/2020,137,105,0,242
UPSON,5/1/2020,138,107,0,245
UPSON,5/2/2020,138,108,0,246
UPSON,5/3/2020,138,110,0,248
UPSON,5/4/2020,139,111,0,250
UPSON,5/5/2020,140,111,0,251
UPSON,5/6/2020,141,111,0,252
UPSON,5/7/2020,142,112,0,254
UPSON,5/8/2020,143,112,0,255
UPSON,5/9/2020,143,113,0,256
UPSON,5/10/2020,145,115,0,260
UPSON,5/11/2020,146,117,0,263
UPSON,5/12/2020,147,119,0,266
UPSON,5/13/2020,148,119,1,268
UPSON,5/14/2020,150,120,1,271
UPSON,5/15/2020,150,122,1,273
UPSON,5/16/2020,152,123,1,276
UPSON,5/17/2020,152,123,1,276
UPSON,5/18/2020,152,123,1,276
UPSON,5/19/2020,154,124,1,279
UPSON,5/20/2020,155,124,1,280
UPSON,5/21/2020,156,124,1,281
UPSON,5/22/2020,157,125,1,283
UPSON,5/23/2020,157,125,1,283
UPSON,5/24/2020,157,125,1,283
UPSON,5/25/2020,157,125,1,283
UPSON,5/26/2020,160,125,1,286
UPSON,5/27/2020,160,125,1,286
UPSON,5/28/2020,166,125,1,292
UPSON,5/29/2020,167,126,1,294
UPSON,5/30/2020,168,127,1,296
UPSON,5/31/2020,168,127,1,296
UPSON,6/1/2020,170,127,1,298
UPSON,6/2/2020,171,127,1,299
UPSON,6/3/2020,171,127,1,299
UPSON,6/4/2020,172,127,1,300
UPSON,6/5/2020,172,129,1,302
UPSON,6/6/2020,173,130,1,304
UPSON,6/7/2020,173,130,1,304
UPSON,6/8/2020,173,131,1,305
UPSON,6/9/2020,174,132,1,307
UPSON,6/10/2020,174,132,1,307
UPSON,6/11/2020,175,134,1,310
UPSON,6/12/2020,178,139,1,318
UPSON,6/13/2020,179,141,1,321
UPSON,6/14/2020,180,141,1,322
UPSON,6/15/2020,185,144,1,330
UPSON,6/16/2020,191,147,1,339
UPSON,6/17/2020,195,147,1,343
UPSON,6/18/2020,196,149,1,346
UPSON,6/19/2020,197,151,1,349
UPSON,6/20/2020,200,152,1,353
UPSON,6/21/2020,202,153,1,356
UPSON,6/22/2020,207,154,1,362
UPSON,6/23/2020,211,155,1,367
UPSON,6/24/2020,211,155,1,367
UPSON,6/25/2020,215,159,1,375
UPSON,6/26/2020,217,162,2,381
UPSON,6/27/2020,219,163,2,384
UPSON,6/28/2020,219,164,2,385
UPSON,6/29/2020,221,164,2,387
UPSON,6/30/2020,221,166,2,389
UPSON,7/1/2020,226,171,2,399
UPSON,7/2/2020,226,174,2,402
UPSON,7/3/2020,226,175,2,403
UPSON,7/4/2020,226,176,2,404
UPSON,7/5/2020,227,177,2,406
UPSON,7/6/2020,227,179,2,408
UPSON,7/7/2020,228,180,2,410
UPSON,7/8/2020,230,180,2,412
UPSON,7/9/2020,233,181,2,416
UPSON,7/10/2020,234,181,2,417
UPSON,7/11/2020,234,183,2,419
UPSON,7/12/2020,237,183,2,422
UPSON,7/13/2020,239,184,3,426
UPSON,7/14/2020,240,188,3,431
UPSON,7/15/2020,241,188,3,432
UPSON,7/16/2020,245,189,3,437
UPSON,7/17/2020,249,196,3,448
UPSON,7/18/2020,251,200,3,454
UPSON,7/19/2020,253,200,3,456
UPSON,7/20/2020,257,201,3,461
UPSON,7/21/2020,258,202,3,463
UPSON,7/22/2020,261,204,3,468
UPSON,7/23/2020,266,208,3,477
UPSON,7/24/2020,273,209,3,485
UPSON,7/25/2020,277,214,3,494
UPSON,7/26/2020,279,215,3,497
UPSON,7/27/2020,285,217,3,505
UPSON,7/28/2020,287,219,3,509
UPSON,7/29/2020,287,223,3,513
UPSON,7/30/2020,292,224,3,519
UPSON,7/31/2020,294,229,3,526
UPSON,8/1/2020,300,232,3,535
UPSON,8/2/2020,301,232,3,536
UPSON,8/3/2020,305,234,4,543
UPSON,8/4/2020,307,236,4,547
UPSON,8/5/2020,314,239,4,557
UPSON,8/6/2020,316,241,4,561
UPSON,8/7/2020,320,241,4,565
UPSON,8/8/2020,323,244,4,571
UPSON,8/9/2020,333,246,4,583
UPSON,8/10/2020,338,247,4,589
UPSON,8/11/2020,340,248,4,592
UPSON,8/12/2020,343,252,4,599
UPSON,8/13/2020,345,253,4,602
UPSON,8/14/2020,346,253,4,603
UPSON,8/15/2020,348,257,4,609
UPSON,8/16/2020,348,262,4,614
UPSON,8/17/2020,353,263,4,620
UPSON,8/18/2020,357,263,4,624
UPSON,8/19/2020,361,265,4,630
UPSON,8/20/2020,365,267,4,636
UPSON,8/21/2020,367,268,4,639
UPSON,8/22/2020,370,271,4,645
UPSON,8/23/2020,372,274,4,650
UPSON,8/24/2020,374,275,4,653
UPSON,8/25/2020,375,276,4,655
UPSON,8/26/2020,377,278,4,659
UPSON,8/27/2020,381,283,4,668
UPSON,8/28/2020,386,284,4,674
UPSON,8/29/2020,387,286,4,677
UPSON,8/30/2020,387,286,4,677
UPSON,8/31/2020,388,287,4,679
UPSON,9/1/2020,392,289,4,685
UPSON,9/2/2020,392,290,4,686
UPSON,9/3/2020,393,295,4,692
UPSON,9/4/2020,397,296,4,697
UPSON,9/5/2020,399,297,4,700
UPSON,9/6/2020,400,299,4,703
UPSON,9/7/2020,401,303,4,708
UPSON,9/8/2020,403,303,4,710
UPSON,9/9/2020,407,304,4,715
UPSON,9/10/2020,413,313,5,731
UPSON,9/11/2020,416,313,5,734
UPSON,9/12/2020,418,314,5,737
UPSON,9/13/2020,422,315,5,742
UPSON,9/14/2020,429,317,5,751
UPSON,9/15/2020,435,320,5,760
UPSON,9/16/2020,441,321,5,767
UPSON,9/17/2020,443,325,5,773
UPSON,9/18/2020,444,328,5,777
UPSON,9/19/2020,444,330,5,779
UPSON,9/20/2020,445,331,5,781
UPSON,9/21/2020,447,334,5,786
UPSON,9/22/2020,451,335,5,791
UPSON,9/23/2020,452,336,5,793
UPSON,9/24/2020,453,336,5,794
UPSON,9/25/2020,456,339,5,800
UPSON,9/26/2020,458,339,5,802
UPSON,9/27/2020,460,339,5,804
UPSON,9/28/2020,461,339,5,805
UPSON,9/29/2020,464,339,5,808
UPSON,9/30/2020,465,340,5,810
UPSON,10/1/2020,465,341,5,811
UPSON,10/2/2020,465,343,5,813
UPSON,10/3/2020,465,343,5,813
UPSON,10/4/2020,465,344,5,814
UPSON,10/5/2020,465,344,5,814
UPSON,10/6/2020,465,345,5,815
UPSON,10/7/2020,465,345,5,815
UPSON,10/8/2020,466,345,5,816
CRAWFORD,5/22/2020,12,17,0,29
CRAWFORD,5/23/2020,12,17,0,29
CRAWFORD,5/24/2020,12,17,0,29
CRAWFORD,5/25/2020,13,17,0,30
CRAWFORD,5/26/2020,13,17,0,30
CRAWFORD,5/27/2020,14,17,0,31
CRAWFORD,5/28/2020,14,17,0,31
CRAWFORD,5/29/2020,14,17,0,31
CRAWFORD,5/30/2020,14,17,0,31
CRAWFORD,5/31/2020,14,17,0,31
CRAWFORD,6/1/2020,14,18,0,32
CRAWFORD,6/2/2020,14,18,0,32
CRAWFORD,6/3/2020,14,18,0,32
CRAWFORD,6/4/2020,14,18,0,32
CRAWFORD,6/5/2020,14,19,0,33
CRAWFORD,6/6/2020,14,19,0,33
CRAWFORD,6/7/2020,14,19,0,33
CRAWFORD,6/8/2020,14,19,0,33
CRAWFORD,6/9/2020,14,20,0,34
CRAWFORD,6/10/2020,14,20,0,34
CRAWFORD,6/11/2020,14,20,0,34
CRAWFORD,6/12/2020,14,20,0,34
CRAWFORD,6/13/2020,14,20,0,34
CRAWFORD,6/14/2020,15,21,0,36
CRAWFORD,6/15/2020,15,21,0,36
CRAWFORD,6/16/2020,16,21,0,37
CRAWFORD,6/17/2020,17,21,0,38
CRAWFORD,6/18/2020,19,21,0,40
CRAWFORD,6/19/2020,19,21,0,40
CRAWFORD,6/20/2020,19,21,0,40
CRAWFORD,6/21/2020,20,21,3,44
CRAWFORD,6/22/2020,20,21,3,44
CRAWFORD,6/23/2020,20,22,3,45
CRAWFORD,6/24/2020,21,22,3,46
CRAWFORD,6/25/2020,23,24,4,51
CRAWFORD,6/26/2020,24,24,4,52
CRAWFORD,6/27/2020,27,24,4,55
CRAWFORD,6/28/2020,28,25,4,57
CRAWFORD,6/29/2020,30,26,4,60
CRAWFORD,6/30/2020,30,27,4,61
CRAWFORD,7/1/2020,31,29,4,64
CRAWFORD,7/2/2020,31,30,4,65
CRAWFORD,7/3/2020,31,31,4,66
CRAWFORD,7/4/2020,31,31,4,66
CRAWFORD,7/5/2020,31,31,4,66
CRAWFORD,7/6/2020,32,32,4,68
CRAWFORD,7/7/2020,34,32,4,70
CRAWFORD,7/8/2020,35,32,4,71
CRAWFORD,7/9/2020,36,32,4,72
CRAWFORD,7/10/2020,37,32,4,73
CRAWFORD,7/11/2020,37,32,4,73
CRAWFORD,7/12/2020,39,32,4,75
CRAWFORD,7/13/2020,40,32,4,76
CRAWFORD,7/14/2020,40,33,4,77
CRAWFORD,7/15/2020,41,34,4,79
CRAWFORD,7/16/2020,41,35,4,80
CRAWFORD,7/17/2020,42,36,4,82
CRAWFORD,7/18/2020,43,36,4,83
CRAWFORD,7/19/2020,43,37,4,84
CRAWFORD,7/20/2020,44,38,4,86
CRAWFORD,7/21/2020,44,39,4,87
CRAWFORD,7/22/2020,49,40,4,93
CRAWFORD,7/23/2020,50,41,4,95
CRAWFORD,7/24/2020,52,42,4,98
CRAWFORD,7/25/2020,52,43,4,99
CRAWFORD,7/26/2020,53,43,4,100
CRAWFORD,7/27/2020,56,43,4,103
CRAWFORD,7/28/2020,59,43,4,106
CRAWFORD,7/29/2020,60,43,4,107
CRAWFORD,7/30/2020,60,44,4,108
CRAWFORD,7/31/2020,60,45,4,109
CRAWFORD,8/1/2020,61,45,4,110
CRAWFORD,8/2/2020,61,45,4,110
CRAWFORD,8/3/2020,62,46,4,112
CRAWFORD,8/4/2020,63,46,4,113
CRAWFORD,8/5/2020,64,46,5,115
CRAWFORD,8/6/2020,64,46,5,115
CRAWFORD,8/7/2020,64,49,5,118
CRAWFORD,8/8/2020,64,49,5,118
CRAWFORD,8/9/2020,65,49,5,119
CRAWFORD,8/10/2020,65,49,5,119
CRAWFORD,8/11/2020,67,51,6,124
CRAWFORD,8/12/2020,69,53,6,128
CRAWFORD,8/13/2020,71,54,6,131
CRAWFORD,8/14/2020,71,55,6,132
CRAWFORD,8/15/2020,72,56,7,135
CRAWFORD,8/16/2020,74,56,7,137
CRAWFORD,8/17/2020,74,57,7,138
CRAWFORD,8/18/2020,76,58,7,141
CRAWFORD,8/19/2020,77,59,7,143
CRAWFORD,8/20/2020,78,60,7,145
CRAWFORD,8/21/2020,79,60,7,146
CRAWFORD,8/22/2020,79,60,7,146
CRAWFORD,8/23/2020,80,61,7,148
CRAWFORD,8/24/2020,83,61,7,151
CRAWFORD,8/25/2020,83,61,7,151
CRAWFORD,8/26/2020,84,61,7,152
CRAWFORD,8/27/2020,84,61,7,152
CRAWFORD,8/28/2020,85,61,7,153
CRAWFORD,8/29/2020,86,62,7,155
CRAWFORD,8/30/2020,87,62,7,156
CRAWFORD,8/31/2020,87,62,7,156
CRAWFORD,9/1/2020,89,62,7,158
CRAWFORD,9/2/2020,90,62,7,159
CRAWFORD,9/3/2020,91,62,8,161
CRAWFORD,9/4/2020,93,62,8,163
CRAWFORD,9/5/2020,93,62,8,163
CRAWFORD,9/6/2020,93,62,8,163
CRAWFORD,9/7/2020,94,63,8,165
CRAWFORD,9/8/2020,94,63,8,165
CRAWFORD,9/9/2020,95,64,8,167
CRAWFORD,9/10/2020,95,64,8,167
CRAWFORD,9/11/2020,95,64,8,167
CRAWFORD,9/12/2020,95,64,8,167
CRAWFORD,9/13/2020,95,64,8,167
CRAWFORD,9/14/2020,97,64,8,169
CRAWFORD,9/15/2020,97,64,8,169
CRAWFORD,9/16/2020,97,64,8,169
CRAWFORD,9/17/2020,97,64,8,169
CRAWFORD,9/18/2020,97,64,8,169
CRAWFORD,9/19/2020,97,65,8,170
CRAWFORD,9/20/2020,97,65,8,170
CRAWFORD,9/21/2020,97,65,8,170
CRAWFORD,9/22/2020,97,65,8,170
CRAWFORD,9/23/2020,98,65,8,171
CRAWFORD,9/24/2020,98,65,8,171
CRAWFORD,9/25/2020,98,65,8,171
CRAWFORD,9/26/2020,98,67,8,173
CRAWFORD,9/27/2020,98,67,8,173
CRAWFORD,9/28/2020,98,68,8,174
CRAWFORD,9/29/2020,98,68,8,174
CRAWFORD,9/30/2020,98,69,8,175
CRAWFORD,10/1/2020,98,69,8,175
CRAWFORD,10/2/2020,99,71,8,178
CRAWFORD,10/3/2020,100,71,9,180
CRAWFORD,10/4/2020,100,72,9,181
CRAWFORD,10/5/2020,101,72,9,182
CRAWFORD,10/6/2020,101,73,9,183
CRAWFORD,10/7/2020,101,73,9,183
CRAWFORD,10/8/2020,101,73,9,183
CRAWFORD,10/9/2020,102,76,9,187
CRAWFORD,10/10/2020,102,76,9,187
CRAWFORD,10/11/2020,102,76,9,187
CRAWFORD,10/12/2020,103,76,9,188
CRAWFORD,10/13/2020,103,76,9,188
CRAWFORD,10/14/2020,103,76,9,188
CRAWFORD,10/15/2020,103,77,9,189
CRAWFORD,10/16/2020,103,77,9,189
CRAWFORD,10/17/2020,103,77,9,189
CRAWFORD,10/18/2020,103,77,9,189
CRAWFORD,10/19/2020,103,77,9,189
CRAWFORD,10/20/2020,103,77,9,189
HART,1/1/2020,0,0,0,0
HART,1/2/2020,0,0,0,0
HART,1/3/2020,0,0,0,0
HART,1/4/2020,0,0,0,0
HART,1/5/2020,0,0,0,0
HART,1/6/2020,0,0,0,0
HART,1/7/2020,0,0,0,0
HART,1/8/2020,0,0,0,0
HART,1/9/2020,0,0,0,0
HART,1/10/2020,0,0,0,0
HART,1/11/2020,0,0,0,0
HART,1/12/2020,0,0,0,0
HART,1/13/2020,0,0,0,0
HART,1/14/2020,0,0,0,0
HART,1/15/2020,0,0,0,0
HART,1/16/2020,0,0,0,0
HART,1/17/2020,0,0,0,0
HART,1/18/2020,0,0,0,0
HART,1/19/2020,0,0,0,0
HART,1/20/2020,0,0,0,0
HART,1/21/2020,0,0,0,0
HART,1/22/2020,0,0,0,0
HART,1/23/2020,0,0,0,0
HART,1/24/2020,0,0,0,0
HART,1/25/2020,0,0,0,0
HART,1/26/2020,0,0,0,0
HART,1/27/2020,0,0,0,0
HART,1/28/2020,0,0,0,0
HART,1/29/2020,0,0,0,0
HART,1/30/2020,0,0,0,0
HART,1/31/2020,0,0,0,0
HART,2/1/2020,0,0,0,0
HART,2/2/2020,0,0,0,0
HART,2/3/2020,0,0,0,0
HART,2/4/2020,0,0,0,0
HART,2/5/2020,0,0,0,0
HART,2/6/2020,0,0,0,0
HART,2/7/2020,0,0,0,0
HART,2/8/2020,0,0,0,0
HART,2/9/2020,0,0,0,0
HART,2/10/2020,0,0,0,0
HART,2/11/2020,0,0,0,0
HART,2/12/2020,0,0,0,0
HART,2/13/2020,0,0,0,0
HART,2/14/2020,0,0,0,0
HART,2/15/2020,0,0,0,0
HART,2/16/2020,0,0,0,0
HART,2/17/2020,0,0,0,0
HART,2/18/2020,0,0,0,0
HART,2/19/2020,0,0,0,0
HART,2/20/2020,0,0,0,0
HART,2/21/2020,0,0,0,0
HART,2/22/2020,0,0,0,0
HART,2/23/2020,0,0,0,0
HART,2/24/2020,0,0,0,0
HART,2/25/2020,0,0,0,0
HART,2/26/2020,0,0,0,0
HART,2/27/2020,0,0,0,0
HART,2/28/2020,0,0,0,0
HART,2/29/2020,0,0,0,0
HART,3/1/2020,0,0,0,0
HART,3/2/2020,0,0,0,0
HART,3/3/2020,0,0,0,0
HART,3/4/2020,0,0,0,0
HART,3/5/2020,0,0,0,0
HART,3/6/2020,0,0,0,0
HART,3/7/2020,0,0,0,0
HART,3/8/2020,0,0,0,0
HART,3/9/2020,0,0,0,0
HART,3/10/2020,0,0,0,0
HART,3/11/2020,0,0,0,0
HART,3/12/2020,0,0,0,0
HART,3/13/2020,0,0,0,0
HART,3/14/2020,0,0,0,0
HART,3/15/2020,0,0,0,0
HART,3/16/2020,0,0,0,0
HART,3/17/2020,0,0,0,0
HART,3/18/2020,1,0,0,1
HART,3/19/2020,1,0,0,1
HART,3/20/2020,1,2,0,3
HART,3/21/2020,1,2,0,3
HART,3/22/2020,1,2,0,3
HART,3/23/2020,1,2,0,3
HART,3/24/2020,1,2,0,3
HART,3/25/2020,1,2,0,3
HART,3/26/2020,1,3,0,4
HART,3/27/2020,1,3,0,4
HART,3/28/2020,1,3,0,4
HART,3/29/2020,1,3,0,4
HART,3/30/2020,1,3,0,4
HART,3/31/2020,1,3,0,4
HART,4/1/2020,1,3,0,4
HART,4/2/2020,1,3,0,4
HART,4/3/2020,1,3,0,4
HART,4/4/2020,1,3,0,4
HART,4/5/2020,1,3,0,4
HART,4/6/2020,1,3,0,4
HART,4/7/2020,1,4,0,5
HART,4/8/2020,1,4,0,5
HART,4/9/2020,2,4,0,6
HART,4/10/2020,2,4,0,6
HART,4/11/2020,2,4,0,6
HART,4/12/2020,2,4,0,6
HART,4/13/2020,2,4,0,6
HART,4/14/2020,2,4,0,6
HART,4/15/2020,2,5,0,7
HART,4/16/2020,2,5,0,7
HART,4/17/2020,3,5,0,8
HART,4/18/2020,3,5,0,8
HART,4/19/2020,3,5,0,8
HART,4/20/2020,4,5,0,9
HART,4/21/2020,4,5,0,9
HART,4/22/2020,4,6,0,10
HART,4/23/2020,4,6,0,10
HART,4/24/2020,4,6,0,10
HART,4/25/2020,4,6,0,10
HART,4/26/2020,4,6,0,10
HART,4/27/2020,5,6,0,11
HART,4/28/2020,5,6,0,11
HART,4/29/2020,8,6,0,14
HART,4/30/2020,8,6,0,14
HART,5/1/2020,8,6,1,15
HART,5/2/2020,8,6,1,15
HART,5/3/2020,8,7,1,16
HART,5/4/2020,8,8,1,17
HART,5/5/2020,10,8,1,19
HART,5/6/2020,10,8,1,19
HART,5/7/2020,12,8,1,21
HART,5/8/2020,13,8,1,22
HART,5/9/2020,13,8,1,22
HART,5/10/2020,13,8,1,22
HART,5/11/2020,13,8,1,22
HART,5/12/2020,14,9,1,24
HART,5/13/2020,15,9,1,25
HART,5/14/2020,15,9,1,25
HART,5/15/2020,15,10,1,26
HART,5/16/2020,15,10,1,26
HART,5/17/2020,16,11,1,28
HART,5/18/2020,16,12,1,29
HART,5/19/2020,16,15,1,32
HART,5/20/2020,16,16,1,33
HART,5/21/2020,16,16,1,33
HART,5/22/2020,17,17,1,35
HART,5/23/2020,17,17,1,35
HART,5/24/2020,18,18,1,37
HART,5/25/2020,18,18,1,37
HART,5/26/2020,19,18,1,38
HART,5/27/2020,19,18,1,38
HART,5/28/2020,19,18,1,38
HART,5/29/2020,20,18,1,39
HART,5/30/2020,20,18,1,39
HART,5/31/2020,21,19,1,41
HART,6/1/2020,21,19,1,41
HART,6/2/2020,26,20,1,47
HART,6/3/2020,26,20,1,47
HART,6/4/2020,26,20,1,47
HART,6/5/2020,26,20,1,47
HART,6/6/2020,27,20,1,48
HART,6/7/2020,28,20,1,49
HART,6/8/2020,28,20,1,49
HART,6/9/2020,30,20,1,51
HART,6/10/2020,31,20,1,52
HART,6/11/2020,31,20,1,52
HART,6/12/2020,33,21,1,55
HART,6/13/2020,35,21,1,57
HART,6/14/2020,35,21,1,57
HART,6/15/2020,35,21,1,57
HART,6/16/2020,35,25,1,61
HART,6/17/2020,35,26,1,62
HART,6/18/2020,36,27,1,64
HART,6/19/2020,38,28,1,67
HART,6/20/2020,40,28,1,69
HART,6/21/2020,40,28,1,69
HART,6/22/2020,43,28,1,72
HART,6/23/2020,45,30,1,76
HART,6/24/2020,50,32,1,83
HART,6/25/2020,51,33,1,85
HART,6/26/2020,57,34,1,92
HART,6/27/2020,58,37,1,96
HART,6/28/2020,61,37,1,99
HART,6/29/2020,66,38,1,105
HART,6/30/2020,75,40,1,116
HART,7/1/2020,76,44,1,121
HART,7/2/2020,77,48,1,126
HART,7/3/2020,80,48,1,129
HART,7/4/2020,80,49,1,130
HART,7/5/2020,82,52,1,135
HART,7/6/2020,86,53,1,140
HART,7/7/2020,94,60,1,155
HART,7/8/2020,98,62,2,162
HART,7/9/2020,101,64,2,167
HART,7/10/2020,106,64,2,172
HART,7/11/2020,110,64,2,176
HART,7/12/2020,115,65,2,182
HART,7/13/2020,123,70,2,195
HART,7/14/2020,128,74,2,204
HART,7/15/2020,134,77,2,213
HART,7/16/2020,136,79,2,217
HART,7/17/2020,141,89,3,233
HART,7/18/2020,145,91,4,240
HART,7/19/2020,148,95,4,247
HART,7/20/2020,151,99,4,254
HART,7/21/2020,156,102,5,263
HART,7/22/2020,160,106,5,271
HART,7/23/2020,165,111,5,281
HART,7/24/2020,169,113,5,287
HART,7/25/2020,171,116,5,292
HART,7/26/2020,178,117,5,300
HART,7/27/2020,185,119,5,309
HART,7/28/2020,188,122,5,315
HART,7/29/2020,192,125,6,323
HART,7/30/2020,193,130,6,329
HART,7/31/2020,196,133,6,335
HART,8/1/2020,198,134,6,338
HART,8/2/2020,199,137,6,342
HART,8/3/2020,206,142,6,354
HART,8/4/2020,213,142,6,361
HART,8/5/2020,216,145,6,367
HART,8/6/2020,217,147,6,370
HART,8/7/2020,218,149,6,373
HART,8/8/2020,221,149,6,376
HART,8/9/2020,222,149,6,377
HART,8/10/2020,224,150,6,380
HART,8/11/2020,226,151,6,383
HART,8/12/2020,227,152,6,385
HART,8/13/2020,232,152,6,390
HART,8/14/2020,234,155,6,395
HART,8/15/2020,235,157,6,398
HART,8/16/2020,237,158,6,401
HART,8/17/2020,240,161,6,407
HART,8/18/2020,241,163,6,410
HART,8/19/2020,242,165,6,413
HART,8/20/2020,245,165,7,417
HART,8/21/2020,249,166,7,422
HART,8/22/2020,252,166,7,425
HART,8/23/2020,252,170,7,429
HART,8/24/2020,255,170,7,432
HART,8/25/2020,259,171,7,437
HART,8/26/2020,260,173,7,440
HART,8/27/2020,263,176,7,446
HART,8/28/2020,264,181,7,452
HART,8/29/2020,266,181,7,454
HART,8/30/2020,267,182,7,456
HART,8/31/2020,270,183,7,460
HART,9/1/2020,274,187,7,468
HART,9/2/2020,276,192,7,475
HART,9/3/2020,278,193,7,478
HART,9/4/2020,279,195,7,481
EFFINGHAM,8/12/2020,427,442,6,875
COOK,4/28/2020,13,9,0,22
GREENE,2/6/2020,0,0,0,0
EFFINGHAM,8/13/2020,434,449,6,889
COOK,4/29/2020,17,10,0,27
GREENE,2/7/2020,0,0,0,0
GREENE,2/8/2020,0,0,0,0
GREENE,2/9/2020,0,0,0,0
GREENE,2/10/2020,0,0,0,0
GREENE,2/11/2020,0,0,0,0
GREENE,2/12/2020,0,0,0,0
GREENE,2/13/2020,0,0,0,0
GREENE,2/14/2020,0,0,0,0
GREENE,2/15/2020,0,0,0,0
GREENE,2/16/2020,0,0,0,0
GREENE,2/17/2020,0,0,0,0
GREENE,2/18/2020,0,0,0,0
GREENE,2/19/2020,0,0,0,0
GREENE,2/20/2020,0,0,0,0
GREENE,2/21/2020,0,0,0,0
GREENE,2/22/2020,0,0,0,0
GREENE,2/23/2020,0,0,0,0
GREENE,2/24/2020,0,0,0,0
GREENE,2/25/2020,0,0,0,0
GREENE,2/26/2020,0,0,0,0
GREENE,2/27/2020,0,0,0,0
GREENE,2/28/2020,0,0,0,0
GREENE,2/29/2020,0,0,0,0
GREENE,3/1/2020,0,0,0,0
GREENE,3/2/2020,0,0,0,0
GREENE,3/3/2020,0,0,0,0
GREENE,3/4/2020,0,0,0,0
GREENE,3/5/2020,0,0,0,0
GREENE,3/6/2020,0,0,0,0
GREENE,3/7/2020,0,0,0,0
GREENE,3/8/2020,0,0,0,0
GREENE,3/9/2020,0,0,0,0
GREENE,3/10/2020,0,0,0,0
GREENE,3/11/2020,0,0,0,0
GREENE,3/12/2020,0,0,0,0
GREENE,3/13/2020,0,0,0,0
GREENE,3/14/2020,0,1,0,1
GREENE,3/15/2020,1,1,0,2
GREENE,3/16/2020,1,1,0,2
GREENE,3/17/2020,1,2,0,3
GREENE,3/18/2020,2,3,0,5
GREENE,3/19/2020,2,3,0,5
GREENE,3/20/2020,3,4,0,7
GREENE,3/21/2020,3,5,0,8
GREENE,3/22/2020,4,5,0,9
GREENE,3/23/2020,5,6,0,11
GREENE,3/24/2020,5,6,0,11
GREENE,3/25/2020,5,7,0,12
GREENE,3/26/2020,5,9,0,14
GREENE,3/27/2020,5,9,0,14
GREENE,3/28/2020,5,9,0,14
GREENE,3/29/2020,5,10,0,15
GREENE,3/30/2020,6,11,0,17
GREENE,3/31/2020,7,12,0,19
GREENE,4/1/2020,8,12,0,20
GREENE,4/2/2020,8,12,0,20
GREENE,4/3/2020,10,13,0,23
GREENE,4/4/2020,11,13,0,24
GREENE,4/5/2020,12,13,0,25
GREENE,4/6/2020,14,14,0,28
GREENE,4/7/2020,15,14,0,29
GREENE,4/8/2020,18,14,0,32
GREENE,4/9/2020,18,15,0,33
GREENE,4/10/2020,19,16,0,35
GREENE,4/11/2020,19,16,0,35
GREENE,4/12/2020,19,16,0,35
GREENE,4/13/2020,20,18,0,38
GREENE,4/14/2020,20,20,0,40
GREENE,4/15/2020,20,20,0,40
GREENE,4/16/2020,21,20,0,41
GREENE,4/17/2020,22,21,0,43
GREENE,4/18/2020,22,22,0,44
GREENE,4/19/2020,22,22,0,44
GREENE,4/20/2020,22,22,0,44
GREENE,4/21/2020,24,22,0,46
GREENE,4/22/2020,26,24,0,50
GREENE,4/23/2020,26,24,0,50
GREENE,4/24/2020,26,25,0,51
GREENE,4/25/2020,28,25,0,53
GREENE,4/26/2020,28,25,0,53
GREENE,4/27/2020,28,25,0,53
GREENE,4/28/2020,28,27,0,55
GREENE,4/29/2020,28,28,0,56
GREENE,4/30/2020,29,28,0,57
GREENE,5/1/2020,29,28,0,57
GREENE,5/2/2020,29,28,0,57
GREENE,5/3/2020,30,28,0,58
GREENE,5/4/2020,30,28,0,58
GREENE,5/5/2020,31,28,0,59
GREENE,5/6/2020,31,28,0,59
GREENE,5/7/2020,31,28,0,59
GREENE,5/8/2020,31,28,0,59
GREENE,5/9/2020,31,29,0,60
GREENE,5/10/2020,31,29,0,60
GREENE,5/11/2020,33,29,0,62
GREENE,5/12/2020,33,29,0,62
GREENE,5/13/2020,33,29,0,62
GREENE,5/14/2020,33,30,0,63
GREENE,5/15/2020,33,30,0,63
GREENE,5/16/2020,33,30,0,63
GREENE,5/17/2020,33,30,0,63
GREENE,5/18/2020,33,30,0,63
GREENE,5/19/2020,33,30,0,63
GREENE,5/20/2020,33,31,0,64
GREENE,5/21/2020,33,31,0,64
GREENE,5/22/2020,34,32,0,66
GREENE,5/23/2020,34,32,0,66
GREENE,5/24/2020,34,32,0,66
GREENE,5/25/2020,35,32,0,67
GREENE,5/26/2020,36,32,0,68
GREENE,5/27/2020,36,32,0,68
GREENE,5/28/2020,36,33,0,69
GREENE,5/29/2020,39,33,0,72
GREENE,5/30/2020,40,33,0,73
GREENE,5/31/2020,40,33,0,73
GREENE,6/1/2020,41,35,0,76
GREENE,6/2/2020,43,39,0,82
GREENE,6/3/2020,43,40,0,83
GREENE,6/4/2020,45,41,0,86
GREENE,6/5/2020,45,42,0,87
GREENE,6/6/2020,45,42,0,87
GREENE,6/7/2020,45,42,0,87
GREENE,6/8/2020,45,42,0,87
GREENE,6/9/2020,45,42,0,87
GREENE,6/10/2020,45,42,0,87
GREENE,6/11/2020,45,42,0,87
GREENE,6/12/2020,45,42,0,87
GREENE,6/13/2020,45,42,0,87
GREENE,6/14/2020,46,43,0,89
GREENE,6/15/2020,46,43,0,89
GREENE,6/16/2020,46,43,0,89
GREENE,6/17/2020,46,43,0,89
GREENE,6/18/2020,47,43,0,90
GREENE,6/19/2020,47,43,0,90
GREENE,6/20/2020,48,45,0,93
GREENE,6/21/2020,48,45,0,93
GREENE,6/22/2020,49,45,0,94
GREENE,6/23/2020,50,46,0,96
GREENE,6/24/2020,50,48,0,98
GREENE,6/25/2020,50,49,0,99
GREENE,6/26/2020,50,51,0,101
GREENE,6/27/2020,52,52,0,104
GREENE,6/28/2020,53,53,0,106
GREENE,6/29/2020,53,54,0,107
GREENE,6/30/2020,53,55,0,108
GREENE,7/1/2020,54,56,0,110
GREENE,7/2/2020,55,60,0,115
GREENE,7/3/2020,58,61,0,119
GREENE,7/4/2020,58,65,0,123
GREENE,7/5/2020,61,66,0,127
GREENE,7/6/2020,69,69,0,138
GREENE,7/7/2020,77,76,0,153
GREENE,7/8/2020,85,80,0,165
GREENE,7/9/2020,91,86,0,177
GREENE,7/10/2020,94,89,0,183
GREENE,7/11/2020,96,90,0,186
GREENE,7/12/2020,97,93,0,190
GREENE,7/13/2020,106,100,0,206
GREENE,7/14/2020,109,105,0,214
GREENE,7/15/2020,112,110,0,222
GREENE,7/16/2020,113,113,0,226
GREENE,7/17/2020,117,115,0,232
GREENE,7/18/2020,120,118,0,238
GREENE,7/19/2020,120,119,0,239
GREENE,7/20/2020,123,120,0,243
GREENE,7/21/2020,126,124,0,250
GREENE,7/22/2020,131,128,0,259
GREENE,7/23/2020,138,129,0,267
GREENE,7/24/2020,140,132,0,272
GREENE,7/25/2020,142,134,0,276
GREENE,7/26/2020,143,135,0,278
GREENE,7/27/2020,145,137,0,282
GREENE,7/28/2020,147,138,0,285
GREENE,7/29/2020,151,140,0,291
GREENE,7/30/2020,160,145,0,305
GREENE,7/31/2020,169,145,0,314
GREENE,8/1/2020,172,153,0,325
GREENE,8/2/2020,175,155,0,330
GREENE,8/3/2020,180,161,0,341
GREENE,8/4/2020,188,163,0,351
GREENE,8/5/2020,191,168,0,359
GREENE,8/6/2020,194,173,0,367
GREENE,8/7/2020,196,176,0,372
GREENE,8/8/2020,200,179,0,379
GREENE,8/9/2020,200,180,0,380
GREENE,8/10/2020,203,184,1,388
GREENE,8/11/2020,208,189,1,398
GREENE,8/12/2020,208,189,1,398
GREENE,8/13/2020,212,190,1,403
GREENE,8/14/2020,217,191,1,409
GREENE,8/15/2020,220,192,1,413
GREENE,8/16/2020,220,192,1,413
GREENE,8/17/2020,224,192,1,417
GREENE,8/18/2020,225,193,1,419
GREENE,8/19/2020,228,195,1,424
GREENE,8/20/2020,230,195,2,427
GREENE,8/21/2020,234,197,2,433
GREENE,8/22/2020,238,199,2,439
GREENE,8/23/2020,238,199,2,439
GREENE,8/24/2020,245,204,2,451
GREENE,8/25/2020,247,205,2,454
GREENE,8/26/2020,253,205,2,460
GREENE,8/27/2020,255,208,2,465
GREENE,8/28/2020,258,211,2,471
GREENE,8/29/2020,258,214,2,474
GREENE,8/30/2020,261,214,3,478
GREENE,8/31/2020,267,219,3,489
GREENE,9/1/2020,272,220,3,495
GREENE,9/2/2020,272,220,3,495
GREENE,9/3/2020,273,221,3,497
GREENE,9/4/2020,273,223,3,499
GREENE,9/5/2020,273,223,3,499
GREENE,9/6/2020,273,223,3,499
GREENE,9/7/2020,276,223,3,502
GREENE,9/8/2020,277,224,3,504
GREENE,9/9/2020,277,224,3,504
GREENE,9/10/2020,277,226,3,506
GREENE,9/11/2020,279,228,3,510
GREENE,9/12/2020,279,231,3,513
GREENE,9/13/2020,279,231,3,513
GREENE,9/14/2020,279,231,3,513
GREENE,9/15/2020,280,231,3,514
GREENE,9/16/2020,280,231,3,514
GREENE,9/17/2020,281,231,3,515
GREENE,9/18/2020,281,233,3,517
GREENE,9/19/2020,282,233,3,518
GREENE,9/20/2020,284,233,3,520
GREENE,9/21/2020,285,234,3,522
GREENE,9/22/2020,285,234,3,522
GREENE,9/23/2020,286,234,3,523
GREENE,9/24/2020,287,234,3,524
GREENE,9/25/2020,288,236,3,527
GREENE,9/26/2020,289,237,3,529
GREENE,9/27/2020,289,237,3,529
GREENE,9/28/2020,289,239,3,531
GREENE,9/29/2020,290,240,3,533
GREENE,9/30/2020,293,242,3,538
GREENE,10/1/2020,294,243,3,540
GREENE,10/2/2020,296,244,3,543
GREENE,10/3/2020,297,246,3,546
GREENE,10/4/2020,299,246,3,548
GREENE,10/5/2020,299,247,3,549
GREENE,10/6/2020,300,248,3,551
GREENE,10/7/2020,300,248,3,551
GREENE,10/8/2020,301,249,3,553
GREENE,10/9/2020,302,249,3,554
GREENE,10/10/2020,303,249,3,555
GREENE,10/11/2020,303,249,3,555
GREENE,10/12/2020,305,249,3,557
GREENE,10/13/2020,305,249,3,557
GREENE,10/14/2020,305,249,3,557
GREENE,10/15/2020,305,249,3,557
GREENE,10/16/2020,305,249,3,557
GREENE,10/17/2020,305,249,3,557
GREENE,10/18/2020,305,249,3,557
GREENE,10/19/2020,305,249,3,557
GREENE,10/20/2020,305,249,3,557
CRAWFORD,1/1/2020,0,0,0,0
CRAWFORD,1/2/2020,0,0,0,0
CRAWFORD,1/3/2020,0,0,0,0
CRAWFORD,1/4/2020,0,0,0,0
CRAWFORD,1/5/2020,0,0,0,0
CRAWFORD,1/6/2020,0,0,0,0
CRAWFORD,1/7/2020,0,0,0,0
CRAWFORD,1/8/2020,0,0,0,0
CRAWFORD,1/9/2020,0,0,0,0
CRAWFORD,1/10/2020,0,0,0,0
CRAWFORD,1/11/2020,0,0,0,0
CRAWFORD,1/12/2020,0,0,0,0
CRAWFORD,1/13/2020,0,0,0,0
CRAWFORD,1/14/2020,0,0,0,0
CRAWFORD,1/15/2020,0,0,0,0
CRAWFORD,1/16/2020,0,0,0,0
CRAWFORD,1/17/2020,0,0,0,0
CRAWFORD,1/18/2020,0,0,0,0
CRAWFORD,1/19/2020,0,0,0,0
CRAWFORD,1/20/2020,0,0,0,0
CRAWFORD,1/21/2020,0,0,0,0
CRAWFORD,1/22/2020,0,0,0,0
CRAWFORD,1/23/2020,0,0,0,0
CRAWFORD,1/24/2020,0,0,0,0
CRAWFORD,1/25/2020,0,0,0,0
CRAWFORD,1/26/2020,0,0,0,0
CRAWFORD,1/27/2020,0,0,0,0
CRAWFORD,1/28/2020,0,0,0,0
CRAWFORD,1/29/2020,0,0,0,0
CRAWFORD,1/30/2020,0,0,0,0
CRAWFORD,1/31/2020,0,0,0,0
CRAWFORD,2/1/2020,0,0,0,0
CRAWFORD,2/2/2020,0,0,0,0
CRAWFORD,2/3/2020,0,0,0,0
CRAWFORD,2/4/2020,0,0,0,0
CRAWFORD,2/5/2020,0,0,0,0
CRAWFORD,2/6/2020,0,0,0,0
CRAWFORD,2/7/2020,0,0,0,0
CRAWFORD,2/8/2020,0,0,0,0
CRAWFORD,2/9/2020,0,0,0,0
CRAWFORD,2/10/2020,0,0,0,0
CRAWFORD,2/11/2020,0,0,0,0
CRAWFORD,2/12/2020,0,0,0,0
CRAWFORD,2/13/2020,0,0,0,0
CRAWFORD,2/14/2020,0,0,0,0
CRAWFORD,2/15/2020,0,0,0,0
CRAWFORD,2/16/2020,0,0,0,0
CRAWFORD,2/17/2020,0,0,0,0
CRAWFORD,2/18/2020,0,0,0,0
CRAWFORD,2/19/2020,0,0,0,0
CRAWFORD,2/20/2020,0,0,0,0
CRAWFORD,2/21/2020,0,0,0,0
CRAWFORD,2/22/2020,0,0,0,0
CRAWFORD,2/23/2020,0,0,0,0
CRAWFORD,2/24/2020,0,0,0,0
CRAWFORD,2/25/2020,0,0,0,0
CRAWFORD,2/26/2020,0,0,0,0
CRAWFORD,2/27/2020,0,0,0,0
CRAWFORD,2/28/2020,0,0,0,0
CRAWFORD,2/29/2020,0,0,0,0
CRAWFORD,3/1/2020,0,0,0,0
CRAWFORD,3/2/2020,0,0,0,0
CRAWFORD,3/3/2020,0,0,0,0
CRAWFORD,3/4/2020,0,0,0,0
CRAWFORD,3/5/2020,0,0,0,0
CRAWFORD,3/6/2020,0,0,0,0
CRAWFORD,3/7/2020,0,0,0,0
CRAWFORD,3/8/2020,0,0,0,0
CRAWFORD,3/9/2020,0,0,0,0
CRAWFORD,3/10/2020,0,0,0,0
CRAWFORD,3/11/2020,0,0,0,0
CRAWFORD,3/12/2020,1,0,0,1
CRAWFORD,3/13/2020,1,0,0,1
CRAWFORD,3/14/2020,1,0,0,1
CRAWFORD,3/15/2020,1,0,0,1
CRAWFORD,3/16/2020,1,0,0,1
CRAWFORD,3/17/2020,1,0,0,1
CRAWFORD,3/18/2020,1,0,0,1
CRAWFORD,3/19/2020,1,0,0,1
CRAWFORD,3/20/2020,1,0,0,1
CRAWFORD,3/21/2020,1,0,0,1
CRAWFORD,3/22/2020,1,1,0,2
CRAWFORD,3/23/2020,1,1,0,2
CRAWFORD,3/24/2020,1,1,0,2
CRAWFORD,3/25/2020,1,1,0,2
CRAWFORD,3/26/2020,1,1,0,2
CRAWFORD,3/27/2020,1,1,0,2
CRAWFORD,3/28/2020,1,1,0,2
CRAWFORD,3/29/2020,1,1,0,2
CRAWFORD,3/30/2020,2,1,0,3
CRAWFORD,3/31/2020,3,1,0,4
CRAWFORD,4/1/2020,3,1,0,4
CRAWFORD,4/2/2020,3,1,0,4
CRAWFORD,4/3/2020,3,1,0,4
CRAWFORD,4/4/2020,3,1,0,4
CRAWFORD,4/5/2020,3,2,0,5
CRAWFORD,4/6/2020,3,2,0,5
CRAWFORD,4/7/2020,3,5,0,8
CRAWFORD,4/8/2020,3,6,0,9
CRAWFORD,4/9/2020,4,6,0,10
CRAWFORD,4/10/2020,4,6,0,10
CRAWFORD,4/11/2020,5,6,0,11
CRAWFORD,4/12/2020,5,6,0,11
CRAWFORD,4/13/2020,7,7,0,14
CRAWFORD,4/14/2020,7,7,0,14
CRAWFORD,4/15/2020,7,7,0,14
CRAWFORD,4/16/2020,7,7,0,14
CRAWFORD,4/17/2020,7,7,0,14
CRAWFORD,4/18/2020,8,7,0,15
CRAWFORD,4/19/2020,9,7,0,16
CRAWFORD,4/20/2020,9,7,0,16
CRAWFORD,4/21/2020,9,7,0,16
CRAWFORD,4/22/2020,9,7,0,16
CRAWFORD,4/23/2020,9,7,0,16
CRAWFORD,4/24/2020,9,7,0,16
CRAWFORD,4/25/2020,9,8,0,17
CRAWFORD,4/26/2020,9,8,0,17
CRAWFORD,4/27/2020,9,9,0,18
CRAWFORD,4/28/2020,9,9,0,18
CRAWFORD,4/29/2020,9,9,0,18
CRAWFORD,4/30/2020,10,9,0,19
CRAWFORD,5/1/2020,10,9,0,19
CRAWFORD,5/2/2020,10,9,0,19
CRAWFORD,5/3/2020,10,9,0,19
CRAWFORD,5/4/2020,10,9,0,19
CRAWFORD,5/5/2020,11,9,0,20
CRAWFORD,5/6/2020,11,9,0,20
CRAWFORD,5/7/2020,11,9,0,20
CRAWFORD,5/8/2020,11,9,0,20
CRAWFORD,5/9/2020,11,9,0,20
CRAWFORD,5/10/2020,11,9,0,20
CRAWFORD,5/11/2020,11,9,0,20
CRAWFORD,5/12/2020,11,14,0,25
CRAWFORD,5/13/2020,12,14,0,26
CRAWFORD,5/14/2020,12,14,0,26
CRAWFORD,5/15/2020,12,14,0,26
CRAWFORD,5/16/2020,12,14,0,26
CRAWFORD,5/17/2020,12,14,0,26
CRAWFORD,5/18/2020,12,14,0,26
CRAWFORD,5/19/2020,12,15,0,27
CRAWFORD,5/20/2020,12,15,0,27
CRAWFORD,5/21/2020,12,17,0,29
MADISON,1/13/2020,0,0,0,0
COOK,4/30/2020,17,10,0,27
COOK,5/1/2020,18,11,0,29
COOK,5/2/2020,18,11,0,29
EFFINGHAM,8/14/2020,437,456,6,899
MADISON,1/14/2020,0,0,0,0
COOK,5/3/2020,18,11,0,29
EFFINGHAM,8/15/2020,442,459,6,907
MADISON,1/15/2020,0,0,0,0
COOK,5/4/2020,18,11,0,29
EFFINGHAM,8/16/2020,453,465,16,934
MADISON,1/16/2020,0,0,0,0
COOK,5/5/2020,18,11,0,29
EFFINGHAM,8/17/2020,468,476,19,963
MADISON,1/17/2020,0,0,0,0
COOK,5/6/2020,18,11,0,29
EFFINGHAM,8/18/2020,474,482,19,975
MADISON,1/18/2020,0,0,0,0
COOK,5/7/2020,19,11,0,30
EFFINGHAM,8/19/2020,487,492,19,998
MADISON,1/19/2020,0,0,0,0
COOK,5/8/2020,19,11,0,30
COOK,5/9/2020,19,11,0,30
COOK,5/10/2020,19,11,0,30
COOK,5/11/2020,19,11,0,30
COOK,5/12/2020,19,11,0,30
COOK,5/13/2020,19,12,0,31
COOK,5/14/2020,19,13,0,32
COOK,5/15/2020,20,13,0,33
COOK,5/16/2020,21,13,0,34
COOK,5/17/2020,21,13,0,34
COOK,5/18/2020,22,14,0,36
COOK,5/19/2020,23,15,0,38
COOK,5/20/2020,23,16,0,39
COOK,5/21/2020,23,17,0,40
COOK,5/22/2020,24,17,0,41
COOK,5/23/2020,25,17,0,42
COOK,5/24/2020,25,18,0,43
COOK,5/25/2020,25,18,0,43
COOK,5/26/2020,26,20,0,46
COOK,5/27/2020,26,20,0,46
COOK,5/28/2020,27,20,0,47
COOK,5/29/2020,27,22,0,49
COOK,5/30/2020,27,22,0,49
COOK,5/31/2020,27,22,0,49
COOK,6/1/2020,29,23,0,52
COOK,6/2/2020,29,26,0,55
COOK,6/3/2020,31,26,0,57
COOK,6/4/2020,32,28,0,60
COOK,6/5/2020,33,30,0,63
COOK,6/6/2020,36,32,0,68
COOK,6/7/2020,36,32,0,68
COOK,6/8/2020,37,33,0,70
COOK,6/9/2020,37,34,0,71
COOK,6/10/2020,41,36,0,77
COOK,6/11/2020,44,36,0,80
COOK,6/12/2020,45,36,0,81
COOK,6/13/2020,49,37,0,86
COOK,6/14/2020,51,37,0,88
COOK,6/15/2020,55,37,0,92
COOK,6/16/2020,55,39,0,94
COOK,6/17/2020,59,41,0,100
COOK,6/18/2020,64,44,0,108
COOK,6/19/2020,65,46,0,111
COOK,6/20/2020,68,50,0,118
COOK,6/21/2020,70,51,0,121
COOK,6/22/2020,78,54,0,132
COOK,6/23/2020,80,55,0,135
COOK,6/24/2020,83,55,0,138
COOK,6/25/2020,89,63,0,152
COOK,6/26/2020,93,67,0,160
COOK,6/27/2020,94,69,0,163
COOK,6/28/2020,96,71,0,167
COOK,6/29/2020,106,75,0,181
COOK,6/30/2020,115,80,0,195
COOK,7/1/2020,118,82,0,200
COOK,7/2/2020,122,87,0,209
COOK,7/3/2020,126,94,0,220
COOK,7/4/2020,133,97,0,230
COOK,7/5/2020,133,98,0,231
COOK,7/6/2020,137,101,0,238
COOK,7/7/2020,138,104,0,242
COOK,7/8/2020,144,104,0,248
COOK,7/9/2020,153,108,0,261
COOK,7/10/2020,156,111,0,267
COOK,7/11/2020,160,112,0,272
COOK,7/12/2020,161,113,0,274
COOK,7/13/2020,165,118,0,283
COOK,7/14/2020,170,120,0,290
COOK,7/15/2020,173,125,0,298
COOK,7/16/2020,177,131,0,308
COOK,7/17/2020,182,132,0,314
COOK,7/18/2020,185,133,0,318
COOK,7/19/2020,187,137,0,324
COOK,7/20/2020,199,139,0,338
COOK,7/21/2020,204,147,1,352
COOK,7/22/2020,211,152,1,364
COOK,7/23/2020,215,155,1,371
COOK,7/24/2020,220,158,1,379
COOK,7/25/2020,226,161,1,388
COOK,7/26/2020,227,162,1,390
COOK,7/27/2020,230,164,1,395
COOK,7/28/2020,233,167,1,401
COOK,7/29/2020,238,168,1,407
COOK,7/30/2020,239,171,2,412
COOK,7/31/2020,245,175,2,422
COOK,8/1/2020,246,175,2,423
COOK,8/2/2020,247,175,2,424
COOK,8/3/2020,248,182,2,432
COOK,8/4/2020,249,183,2,434
COOK,8/5/2020,253,186,3,442
COOK,8/6/2020,256,194,3,453
COOK,8/7/2020,261,196,3,460
COOK,8/8/2020,261,197,3,461
COOK,8/9/2020,262,197,3,462
COOK,8/10/2020,267,199,3,469
COOK,8/11/2020,269,200,3,472
COOK,8/12/2020,272,201,3,476
COOK,8/13/2020,276,202,3,481
COOK,8/14/2020,279,205,3,487
COOK,8/15/2020,280,207,3,490
COOK,8/16/2020,280,208,3,491
COOK,8/17/2020,283,208,3,494
COOK,8/18/2020,287,211,3,501
COOK,8/19/2020,287,211,3,501
COOK,8/20/2020,291,211,5,507
COOK,8/21/2020,291,211,5,507
COOK,8/22/2020,291,211,5,507
COOK,8/23/2020,291,213,5,509
COOK,8/24/2020,291,213,5,509
COOK,8/25/2020,292,214,5,511
COOK,8/26/2020,294,214,5,513
COOK,8/27/2020,294,214,5,513
COOK,8/28/2020,295,214,5,514
COOK,8/29/2020,295,214,5,514
COOK,8/30/2020,295,214,5,514
COOK,8/31/2020,297,216,5,518
COOK,9/1/2020,298,216,5,519
COOK,9/2/2020,299,218,5,522
COOK,9/3/2020,303,220,5,528
COOK,9/4/2020,303,222,5,530
COOK,9/5/2020,303,222,5,530
COOK,9/6/2020,303,222,5,530
COOK,9/7/2020,303,222,5,530
COOK,9/8/2020,304,222,5,531
COOK,9/9/2020,305,223,5,533
COOK,9/10/2020,305,223,5,533
COOK,9/11/2020,305,223,5,533
COOK,9/12/2020,305,223,5,533
COOK,9/13/2020,306,224,5,535
COOK,9/14/2020,307,225,5,537
COOK,9/15/2020,308,225,5,538
COOK,9/16/2020,310,225,5,540
COOK,9/17/2020,312,226,5,543
COOK,9/18/2020,315,226,5,546
COOK,9/19/2020,315,226,5,546
COOK,9/20/2020,315,226,5,546
COOK,9/21/2020,317,227,5,549
COOK,9/22/2020,317,228,5,550
COOK,9/23/2020,318,228,5,551
COOK,9/24/2020,318,229,5,552
COOK,9/25/2020,319,229,5,553
COOK,9/26/2020,320,229,5,554
COOK,9/27/2020,320,229,5,554
COOK,9/28/2020,321,230,5,556
COOK,9/29/2020,321,231,5,557
COOK,9/30/2020,321,231,5,557
COOK,10/1/2020,321,232,5,558
COOK,10/2/2020,321,232,5,558
COOK,10/3/2020,321,232,5,558
COOK,10/4/2020,322,233,5,560
COOK,10/5/2020,322,233,5,560
COOK,10/6/2020,322,233,5,560
COOK,10/7/2020,323,233,5,561
COOK,10/8/2020,324,234,5,563
COOK,10/9/2020,324,234,5,563
COOK,10/10/2020,324,235,5,564
COOK,10/11/2020,325,236,5,566
COOK,10/12/2020,325,237,5,567
COOK,10/13/2020,327,238,5,570
COOK,10/14/2020,327,238,5,570
COOK,10/15/2020,327,238,5,570
COOK,10/16/2020,329,238,5,572
COOK,10/17/2020,329,238,5,572
COOK,10/18/2020,329,238,5,572
COOK,10/19/2020,330,238,5,573
COOK,10/20/2020,330,238,5,573
EFFINGHAM,1/1/2020,0,0,0,0
EFFINGHAM,1/2/2020,0,0,0,0
EFFINGHAM,1/3/2020,0,0,0,0
EFFINGHAM,1/4/2020,0,0,0,0
EFFINGHAM,1/5/2020,0,0,0,0
EFFINGHAM,1/6/2020,0,0,0,0
EFFINGHAM,1/7/2020,0,0,0,0
EFFINGHAM,1/8/2020,0,0,0,0
EFFINGHAM,1/9/2020,0,0,0,0
EFFINGHAM,1/10/2020,0,0,0,0
EFFINGHAM,1/11/2020,0,0,0,0
EFFINGHAM,1/12/2020,0,0,0,0
EFFINGHAM,1/13/2020,0,0,0,0
EFFINGHAM,1/14/2020,0,0,0,0
EFFINGHAM,1/15/2020,0,0,0,0
EFFINGHAM,1/16/2020,0,0,0,0
EFFINGHAM,1/17/2020,0,0,0,0
EFFINGHAM,1/18/2020,0,0,0,0
EFFINGHAM,1/19/2020,0,0,0,0
EFFINGHAM,1/20/2020,0,0,0,0
EFFINGHAM,1/21/2020,0,0,0,0
EFFINGHAM,1/22/2020,0,0,0,0
EFFINGHAM,1/23/2020,0,0,0,0
EFFINGHAM,1/24/2020,0,0,0,0
EFFINGHAM,1/25/2020,0,0,0,0
EFFINGHAM,1/26/2020,0,0,0,0
EFFINGHAM,1/27/2020,0,0,0,0
EFFINGHAM,1/28/2020,0,0,0,0
EFFINGHAM,1/29/2020,0,0,0,0
EFFINGHAM,1/30/2020,0,0,0,0
EFFINGHAM,1/31/2020,0,0,0,0
EFFINGHAM,2/1/2020,0,0,0,0
EFFINGHAM,2/2/2020,0,0,0,0
EFFINGHAM,2/3/2020,0,0,0,0
EFFINGHAM,2/4/2020,0,0,0,0
EFFINGHAM,2/5/2020,0,0,0,0
EFFINGHAM,2/6/2020,0,0,0,0
EFFINGHAM,2/7/2020,0,0,0,0
EFFINGHAM,2/8/2020,0,0,0,0
EFFINGHAM,2/9/2020,0,0,0,0
EFFINGHAM,2/10/2020,0,0,0,0
EFFINGHAM,2/11/2020,0,0,0,0
EFFINGHAM,2/12/2020,0,0,0,0
EFFINGHAM,2/13/2020,0,0,0,0
EFFINGHAM,2/14/2020,0,0,0,0
EFFINGHAM,2/15/2020,0,0,0,0
EFFINGHAM,2/16/2020,0,0,0,0
EFFINGHAM,2/17/2020,0,0,0,0
EFFINGHAM,2/18/2020,0,0,0,0
EFFINGHAM,2/19/2020,0,0,0,0
EFFINGHAM,2/20/2020,0,0,0,0
EFFINGHAM,2/21/2020,0,0,0,0
EFFINGHAM,2/22/2020,0,0,0,0
EFFINGHAM,2/23/2020,0,0,0,0
EFFINGHAM,2/24/2020,0,0,0,0
EFFINGHAM,2/25/2020,0,0,0,0
EFFINGHAM,2/26/2020,0,0,0,0
EFFINGHAM,2/27/2020,0,0,0,0
EFFINGHAM,2/28/2020,0,0,0,0
EFFINGHAM,2/29/2020,0,0,0,0
EFFINGHAM,3/1/2020,1,0,0,1
EFFINGHAM,3/2/2020,1,0,0,1
EFFINGHAM,3/3/2020,1,0,0,1
EFFINGHAM,3/4/2020,1,0,0,1
EFFINGHAM,3/5/2020,2,0,0,2
EFFINGHAM,3/6/2020,2,1,0,3
EFFINGHAM,3/7/2020,2,1,0,3
EFFINGHAM,3/8/2020,2,1,0,3
EFFINGHAM,3/9/2020,3,2,0,5
EFFINGHAM,3/10/2020,4,2,0,6
EFFINGHAM,3/11/2020,4,2,0,6
EFFINGHAM,3/12/2020,4,2,0,6
EFFINGHAM,3/13/2020,4,2,0,6
EFFINGHAM,3/14/2020,5,2,0,7
EFFINGHAM,3/15/2020,6,2,0,8
EFFINGHAM,3/16/2020,6,2,0,8
EFFINGHAM,3/17/2020,6,4,0,10
EFFINGHAM,3/18/2020,6,4,0,10
EFFINGHAM,3/19/2020,6,4,0,10
EFFINGHAM,3/20/2020,7,4,0,11
EFFINGHAM,3/21/2020,8,5,0,13
EFFINGHAM,3/22/2020,8,5,0,13
EFFINGHAM,3/23/2020,9,5,0,14
EFFINGHAM,3/24/2020,9,6,0,15
EFFINGHAM,3/25/2020,10,6,0,16
EFFINGHAM,3/26/2020,10,7,0,17
EFFINGHAM,3/27/2020,11,8,0,19
EFFINGHAM,3/28/2020,11,9,0,20
EFFINGHAM,3/29/2020,11,9,0,20
EFFINGHAM,3/30/2020,11,10,0,21
EFFINGHAM,3/31/2020,11,10,0,21
EFFINGHAM,4/1/2020,11,10,0,21
EFFINGHAM,4/2/2020,11,10,0,21
EFFINGHAM,4/3/2020,11,11,0,22
EFFINGHAM,4/4/2020,11,11,0,22
EFFINGHAM,4/5/2020,12,11,0,23
EFFINGHAM,4/6/2020,13,11,0,24
EFFINGHAM,4/7/2020,13,12,0,25
EFFINGHAM,4/8/2020,13,13,0,26
EFFINGHAM,4/9/2020,13,13,0,26
EFFINGHAM,4/10/2020,13,15,0,28
EFFINGHAM,4/11/2020,13,16,0,29
EFFINGHAM,4/12/2020,13,16,0,29
EFFINGHAM,4/13/2020,15,16,0,31
EFFINGHAM,4/14/2020,15,17,0,32
EFFINGHAM,4/15/2020,15,17,0,32
EFFINGHAM,4/16/2020,15,18,0,33
EFFINGHAM,4/17/2020,15,19,0,34
EFFINGHAM,4/18/2020,16,19,0,35
EFFINGHAM,4/19/2020,16,19,0,35
EFFINGHAM,4/20/2020,16,20,0,36
EFFINGHAM,4/21/2020,17,20,0,37
EFFINGHAM,4/22/2020,17,21,0,38
EFFINGHAM,4/23/2020,17,21,0,38
EFFINGHAM,4/24/2020,18,21,0,39
EFFINGHAM,4/25/2020,18,21,0,39
EFFINGHAM,4/26/2020,18,21,0,39
EFFINGHAM,4/27/2020,18,21,0,39
EFFINGHAM,4/28/2020,18,22,0,40
EFFINGHAM,4/29/2020,19,22,0,41
EFFINGHAM,4/30/2020,19,22,0,41
EFFINGHAM,5/1/2020,20,22,0,42
EFFINGHAM,5/2/2020,20,22,0,42
EFFINGHAM,5/3/2020,20,22,0,42
EFFINGHAM,5/4/2020,21,22,0,43
EFFINGHAM,5/5/2020,22,23,0,45
EFFINGHAM,5/6/2020,22,24,0,46
EFFINGHAM,5/7/2020,24,24,0,48
EFFINGHAM,5/8/2020,26,26,0,52
EFFINGHAM,5/9/2020,26,26,0,52
EFFINGHAM,5/10/2020,28,27,0,55
EFFINGHAM,5/11/2020,30,27,0,57
EFFINGHAM,5/12/2020,30,27,0,57
EFFINGHAM,5/13/2020,30,27,0,57
EFFINGHAM,5/14/2020,30,27,0,57
EFFINGHAM,5/15/2020,33,28,0,61
EFFINGHAM,5/16/2020,35,29,0,64
EFFINGHAM,5/17/2020,36,29,0,65
EFFINGHAM,5/18/2020,36,29,0,65
EFFINGHAM,5/19/2020,38,29,0,67
EFFINGHAM,5/20/2020,38,29,0,67
EFFINGHAM,5/21/2020,38,29,0,67
EFFINGHAM,5/22/2020,43,32,0,75
EFFINGHAM,5/23/2020,43,32,0,75
EFFINGHAM,5/24/2020,44,33,0,77
EFFINGHAM,5/25/2020,44,33,0,77
EFFINGHAM,5/26/2020,45,34,0,79
EFFINGHAM,5/27/2020,45,34,0,79
EFFINGHAM,5/28/2020,45,34,0,79
EFFINGHAM,5/29/2020,45,35,0,80
EFFINGHAM,5/30/2020,45,35,0,80
EFFINGHAM,5/31/2020,45,35,0,80
EFFINGHAM,6/1/2020,46,35,0,81
EFFINGHAM,6/2/2020,46,36,0,82
EFFINGHAM,6/3/2020,48,36,0,84
EFFINGHAM,6/4/2020,48,36,0,84
EFFINGHAM,6/5/2020,49,37,0,86
EFFINGHAM,6/6/2020,49,37,0,86
EFFINGHAM,6/7/2020,49,37,0,86
EFFINGHAM,6/8/2020,50,38,0,88
EFFINGHAM,6/9/2020,52,40,0,92
EFFINGHAM,6/10/2020,52,40,0,92
EFFINGHAM,6/11/2020,53,41,0,94
EFFINGHAM,6/12/2020,54,41,0,95
EFFINGHAM,6/13/2020,55,42,0,97
EFFINGHAM,6/14/2020,55,43,0,98
EFFINGHAM,6/15/2020,57,45,0,102
EFFINGHAM,6/16/2020,57,45,0,102
EFFINGHAM,6/17/2020,62,48,0,110
EFFINGHAM,6/18/2020,68,48,0,116
EFFINGHAM,6/19/2020,69,52,0,121
EFFINGHAM,6/20/2020,73,52,0,125
EFFINGHAM,6/21/2020,73,57,0,130
EFFINGHAM,6/22/2020,82,67,0,149
EFFINGHAM,6/23/2020,86,75,0,161
EFFINGHAM,6/24/2020,91,85,0,176
EFFINGHAM,6/25/2020,95,89,0,184
EFFINGHAM,6/26/2020,100,96,0,196
EFFINGHAM,6/27/2020,106,100,0,206
EFFINGHAM,6/28/2020,109,104,0,213
EFFINGHAM,6/29/2020,116,107,0,223
EFFINGHAM,6/30/2020,123,116,0,239
EFFINGHAM,7/1/2020,129,119,0,248
EFFINGHAM,7/2/2020,141,123,0,264
EFFINGHAM,7/3/2020,146,131,0,277
EFFINGHAM,7/4/2020,149,134,0,283
EFFINGHAM,7/5/2020,151,138,0,289
EFFINGHAM,7/6/2020,159,157,0,316
EFFINGHAM,7/7/2020,175,176,2,353
EFFINGHAM,7/8/2020,184,179,2,365
EFFINGHAM,7/9/2020,193,235,2,430
EFFINGHAM,7/10/2020,197,241,2,440
EFFINGHAM,7/11/2020,199,248,2,449
EFFINGHAM,7/12/2020,203,249,2,454
EFFINGHAM,7/13/2020,212,259,4,475
EFFINGHAM,7/14/2020,222,267,4,493
EFFINGHAM,7/15/2020,231,279,4,514
EFFINGHAM,7/16/2020,235,284,4,523
EFFINGHAM,7/17/2020,241,292,4,537
EFFINGHAM,7/18/2020,249,295,4,548
EFFINGHAM,7/19/2020,258,299,4,561
EFFINGHAM,7/20/2020,266,306,4,576
EFFINGHAM,7/21/2020,276,311,4,591
EFFINGHAM,7/22/2020,280,317,4,601
EFFINGHAM,7/23/2020,285,321,4,610
EFFINGHAM,7/24/2020,288,325,4,617
EFFINGHAM,7/25/2020,291,330,4,625
EFFINGHAM,7/26/2020,296,333,4,633
EFFINGHAM,7/27/2020,304,337,4,645
EFFINGHAM,7/28/2020,316,344,4,664
EFFINGHAM,7/29/2020,319,352,4,675
EFFINGHAM,7/30/2020,326,356,4,686
EFFINGHAM,7/31/2020,333,361,4,698
EFFINGHAM,8/1/2020,337,367,4,708
EFFINGHAM,8/2/2020,339,369,4,712
EFFINGHAM,8/3/2020,353,376,4,733
EFFINGHAM,8/4/2020,359,383,4,746
EFFINGHAM,8/5/2020,365,390,5,760
EFFINGHAM,8/6/2020,371,398,5,774
EFFINGHAM,8/7/2020,379,404,5,788
EFFINGHAM,8/8/2020,385,410,5,800
EFFINGHAM,8/9/2020,391,414,5,810
EFFINGHAM,8/10/2020,405,430,6,841
EFFINGHAM,8/11/2020,419,437,6,862
EFFINGHAM,8/20/2020,498,503,20,1021
EFFINGHAM,8/21/2020,505,507,20,1032
EFFINGHAM,8/22/2020,510,510,20,1040
EFFINGHAM,8/23/2020,519,514,20,1053
EFFINGHAM,8/24/2020,527,522,20,1069
EFFINGHAM,8/25/2020,538,534,20,1092
EFFINGHAM,8/26/2020,551,541,20,1112
EFFINGHAM,8/27/2020,555,544,20,1119
EFFINGHAM,8/28/2020,560,559,20,1139
EFFINGHAM,8/29/2020,570,561,20,1151
EFFINGHAM,8/30/2020,573,567,20,1160
EFFINGHAM,8/31/2020,588,576,20,1184
EFFINGHAM,9/1/2020,598,585,20,1203
EFFINGHAM,9/2/2020,604,590,20,1214
EFFINGHAM,9/3/2020,617,597,20,1234
MADISON,1/20/2020,0,0,0,0
EFFINGHAM,9/4/2020,632,605,20,1257
EFFINGHAM,9/5/2020,638,614,20,1272
EFFINGHAM,9/6/2020,644,618,20,1282
EFFINGHAM,9/7/2020,648,629,20,1297
EFFINGHAM,9/8/2020,657,639,20,1316
EFFINGHAM,9/9/2020,664,647,20,1331
EFFINGHAM,9/10/2020,675,652,20,1347
EFFINGHAM,9/11/2020,685,658,20,1363
EFFINGHAM,9/12/2020,687,660,20,1367
EFFINGHAM,9/13/2020,693,663,20,1376
EFFINGHAM,9/14/2020,701,675,20,1396
EFFINGHAM,9/15/2020,704,682,20,1406
EFFINGHAM,9/16/2020,706,685,20,1411
EFFINGHAM,9/17/2020,714,687,20,1421
EFFINGHAM,9/18/2020,718,690,20,1428
EFFINGHAM,9/19/2020,718,693,20,1431
EFFINGHAM,9/20/2020,721,698,20,1439
EFFINGHAM,9/21/2020,731,703,20,1454
EFFINGHAM,9/22/2020,732,705,20,1457
EFFINGHAM,9/23/2020,738,708,20,1466
EFFINGHAM,9/24/2020,739,710,20,1469
EFFINGHAM,9/25/2020,749,712,20,1481
EFFINGHAM,9/26/2020,752,715,20,1487
EFFINGHAM,9/27/2020,756,719,20,1495
EFFINGHAM,9/28/2020,760,729,20,1509
EFFINGHAM,9/29/2020,762,734,20,1516
EFFINGHAM,9/30/2020,767,740,21,1528
EFFINGHAM,10/1/2020,773,745,21,1539
EFFINGHAM,10/2/2020,779,751,21,1551
EFFINGHAM,10/3/2020,789,756,21,1566
EFFINGHAM,10/4/2020,797,759,21,1577
EFFINGHAM,10/5/2020,810,761,21,1592
EFFINGHAM,10/6/2020,816,766,21,1603
EFFINGHAM,10/7/2020,826,770,21,1617
EFFINGHAM,10/8/2020,831,772,21,1624
EFFINGHAM,10/9/2020,841,777,21,1639
EFFINGHAM,10/10/2020,849,783,21,1653
EFFINGHAM,10/11/2020,850,784,21,1655
EFFINGHAM,10/12/2020,861,788,21,1670
EFFINGHAM,10/13/2020,869,792,21,1682
EFFINGHAM,10/14/2020,873,798,21,1692
EFFINGHAM,10/15/2020,879,805,21,1705
EFFINGHAM,10/16/2020,882,808,21,1711
EFFINGHAM,10/17/2020,884,809,21,1714
EFFINGHAM,10/18/2020,885,811,21,1717
EFFINGHAM,10/19/2020,885,813,21,1719
EFFINGHAM,10/20/2020,885,813,21,1719
CARROLL,1/1/2020,0,0,0,0
CARROLL,1/2/2020,0,0,0,0
CARROLL,1/3/2020,0,0,0,0
CARROLL,1/4/2020,0,0,0,0
CARROLL,1/5/2020,0,0,0,0
CARROLL,1/6/2020,0,0,0,0
CARROLL,1/7/2020,0,0,0,0
CARROLL,1/8/2020,0,0,0,0
CARROLL,1/9/2020,0,0,0,0
CARROLL,1/10/2020,0,0,0,0
CARROLL,1/11/2020,0,0,0,0
CARROLL,1/12/2020,0,0,0,0
CARROLL,1/13/2020,0,0,0,0
CARROLL,1/14/2020,0,0,0,0
CARROLL,1/15/2020,0,0,0,0
CARROLL,1/16/2020,0,0,0,0
CARROLL,1/17/2020,0,0,0,0
CARROLL,1/18/2020,0,0,0,0
CARROLL,1/19/2020,0,0,0,0
CARROLL,1/20/2020,0,0,0,0
CARROLL,1/21/2020,0,0,0,0
CARROLL,1/22/2020,0,0,0,0
CARROLL,1/23/2020,0,0,0,0
CARROLL,1/24/2020,0,0,0,0
CARROLL,1/25/2020,0,0,0,0
CARROLL,1/26/2020,0,0,0,0
CARROLL,1/27/2020,0,0,0,0
CARROLL,1/28/2020,0,0,0,0
CARROLL,1/29/2020,0,0,0,0
CARROLL,1/30/2020,0,0,0,0
CARROLL,1/31/2020,0,0,0,0
CARROLL,2/1/2020,0,0,1,1
CARROLL,2/2/2020,0,0,1,1
CARROLL,2/3/2020,0,0,1,1
CARROLL,2/4/2020,0,0,1,1
CARROLL,2/5/2020,0,0,1,1
CARROLL,2/6/2020,0,0,1,1
CARROLL,2/7/2020,0,0,1,1
CARROLL,2/8/2020,0,0,1,1
CARROLL,2/9/2020,0,0,1,1
CARROLL,2/10/2020,0,0,1,1
CARROLL,2/11/2020,0,0,1,1
CARROLL,2/12/2020,0,0,1,1
CARROLL,2/13/2020,0,0,1,1
CARROLL,2/14/2020,0,0,1,1
CARROLL,2/15/2020,0,0,1,1
CARROLL,2/16/2020,0,0,1,1
CARROLL,2/17/2020,0,0,1,1
CARROLL,2/18/2020,0,0,1,1
CARROLL,2/19/2020,0,0,1,1
CARROLL,2/20/2020,0,0,1,1
CARROLL,2/21/2020,0,0,1,1
CARROLL,2/22/2020,0,0,1,1
CARROLL,2/23/2020,0,0,1,1
CARROLL,2/24/2020,0,0,1,1
CARROLL,2/25/2020,0,0,1,1
CARROLL,2/26/2020,0,0,1,1
CARROLL,2/27/2020,0,0,1,1
CARROLL,2/28/2020,0,0,1,1
CARROLL,2/29/2020,0,0,1,1
CARROLL,3/1/2020,0,0,1,1
CARROLL,3/2/2020,1,0,1,2
CARROLL,3/3/2020,3,0,1,4
CARROLL,3/4/2020,3,0,1,4
CARROLL,3/5/2020,3,0,1,4
CARROLL,3/6/2020,3,1,1,5
CARROLL,3/7/2020,4,2,1,7
CARROLL,3/8/2020,5,2,1,8
CARROLL,3/9/2020,5,2,1,8
CARROLL,3/10/2020,7,2,1,10
CARROLL,3/11/2020,9,4,1,14
CARROLL,3/12/2020,11,5,1,17
CARROLL,3/13/2020,16,7,1,24
CARROLL,3/14/2020,22,9,1,32
CARROLL,3/15/2020,25,11,1,37
CARROLL,3/16/2020,30,16,1,47
CARROLL,3/17/2020,35,20,1,56
CARROLL,3/18/2020,43,20,1,64
CARROLL,3/19/2020,43,23,1,67
CARROLL,3/20/2020,47,27,1,75
CARROLL,3/21/2020,50,31,1,82
CARROLL,3/22/2020,53,36,1,90
CARROLL,3/23/2020,65,43,2,110
CARROLL,3/24/2020,70,53,2,125
CARROLL,3/25/2020,78,61,2,141
CARROLL,3/26/2020,80,68,2,150
CARROLL,3/27/2020,83,73,2,158
CARROLL,3/28/2020,85,78,2,165
CARROLL,3/29/2020,86,78,2,166
CARROLL,3/30/2020,88,80,2,170
CARROLL,3/31/2020,91,83,3,177
CARROLL,4/1/2020,97,90,3,190
CARROLL,4/2/2020,100,93,3,196
CARROLL,4/3/2020,104,96,3,203
CARROLL,4/4/2020,110,98,3,211
CARROLL,4/5/2020,112,98,3,213
CARROLL,4/6/2020,131,105,3,239
CARROLL,4/7/2020,134,109,3,246
CARROLL,4/8/2020,142,116,3,261
CARROLL,4/9/2020,147,120,3,270
CARROLL,4/10/2020,154,123,3,280
CARROLL,4/11/2020,157,126,3,286
CARROLL,4/12/2020,158,128,3,289
CARROLL,4/13/2020,160,132,3,295
CARROLL,4/14/2020,169,137,3,309
CARROLL,4/15/2020,171,138,3,312
CARROLL,4/16/2020,180,145,3,328
CARROLL,4/17/2020,192,148,3,343
CARROLL,4/18/2020,196,150,3,349
CARROLL,4/19/2020,196,150,3,349
CARROLL,4/20/2020,200,153,3,356
CARROLL,4/21/2020,207,155,3,365
CARROLL,4/22/2020,207,157,3,367
CARROLL,4/23/2020,207,157,3,367
CARROLL,4/24/2020,207,158,3,368
CARROLL,4/25/2020,209,158,3,370
CARROLL,4/26/2020,209,160,3,372
CARROLL,4/27/2020,210,172,3,385
CARROLL,4/28/2020,215,174,4,393
CARROLL,4/29/2020,220,174,4,398
CARROLL,4/30/2020,220,176,4,400
CARROLL,5/1/2020,227,183,4,414
CARROLL,5/2/2020,227,183,4,414
CARROLL,5/3/2020,227,184,4,415
CARROLL,5/4/2020,228,184,4,416
CARROLL,5/5/2020,228,184,4,416
CARROLL,5/6/2020,231,184,4,419
CARROLL,5/7/2020,233,185,4,422
CARROLL,5/8/2020,235,189,4,428
CARROLL,5/9/2020,236,190,4,430
CARROLL,5/10/2020,237,191,4,432
CARROLL,5/11/2020,239,194,4,437
CARROLL,5/12/2020,243,199,4,446
CARROLL,5/13/2020,247,200,4,451
CARROLL,5/14/2020,251,204,4,459
CARROLL,5/15/2020,254,207,4,465
CARROLL,5/16/2020,257,210,4,471
CARROLL,5/17/2020,263,212,4,479
CARROLL,5/18/2020,273,216,4,493
CARROLL,5/19/2020,276,226,4,506
CARROLL,5/20/2020,280,240,4,524
CARROLL,5/21/2020,283,242,4,529
CARROLL,5/22/2020,288,243,4,535
CARROLL,5/23/2020,289,246,4,539
CARROLL,5/24/2020,290,246,4,540
CARROLL,5/25/2020,294,251,4,549
CARROLL,5/26/2020,296,256,4,556
CARROLL,5/27/2020,300,260,4,564
CARROLL,5/28/2020,305,261,4,570
CARROLL,5/29/2020,307,263,4,574
CARROLL,5/30/2020,309,263,4,576
CARROLL,5/31/2020,310,264,4,578
CARROLL,6/1/2020,312,268,4,584
CARROLL,6/2/2020,316,270,4,590
CARROLL,6/3/2020,318,271,4,593
CARROLL,6/4/2020,319,272,4,595
CARROLL,6/5/2020,319,273,4,596
CARROLL,6/6/2020,319,275,4,598
CARROLL,6/7/2020,322,278,4,604
CARROLL,6/8/2020,323,281,4,608
CARROLL,6/9/2020,325,284,5,614
CARROLL,6/10/2020,331,289,5,625
CARROLL,6/11/2020,332,291,5,628
CARROLL,6/12/2020,333,294,5,632
CARROLL,6/13/2020,334,294,5,633
CARROLL,6/14/2020,335,295,5,635
CARROLL,6/15/2020,339,299,5,643
CARROLL,6/16/2020,344,303,5,652
CARROLL,6/17/2020,347,307,5,659
CARROLL,6/18/2020,349,312,5,666
CARROLL,6/19/2020,351,314,5,670
CARROLL,6/20/2020,351,316,5,672
CARROLL,6/21/2020,352,318,5,675
CARROLL,6/22/2020,360,330,6,696
CARROLL,6/23/2020,371,340,6,717
CARROLL,6/24/2020,379,351,6,736
CARROLL,6/25/2020,389,363,6,758
CARROLL,6/26/2020,403,373,7,783
CARROLL,6/27/2020,409,378,7,794
CARROLL,6/28/2020,412,382,7,801
CARROLL,6/29/2020,430,398,8,836
CARROLL,6/30/2020,434,402,8,844
CARROLL,7/1/2020,458,423,10,891
CARROLL,7/2/2020,478,441,11,930
CARROLL,7/3/2020,494,455,12,961
CARROLL,7/4/2020,501,461,12,974
CARROLL,7/5/2020,511,473,12,996
CARROLL,7/6/2020,536,499,13,1048
CARROLL,7/7/2020,567,528,14,1109
CARROLL,7/8/2020,584,543,14,1141
CARROLL,7/9/2020,620,571,14,1205
CARROLL,7/10/2020,664,612,16,1292
CARROLL,7/11/2020,672,618,17,1307
CARROLL,7/12/2020,680,621,17,1318
CARROLL,7/13/2020,717,653,17,1387
CARROLL,7/14/2020,755,684,17,1456
CARROLL,7/15/2020,792,713,17,1522
CARROLL,7/16/2020,821,730,17,1568
CARROLL,7/17/2020,853,761,18,1632
CARROLL,7/18/2020,864,768,18,1650
CARROLL,7/19/2020,867,772,18,1657
CARROLL,7/20/2020,895,791,20,1706
CARROLL,7/21/2020,932,819,21,1772
CARROLL,7/22/2020,945,836,22,1803
CARROLL,7/23/2020,976,857,23,1856
CARROLL,7/24/2020,998,883,24,1905
CARROLL,7/25/2020,1002,889,24,1915
CARROLL,7/26/2020,1009,893,24,1926
CARROLL,7/27/2020,1019,904,26,1949
CARROLL,7/28/2020,1039,921,27,1987
CARROLL,7/29/2020,1057,933,27,2017
CARROLL,7/30/2020,1063,942,27,2032
CARROLL,7/31/2020,1073,953,27,2053
CARROLL,8/1/2020,1082,958,28,2068
CARROLL,8/2/2020,1087,964,28,2079
CARROLL,8/3/2020,1094,977,28,2099
CARROLL,8/4/2020,1107,984,28,2119
CARROLL,8/5/2020,1113,997,28,2138
CARROLL,8/6/2020,1118,1002,28,2148
CARROLL,8/7/2020,1128,1011,28,2167
CARROLL,8/8/2020,1137,1014,28,2179
CARROLL,8/9/2020,1152,1021,28,2201
CARROLL,8/10/2020,1170,1038,28,2236
CARROLL,8/11/2020,1176,1049,28,2253
CARROLL,8/12/2020,1189,1062,28,2279
CARROLL,8/13/2020,1197,1076,28,2301
CARROLL,8/14/2020,1207,1088,28,2323
CARROLL,8/15/2020,1214,1098,28,2340
CARROLL,8/16/2020,1220,1104,28,2352
CARROLL,8/17/2020,1232,1121,28,2381
CARROLL,8/18/2020,1244,1127,29,2400
CARROLL,8/19/2020,1260,1142,29,2431
CARROLL,8/20/2020,1271,1147,29,2447
CARROLL,8/21/2020,1287,1156,29,2472
CARROLL,8/22/2020,1297,1160,30,2487
CARROLL,8/23/2020,1300,1164,30,2494
CARROLL,8/24/2020,1309,1173,30,2512
CARROLL,8/25/2020,1321,1182,30,2533
CARROLL,8/26/2020,1332,1192,30,2554
CARROLL,8/27/2020,1338,1203,30,2571
CARROLL,8/28/2020,1343,1211,31,2585
CARROLL,8/29/2020,1350,1216,31,2597
CARROLL,8/30/2020,1353,1222,31,2606
CARROLL,8/31/2020,1365,1230,31,2626
CARROLL,9/1/2020,1368,1239,31,2638
CARROLL,9/2/2020,1377,1250,31,2658
CARROLL,9/3/2020,1388,1257,31,2676
CARROLL,9/4/2020,1392,1265,31,2688
CARROLL,9/5/2020,1398,1272,31,2701
CARROLL,9/6/2020,1403,1276,31,2710
CARROLL,9/7/2020,1410,1283,31,2724
CARROLL,9/8/2020,1420,1288,31,2739
CARROLL,9/9/2020,1428,1299,31,2758
CARROLL,9/10/2020,1436,1305,31,2772
CARROLL,9/11/2020,1448,1313,31,2792
CARROLL,9/12/2020,1451,1315,31,2797
CARROLL,9/13/2020,1456,1318,31,2805
CARROLL,9/14/2020,1464,1326,31,2821
CARROLL,9/15/2020,1469,1333,31,2833
CARROLL,9/16/2020,1470,1337,31,2838
CARROLL,9/17/2020,1473,1343,31,2847
CARROLL,9/18/2020,1490,1346,31,2867
CARROLL,9/19/2020,1497,1351,31,2879
CARROLL,9/20/2020,1501,1356,31,2888
CARROLL,9/21/2020,1510,1365,31,2906
CARROLL,9/22/2020,1519,1369,31,2919
CARROLL,9/23/2020,1523,1375,33,2931
CARROLL,9/24/2020,1529,1380,33,2942
CARROLL,9/25/2020,1537,1385,34,2956
CARROLL,9/26/2020,1539,1390,34,2963
CARROLL,9/27/2020,1540,1392,35,2967
CARROLL,9/28/2020,1545,1402,36,2983
CARROLL,9/29/2020,1554,1405,36,2995
CARROLL,9/30/2020,1563,1408,36,3007
CARROLL,10/1/2020,1572,1412,36,3020
CARROLL,10/2/2020,1583,1419,36,3038
CARROLL,10/3/2020,1585,1422,36,3043
CARROLL,10/4/2020,1591,1425,36,3052
CARROLL,10/5/2020,1601,1434,36,3071
CARROLL,10/6/2020,1604,1438,36,3078
CARROLL,10/7/2020,1614,1446,36,3096
CARROLL,10/8/2020,1627,1453,36,3116
CARROLL,10/9/2020,1630,1462,36,3128
CARROLL,10/10/2020,1638,1467,36,3141
CARROLL,10/11/2020,1640,1471,36,3147
CARROLL,10/12/2020,1647,1476,36,3159
CARROLL,10/13/2020,1651,1482,36,3169
CARROLL,10/14/2020,1658,1489,36,3183
CARROLL,10/15/2020,1659,1490,36,3185
CARROLL,10/16/2020,1662,1494,36,3192
CARROLL,10/17/2020,1663,1495,36,3194
CARROLL,10/18/2020,1663,1495,36,3194
CARROLL,10/19/2020,1663,1495,36,3194
CARROLL,10/20/2020,1663,1495,36,3194
GREENE,1/1/2020,0,0,0,0
GREENE,1/2/2020,0,0,0,0
GREENE,1/3/2020,0,0,0,0
GREENE,1/4/2020,0,0,0,0
GREENE,1/5/2020,0,0,0,0
GREENE,1/6/2020,0,0,0,0
GREENE,1/7/2020,0,0,0,0
GREENE,1/8/2020,0,0,0,0
GREENE,1/9/2020,0,0,0,0
GREENE,1/10/2020,0,0,0,0
GREENE,1/11/2020,0,0,0,0
GREENE,1/12/2020,0,0,0,0
GREENE,1/13/2020,0,0,0,0
GREENE,1/14/2020,0,0,0,0
GREENE,1/15/2020,0,0,0,0
GREENE,1/16/2020,0,0,0,0
GREENE,1/17/2020,0,0,0,0
GREENE,1/18/2020,0,0,0,0
GREENE,1/19/2020,0,0,0,0
GREENE,1/20/2020,0,0,0,0
GREENE,1/21/2020,0,0,0,0
GREENE,1/22/2020,0,0,0,0
GREENE,1/23/2020,0,0,0,0
GREENE,1/24/2020,0,0,0,0
GREENE,1/25/2020,0,0,0,0
GREENE,1/26/2020,0,0,0,0
GREENE,1/27/2020,0,0,0,0
GREENE,1/28/2020,0,0,0,0
GREENE,1/29/2020,0,0,0,0
GREENE,1/30/2020,0,0,0,0
GREENE,1/31/2020,0,0,0,0
GREENE,2/1/2020,0,0,0,0
GREENE,2/2/2020,0,0,0,0
GREENE,2/3/2020,0,0,0,0
GREENE,2/4/2020,0,0,0,0
GREENE,2/5/2020,0,0,0,0
MADISON,1/21/2020,0,0,0,0
MADISON,1/22/2020,0,0,0,0
MADISON,1/23/2020,0,0,0,0
MADISON,1/24/2020,0,0,0,0
MADISON,1/25/2020,0,0,0,0
MADISON,1/26/2020,0,0,0,0
MADISON,1/27/2020,0,0,0,0
MADISON,1/28/2020,0,0,0,0
MADISON,1/29/2020,0,0,0,0
MADISON,1/30/2020,0,0,0,0
MADISON,1/31/2020,0,0,0,0
MADISON,2/1/2020,0,0,0,0
MADISON,2/2/2020,0,0,0,0
MADISON,2/3/2020,0,0,0,0
MADISON,2/4/2020,0,0,0,0
MADISON,2/5/2020,0,0,0,0
MADISON,2/6/2020,0,0,0,0
MADISON,2/7/2020,0,0,0,0
MADISON,2/8/2020,0,0,0,0
MADISON,2/9/2020,0,0,0,0
MADISON,2/10/2020,0,0,0,0
MADISON,2/11/2020,0,0,0,0
MADISON,2/12/2020,0,0,0,0
MADISON,2/13/2020,0,0,0,0
MADISON,2/14/2020,0,0,0,0
MADISON,2/15/2020,0,0,0,0
MADISON,2/16/2020,0,0,0,0
MADISON,2/17/2020,0,0,0,0
MADISON,2/18/2020,0,0,0,0
MADISON,2/19/2020,0,0,0,0
MADISON,2/20/2020,0,0,0,0
MADISON,2/21/2020,0,0,0,0
MADISON,2/22/2020,0,0,0,0
MADISON,2/23/2020,0,0,0,0
MADISON,2/24/2020,0,0,0,0
MADISON,2/25/2020,0,0,0,0
MADISON,2/26/2020,0,0,0,0
MADISON,2/27/2020,0,0,0,0
MADISON,2/28/2020,0,0,0,0
MADISON,2/29/2020,0,0,0,0
MADISON,3/1/2020,0,0,0,0
MADISON,3/2/2020,0,0,0,0
MADISON,3/3/2020,0,0,0,0
MADISON,3/4/2020,0,0,0,0
MADISON,3/5/2020,0,0,0,0
MADISON,3/6/2020,0,0,0,0
MADISON,3/7/2020,0,0,0,0
MADISON,3/8/2020,0,0,0,0
MADISON,3/9/2020,0,0,0,0
MADISON,3/10/2020,0,0,0,0
MADISON,3/11/2020,0,1,0,1
MADISON,3/12/2020,0,1,0,1
MADISON,3/13/2020,1,1,0,2
MADISON,3/14/2020,1,1,0,2
MADISON,3/15/2020,1,1,0,2
MADISON,3/16/2020,1,1,0,2
MADISON,3/17/2020,1,1,0,2
MADISON,3/18/2020,1,1,0,2
MADISON,3/19/2020,1,1,0,2
MADISON,3/20/2020,1,2,0,3
MADISON,3/21/2020,1,2,0,3
MADISON,3/22/2020,1,2,0,3
MADISON,3/23/2020,1,2,0,3
MADISON,3/24/2020,1,2,0,3
MADISON,3/25/2020,2,2,0,4
MADISON,3/26/2020,3,2,0,5
MADISON,3/27/2020,4,2,0,6
MADISON,3/28/2020,4,2,0,6
MADISON,3/29/2020,4,2,0,6
MADISON,3/30/2020,4,3,0,7
MADISON,3/31/2020,6,3,0,9
MADISON,4/1/2020,6,3,0,9
MADISON,4/2/2020,6,4,0,10
MADISON,4/3/2020,7,4,0,11
MADISON,4/4/2020,7,5,0,12
MADISON,4/5/2020,7,5,0,12
MADISON,4/6/2020,9,5,0,14
MADISON,4/7/2020,9,6,0,15
MADISON,4/8/2020,9,6,0,15
MADISON,4/9/2020,9,6,0,15
MADISON,4/10/2020,10,7,0,17
MADISON,4/11/2020,10,7,0,17
MADISON,4/12/2020,10,7,0,17
MADISON,4/13/2020,11,7,0,18
MADISON,4/14/2020,12,7,0,19
MADISON,4/15/2020,13,7,0,20
MADISON,4/16/2020,13,9,0,22
MADISON,4/17/2020,14,9,0,23
MADISON,4/18/2020,14,9,0,23
MADISON,4/19/2020,14,9,0,23
MADISON,4/20/2020,17,9,0,26
MADISON,4/21/2020,17,10,0,27
MADISON,4/22/2020,17,10,0,27
MADISON,4/23/2020,17,10,0,27
MADISON,4/24/2020,17,10,0,27
MADISON,4/25/2020,17,10,0,27
MADISON,4/26/2020,17,10,0,27
MADISON,4/27/2020,19,10,0,29
MADISON,4/28/2020,19,10,0,29
MADISON,4/29/2020,19,11,0,30
MADISON,4/30/2020,19,11,0,30
MADISON,5/1/2020,20,11,0,31
MADISON,5/2/2020,20,11,0,31
MADISON,5/3/2020,20,11,0,31
MADISON,5/4/2020,20,11,0,31
MADISON,5/5/2020,20,11,0,31
MADISON,5/6/2020,20,11,0,31
MADISON,5/7/2020,20,11,0,31
MADISON,5/8/2020,21,11,0,32
MADISON,5/9/2020,22,11,0,33
MADISON,5/10/2020,22,11,0,33
MADISON,5/11/2020,22,11,0,33
MADISON,5/12/2020,22,12,0,34
MADISON,5/13/2020,22,12,0,34
MADISON,5/14/2020,25,12,0,37
MADISON,5/15/2020,27,12,0,39
MADISON,5/16/2020,27,12,0,39
MADISON,5/17/2020,29,12,0,41
MADISON,5/18/2020,30,12,0,42
MADISON,5/19/2020,31,15,0,46
MADISON,5/20/2020,31,15,0,46
MADISON,5/21/2020,32,16,0,48
MADISON,5/22/2020,34,18,0,52
MADISON,5/23/2020,35,18,0,53
MADISON,5/24/2020,35,18,0,53
MADISON,5/25/2020,35,18,0,53
MADISON,5/26/2020,35,21,0,56
MADISON,5/27/2020,36,21,0,57
MADISON,5/28/2020,37,22,1,60
MADISON,5/29/2020,37,22,1,60
MADISON,5/30/2020,37,23,1,61
MADISON,5/31/2020,39,25,1,65
MADISON,6/1/2020,41,26,1,68
MADISON,6/2/2020,41,27,1,69
MADISON,6/3/2020,41,28,1,70
MADISON,6/4/2020,42,28,1,71
MADISON,6/5/2020,42,29,1,72
MADISON,6/6/2020,42,29,1,72
MADISON,6/7/2020,42,29,1,72
MADISON,6/8/2020,43,31,1,75
MADISON,6/9/2020,46,31,1,78
MADISON,6/10/2020,46,31,1,78
MADISON,6/11/2020,46,31,1,78
MADISON,6/12/2020,47,32,1,80
MADISON,6/13/2020,47,32,1,80
MADISON,6/14/2020,47,32,1,80
MADISON,6/15/2020,48,32,1,81
MADISON,6/16/2020,50,32,1,83
MADISON,6/17/2020,52,35,1,88
MADISON,6/18/2020,52,35,1,88
MADISON,6/19/2020,52,35,1,88
MADISON,6/20/2020,53,35,1,89
MADISON,6/21/2020,54,35,1,90
MADISON,6/22/2020,59,35,1,95
MADISON,6/23/2020,62,35,1,98
MADISON,6/24/2020,64,39,1,104
MADISON,6/25/2020,65,41,1,107
MADISON,6/26/2020,68,47,1,116
MADISON,6/27/2020,70,48,1,119
MADISON,6/28/2020,74,50,1,125
MADISON,6/29/2020,78,51,1,130
MADISON,6/30/2020,81,56,1,138
MADISON,7/1/2020,87,61,1,149
MADISON,7/2/2020,93,62,1,156
MADISON,7/3/2020,96,64,1,161
MADISON,7/4/2020,99,67,1,167
MADISON,7/5/2020,103,71,1,175
MADISON,7/6/2020,111,76,1,188
MADISON,7/7/2020,115,81,1,197
MADISON,7/8/2020,120,82,1,203
MADISON,7/9/2020,125,90,1,216
MADISON,7/10/2020,126,93,1,220
MADISON,7/11/2020,132,97,1,230
MADISON,7/12/2020,133,98,1,232
MADISON,7/13/2020,141,101,1,243
MADISON,7/14/2020,147,109,1,257
MADISON,7/15/2020,155,111,2,268
MADISON,7/16/2020,159,115,2,276
MADISON,7/17/2020,163,115,2,280
MADISON,7/18/2020,165,116,2,283
MADISON,7/19/2020,168,118,2,288
MADISON,7/20/2020,177,127,2,306
MADISON,7/21/2020,180,131,3,314
MADISON,7/22/2020,183,137,3,323
MADISON,7/23/2020,187,142,3,332
MADISON,7/24/2020,194,144,3,341
MADISON,7/25/2020,202,149,3,354
MADISON,7/26/2020,206,150,3,359
MADISON,7/27/2020,209,156,3,368
MADISON,7/28/2020,212,158,3,373
MADISON,7/29/2020,215,162,3,380
MADISON,7/30/2020,218,164,3,385
MADISON,7/31/2020,225,169,3,397
MADISON,8/1/2020,228,170,3,401
MADISON,8/2/2020,229,172,3,404
MADISON,8/3/2020,233,174,5,412
MADISON,8/4/2020,239,179,5,423
MADISON,8/5/2020,240,183,5,428
MADISON,8/6/2020,241,185,6,432
MADISON,8/7/2020,246,188,6,440
MADISON,8/8/2020,250,190,6,446
MADISON,8/9/2020,252,192,6,450
MADISON,8/10/2020,256,198,6,460
MADISON,8/11/2020,258,199,6,463
MADISON,8/12/2020,262,204,6,472
MADISON,8/13/2020,262,210,6,478
MADISON,8/14/2020,264,215,6,485
MADISON,8/15/2020,265,218,6,489
MADISON,8/16/2020,267,221,6,494
MADISON,8/17/2020,270,223,6,499
MADISON,8/18/2020,272,226,6,504
MADISON,8/19/2020,276,228,6,510
MADISON,8/20/2020,279,231,6,516
MADISON,8/21/2020,280,235,6,521
MADISON,8/22/2020,281,240,6,527
MADISON,8/23/2020,282,240,6,528
MADISON,8/24/2020,287,242,6,535
MADISON,8/25/2020,290,246,6,542
MADISON,8/26/2020,295,246,6,547
MADISON,8/27/2020,302,249,6,557
MADISON,8/28/2020,304,251,6,561
MADISON,8/29/2020,304,253,6,563
MADISON,8/30/2020,304,254,6,564
MADISON,8/31/2020,308,257,6,571
MADISON,9/1/2020,310,261,6,577
MADISON,9/2/2020,318,263,6,587
MADISON,9/3/2020,322,274,6,602
MADISON,9/4/2020,323,279,6,608
MADISON,9/5/2020,326,281,6,613
MADISON,9/6/2020,327,281,6,614
MADISON,9/7/2020,328,281,6,615
MADISON,9/8/2020,333,285,6,624
MADISON,9/9/2020,340,290,6,636
MADISON,9/10/2020,342,291,6,639
MADISON,9/11/2020,343,296,7,646
MADISON,9/12/2020,344,302,7,653
MADISON,9/13/2020,346,309,7,662
MADISON,9/14/2020,347,312,7,666
MADISON,9/15/2020,350,314,7,671
MADISON,9/16/2020,352,318,7,677
MADISON,9/17/2020,354,322,7,683
MADISON,9/18/2020,357,323,7,687
MADISON,9/19/2020,358,324,7,689
MADISON,9/20/2020,360,324,7,691
MADISON,9/21/2020,360,327,7,694
MADISON,9/22/2020,361,328,7,696
MADISON,9/23/2020,365,329,7,701
MADISON,9/24/2020,370,330,7,707
MADISON,9/25/2020,375,331,8,714
MADISON,9/26/2020,376,332,8,716
MADISON,9/27/2020,376,333,8,717
MADISON,9/28/2020,378,334,9,721
MADISON,9/29/2020,379,336,9,724
MADISON,9/30/2020,379,337,9,725
MADISON,10/1/2020,381,337,9,727
MADISON,10/2/2020,384,339,9,732
MADISON,10/3/2020,384,340,9,733
MADISON,10/4/2020,384,340,9,733
MADISON,10/5/2020,384,342,9,735
MADISON,10/6/2020,385,343,9,737
MADISON,10/7/2020,386,345,9,740
MADISON,10/8/2020,389,345,9,743
MADISON,10/9/2020,390,346,9,745
MADISON,10/10/2020,391,346,9,746
MADISON,10/11/2020,394,346,9,749
MADISON,10/12/2020,394,347,9,750
MADISON,10/13/2020,395,349,9,753
MADISON,10/14/2020,396,350,9,755
MADISON,10/15/2020,396,350,9,755
MADISON,10/16/2020,396,352,9,757
MADISON,10/17/2020,396,352,9,757
MADISON,10/18/2020,396,352,9,757
MADISON,10/19/2020,396,352,9,757
MADISON,10/20/2020,396,352,9,757
COOK,1/1/2020,0,0,0,0
COOK,1/2/2020,0,0,0,0
COOK,1/3/2020,0,0,0,0
COOK,1/4/2020,0,0,0,0
COOK,1/5/2020,0,0,0,0
COOK,1/6/2020,0,0,0,0
COOK,1/7/2020,0,0,0,0
COOK,1/8/2020,0,0,0,0
COOK,1/9/2020,0,0,0,0
COOK,1/10/2020,0,0,0,0
COOK,1/11/2020,0,0,0,0
COOK,1/12/2020,0,0,0,0
COOK,1/13/2020,0,0,0,0
COOK,1/14/2020,0,0,0,0
COOK,1/15/2020,0,0,0,0
COOK,1/16/2020,0,0,0,0
COOK,1/17/2020,0,0,0,0
COOK,1/18/2020,0,0,0,0
COOK,1/19/2020,0,0,0,0
COOK,1/20/2020,0,0,0,0
COOK,1/21/2020,0,0,0,0
COOK,1/22/2020,0,0,0,0
COOK,1/23/2020,0,0,0,0
COOK,1/24/2020,0,0,0,0
COOK,1/25/2020,0,0,0,0
COOK,1/26/2020,0,0,0,0
COOK,1/27/2020,0,0,0,0
COOK,1/28/2020,0,0,0,0
COOK,1/29/2020,0,0,0,0
COOK,1/30/2020,0,0,0,0
COOK,1/31/2020,0,0,0,0
COOK,2/1/2020,0,0,0,0
COOK,2/2/2020,0,0,0,0
COOK,2/3/2020,0,0,0,0
COOK,2/4/2020,0,0,0,0
COOK,2/5/2020,0,0,0,0
COOK,2/6/2020,0,0,0,0
COOK,2/7/2020,0,0,0,0
COOK,2/8/2020,0,0,0,0
COOK,2/9/2020,0,0,0,0
COOK,2/10/2020,0,0,0,0
COOK,2/11/2020,0,0,0,0
COOK,2/12/2020,0,0,0,0
COOK,2/13/2020,0,0,0,0
COOK,2/14/2020,0,0,0,0
COOK,2/15/2020,0,0,0,0
COOK,2/16/2020,0,0,0,0
COOK,2/17/2020,0,0,0,0
COOK,2/18/2020,0,0,0,0
COOK,2/19/2020,0,0,0,0
COOK,2/20/2020,0,0,0,0
COOK,2/21/2020,0,0,0,0
COOK,2/22/2020,0,0,0,0
COOK,2/23/2020,0,0,0,0
COOK,2/24/2020,0,0,0,0
COOK,2/25/2020,0,0,0,0
COOK,2/26/2020,0,0,0,0
COOK,2/27/2020,0,0,0,0
COOK,2/28/2020,0,0,0,0
COOK,2/29/2020,0,0,0,0
COOK,3/1/2020,0,0,0,0
COOK,3/2/2020,0,0,0,0
COOK,3/3/2020,0,0,0,0
COOK,3/4/2020,0,0,0,0
COOK,3/5/2020,0,0,0,0
COOK,3/6/2020,0,0,0,0
COOK,3/7/2020,0,0,0,0
COOK,3/8/2020,0,0,0,0
COOK,3/9/2020,0,0,0,0
COOK,3/10/2020,0,0,0,0
COOK,3/11/2020,0,0,0,0
COOK,3/12/2020,0,0,0,0
COOK,3/13/2020,0,0,0,0
COOK,3/14/2020,0,0,0,0
COOK,3/15/2020,0,0,0,0
COOK,3/16/2020,0,0,0,0
COOK,3/17/2020,0,0,0,0
COOK,3/18/2020,0,0,0,0
COOK,3/19/2020,0,0,0,0
COOK,3/20/2020,0,0,0,0
COOK,3/21/2020,0,0,0,0
COOK,3/22/2020,0,0,0,0
COOK,3/23/2020,0,0,0,0
COOK,3/24/2020,0,0,0,0
COOK,3/25/2020,0,0,0,0
COOK,3/26/2020,1,0,0,1
COOK,3/27/2020,1,0,0,1
COOK,3/28/2020,1,0,0,1
COOK,3/29/2020,1,0,0,1
COOK,3/30/2020,2,0,0,2
COOK,3/31/2020,2,0,0,2
COOK,4/1/2020,2,0,0,2
COOK,4/2/2020,2,1,0,3
COOK,4/3/2020,3,1,0,4
COOK,4/4/2020,3,1,0,4
COOK,4/5/2020,3,1,0,4
COOK,4/6/2020,3,1,0,4
COOK,4/7/2020,4,1,0,5
COOK,4/8/2020,6,1,0,7
COOK,4/9/2020,6,1,0,7
COOK,4/10/2020,8,2,0,10
COOK,4/11/2020,8,2,0,10
COOK,4/12/2020,9,2,0,11
COOK,4/13/2020,10,2,0,12
COOK,4/14/2020,10,2,0,12
COOK,4/15/2020,10,2,0,12
COOK,4/16/2020,10,4,0,14
COOK,4/17/2020,10,4,0,14
COOK,4/18/2020,10,6,0,16
COOK,4/19/2020,11,6,0,17
COOK,4/20/2020,11,6,0,17
COOK,4/21/2020,11,7,0,18
COOK,4/22/2020,11,8,0,19
COOK,4/23/2020,12,8,0,20
COOK,4/24/2020,12,8,0,20
COOK,4/25/2020,13,9,0,22
COOK,4/26/2020,13,9,0,22
COOK,4/27/2020,13,9,0,22
HANCOCK,3/1/2020,0,0,0,0
WILKINSON,3/25/2020,1,3,0,4
HANCOCK,3/2/2020,0,0,0,0
PIKE,6/15/2020,38,48,0,86
WILKINSON,3/26/2020,1,4,0,5
HANCOCK,3/3/2020,0,0,0,0
PIKE,6/16/2020,38,48,0,86
PIKE,6/17/2020,38,49,0,87
PIKE,6/18/2020,39,51,0,90
PIKE,6/19/2020,40,51,0,91
PIKE,6/20/2020,40,51,0,91
PIKE,6/21/2020,40,51,0,91
PIKE,6/22/2020,41,54,0,95
PIKE,6/23/2020,41,54,0,95
PIKE,6/24/2020,42,54,0,96
PIKE,6/25/2020,45,54,0,99
PIKE,6/26/2020,46,54,0,100
PIKE,6/27/2020,46,55,0,101
PIKE,6/28/2020,46,57,0,103
PIKE,6/29/2020,48,57,0,105
PIKE,6/30/2020,49,58,0,107
PIKE,7/1/2020,51,61,1,113
PIKE,7/2/2020,54,61,1,116
PIKE,7/3/2020,55,61,1,117
PIKE,7/4/2020,56,62,1,119
PIKE,7/5/2020,56,63,1,120
PIKE,7/6/2020,60,64,1,125
PIKE,7/7/2020,63,64,1,128
PIKE,7/8/2020,64,66,1,131
PIKE,7/9/2020,69,67,1,137
PIKE,7/10/2020,70,69,1,140
PIKE,7/11/2020,71,71,1,143
PIKE,7/12/2020,73,72,1,146
PIKE,7/13/2020,75,72,1,148
PIKE,7/14/2020,78,72,1,151
PIKE,7/15/2020,80,76,1,157
PIKE,7/16/2020,81,79,1,161
PIKE,7/17/2020,82,82,1,165
PIKE,7/18/2020,82,84,1,167
PIKE,7/19/2020,83,84,1,168
PIKE,7/20/2020,90,84,1,175
PIKE,7/21/2020,91,87,1,179
PIKE,7/22/2020,92,89,1,182
PIKE,7/23/2020,96,95,1,192
PIKE,7/24/2020,99,95,1,195
PIKE,7/25/2020,100,96,1,197
PIKE,7/26/2020,101,98,1,200
PIKE,7/27/2020,103,100,1,204
PIKE,7/28/2020,104,100,1,205
PIKE,7/29/2020,105,100,1,206
PIKE,7/30/2020,106,103,1,210
PIKE,7/31/2020,106,103,1,210
PIKE,8/1/2020,108,103,1,212
PIKE,8/2/2020,110,103,1,214
PIKE,8/3/2020,113,108,1,222
PIKE,8/4/2020,116,110,1,227
PIKE,8/5/2020,119,112,2,233
PIKE,8/6/2020,122,113,2,237
PIKE,8/7/2020,125,115,2,242
PIKE,8/8/2020,128,117,2,247
PIKE,8/9/2020,129,117,2,248
PIKE,8/10/2020,129,120,2,251
PIKE,8/11/2020,130,122,2,254
PIKE,8/12/2020,130,124,2,256
PIKE,8/13/2020,132,124,2,258
PIKE,8/14/2020,136,126,2,264
PIKE,8/15/2020,138,127,2,267
PIKE,8/16/2020,141,128,2,271
PIKE,8/17/2020,143,129,2,274
PIKE,8/18/2020,145,129,2,276
PIKE,8/19/2020,145,129,2,276
PIKE,8/20/2020,146,129,2,277
PIKE,8/21/2020,147,129,2,278
PIKE,8/22/2020,150,129,2,281
PIKE,8/23/2020,151,130,2,283
PIKE,8/24/2020,151,131,2,284
PIKE,8/25/2020,151,133,2,286
PIKE,8/26/2020,152,133,2,287
PIKE,8/27/2020,152,135,2,289
PIKE,8/28/2020,153,137,2,292
PIKE,8/29/2020,153,138,2,293
PIKE,8/30/2020,154,139,2,295
PIKE,8/31/2020,156,141,2,299
PIKE,9/1/2020,156,141,2,299
PIKE,9/2/2020,157,141,2,300
PIKE,9/3/2020,158,142,2,302
PIKE,9/4/2020,159,142,2,303
PIKE,9/5/2020,160,142,2,304
PIKE,9/6/2020,161,142,2,305
PIKE,9/7/2020,162,142,2,306
PIKE,9/8/2020,164,143,2,309
PIKE,9/9/2020,166,143,2,311
PIKE,9/10/2020,168,143,2,313
PIKE,9/11/2020,171,143,2,316
PIKE,9/12/2020,173,144,2,319
PIKE,9/13/2020,173,144,2,319
PIKE,9/14/2020,173,146,2,321
PIKE,9/15/2020,174,147,3,324
PIKE,9/16/2020,176,149,3,328
PIKE,9/17/2020,176,150,3,329
PIKE,9/18/2020,177,152,3,332
PIKE,9/19/2020,177,152,3,332
PIKE,9/20/2020,179,153,3,335
PIKE,9/21/2020,180,155,3,338
PIKE,9/22/2020,181,156,3,340
PIKE,9/23/2020,181,157,3,341
PIKE,9/24/2020,182,157,3,342
PIKE,9/25/2020,183,158,3,344
PIKE,9/26/2020,184,158,3,345
PIKE,9/27/2020,185,158,3,346
PIKE,9/28/2020,191,160,3,354
PIKE,9/29/2020,191,160,3,354
PIKE,9/30/2020,193,160,3,356
PIKE,10/1/2020,194,161,3,358
PIKE,10/2/2020,194,161,3,358
PIKE,10/3/2020,195,163,3,361
PIKE,10/4/2020,195,165,3,363
PIKE,10/5/2020,196,165,3,364
PIKE,10/6/2020,198,165,3,366
PIKE,10/7/2020,199,165,3,367
PIKE,10/8/2020,199,166,3,368
PIKE,10/9/2020,199,168,3,370
PIKE,10/10/2020,199,168,3,370
PIKE,10/11/2020,199,168,3,370
PIKE,10/12/2020,200,170,3,373
PIKE,10/13/2020,200,171,3,374
PIKE,10/14/2020,200,171,3,374
PIKE,10/15/2020,201,172,4,377
PIKE,10/16/2020,201,172,4,377
PIKE,10/17/2020,201,172,4,377
PIKE,10/18/2020,201,172,4,377
PIKE,10/19/2020,201,172,4,377
PIKE,10/20/2020,201,172,4,377
QUITMAN,1/1/2020,0,0,0,0
QUITMAN,1/2/2020,0,0,0,0
QUITMAN,1/3/2020,0,0,0,0
QUITMAN,1/4/2020,0,0,0,0
QUITMAN,1/5/2020,0,0,0,0
QUITMAN,1/6/2020,0,0,0,0
QUITMAN,1/7/2020,0,0,0,0
QUITMAN,1/8/2020,0,0,0,0
QUITMAN,1/9/2020,0,0,0,0
QUITMAN,1/10/2020,0,0,0,0
QUITMAN,1/11/2020,0,0,0,0
QUITMAN,1/12/2020,0,0,0,0
QUITMAN,1/13/2020,0,0,0,0
QUITMAN,1/14/2020,0,0,0,0
QUITMAN,1/15/2020,0,0,0,0
QUITMAN,1/16/2020,0,0,0,0
QUITMAN,1/17/2020,0,0,0,0
QUITMAN,1/18/2020,0,0,0,0
QUITMAN,1/19/2020,0,0,0,0
QUITMAN,1/20/2020,0,0,0,0
QUITMAN,1/21/2020,0,0,0,0
QUITMAN,1/22/2020,0,0,0,0
QUITMAN,1/23/2020,0,0,0,0
QUITMAN,1/24/2020,0,0,0,0
QUITMAN,1/25/2020,0,0,0,0
QUITMAN,1/26/2020,0,0,0,0
QUITMAN,1/27/2020,0,0,0,0
QUITMAN,1/28/2020,0,0,0,0
QUITMAN,1/29/2020,0,0,0,0
QUITMAN,1/30/2020,0,0,0,0
QUITMAN,1/31/2020,0,0,0,0
QUITMAN,2/1/2020,0,0,0,0
QUITMAN,2/2/2020,0,0,0,0
QUITMAN,2/3/2020,0,0,0,0
QUITMAN,2/4/2020,0,0,0,0
QUITMAN,2/5/2020,0,0,0,0
QUITMAN,2/6/2020,0,0,0,0
QUITMAN,2/7/2020,0,0,0,0
QUITMAN,2/8/2020,0,0,0,0
QUITMAN,2/9/2020,0,0,0,0
QUITMAN,2/10/2020,0,0,0,0
QUITMAN,2/11/2020,0,0,0,0
QUITMAN,2/12/2020,0,0,0,0
QUITMAN,2/13/2020,0,0,0,0
QUITMAN,2/14/2020,0,0,0,0
QUITMAN,2/15/2020,0,0,0,0
QUITMAN,2/16/2020,0,0,0,0
QUITMAN,2/17/2020,0,0,0,0
QUITMAN,2/18/2020,0,0,0,0
QUITMAN,2/19/2020,0,0,0,0
QUITMAN,2/20/2020,0,0,0,0
QUITMAN,2/21/2020,0,0,0,0
QUITMAN,2/22/2020,0,0,0,0
QUITMAN,2/23/2020,0,0,0,0
QUITMAN,2/24/2020,0,0,0,0
QUITMAN,2/25/2020,0,0,0,0
QUITMAN,2/26/2020,0,0,0,0
QUITMAN,2/27/2020,0,0,0,0
QUITMAN,2/28/2020,0,0,0,0
QUITMAN,2/29/2020,0,0,0,0
QUITMAN,3/1/2020,0,0,0,0
QUITMAN,3/2/2020,0,0,0,0
QUITMAN,3/3/2020,0,0,0,0
QUITMAN,3/4/2020,0,0,0,0
QUITMAN,3/5/2020,0,0,0,0
QUITMAN,3/6/2020,1,0,0,1
QUITMAN,3/7/2020,1,0,0,1
QUITMAN,3/8/2020,1,0,0,1
QUITMAN,3/9/2020,1,0,0,1
QUITMAN,3/10/2020,1,0,0,1
QUITMAN,3/11/2020,1,0,0,1
QUITMAN,3/12/2020,1,0,0,1
QUITMAN,3/13/2020,1,0,0,1
QUITMAN,3/14/2020,1,0,0,1
QUITMAN,3/15/2020,1,0,0,1
QUITMAN,3/16/2020,1,0,0,1
QUITMAN,3/17/2020,1,0,0,1
QUITMAN,3/18/2020,1,0,0,1
QUITMAN,3/19/2020,1,0,0,1
QUITMAN,3/20/2020,1,0,0,1
QUITMAN,3/21/2020,1,0,0,1
QUITMAN,3/22/2020,1,0,0,1
QUITMAN,3/23/2020,1,0,0,1
QUITMAN,3/24/2020,1,0,0,1
QUITMAN,3/25/2020,1,0,0,1
QUITMAN,3/26/2020,1,0,0,1
QUITMAN,3/27/2020,1,0,0,1
QUITMAN,3/28/2020,1,0,0,1
QUITMAN,3/29/2020,1,0,0,1
QUITMAN,3/30/2020,1,0,0,1
QUITMAN,3/31/2020,1,0,0,1
QUITMAN,4/1/2020,1,0,0,1
QUITMAN,4/2/2020,1,0,0,1
QUITMAN,4/3/2020,1,0,0,1
QUITMAN,4/4/2020,2,1,0,3
QUITMAN,4/5/2020,2,1,0,3
QUITMAN,4/6/2020,3,1,0,4
QUITMAN,4/7/2020,3,1,0,4
QUITMAN,4/8/2020,3,1,0,4
QUITMAN,4/9/2020,3,1,0,4
QUITMAN,4/10/2020,3,1,0,4
QUITMAN,4/11/2020,3,1,0,4
QUITMAN,4/12/2020,3,1,0,4
QUITMAN,4/13/2020,3,1,0,4
QUITMAN,4/14/2020,3,1,0,4
QUITMAN,4/15/2020,4,1,0,5
QUITMAN,4/16/2020,4,1,0,5
QUITMAN,4/17/2020,4,1,0,5
QUITMAN,4/18/2020,4,1,0,5
QUITMAN,4/19/2020,4,1,0,5
QUITMAN,4/20/2020,4,1,0,5
QUITMAN,4/21/2020,4,1,0,5
QUITMAN,4/22/2020,5,1,0,6
QUITMAN,4/23/2020,5,1,1,7
QUITMAN,4/24/2020,5,1,1,7
QUITMAN,4/25/2020,5,1,1,7
QUITMAN,4/26/2020,5,1,1,7
QUITMAN,4/27/2020,5,1,1,7
QUITMAN,4/28/2020,5,1,1,7
QUITMAN,4/29/2020,5,1,1,7
QUITMAN,4/30/2020,6,1,1,8
QUITMAN,5/1/2020,6,1,1,8
QUITMAN,5/2/2020,6,1,1,8
QUITMAN,5/3/2020,6,1,1,8
QUITMAN,5/4/2020,6,1,1,8
QUITMAN,5/5/2020,6,1,1,8
QUITMAN,5/6/2020,7,1,1,9
QUITMAN,5/7/2020,7,1,1,9
QUITMAN,5/8/2020,7,1,1,9
QUITMAN,5/9/2020,7,1,1,9
QUITMAN,5/10/2020,7,1,1,9
QUITMAN,5/11/2020,7,1,1,9
QUITMAN,5/12/2020,8,2,1,11
QUITMAN,5/13/2020,8,2,1,11
QUITMAN,5/14/2020,8,2,1,11
QUITMAN,5/15/2020,8,2,1,11
QUITMAN,5/16/2020,8,2,1,11
QUITMAN,5/17/2020,8,2,1,11
QUITMAN,5/18/2020,9,2,1,12
QUITMAN,5/19/2020,9,2,1,12
QUITMAN,5/20/2020,9,2,1,12
QUITMAN,5/21/2020,9,2,1,12
QUITMAN,5/22/2020,9,2,1,12
QUITMAN,5/23/2020,9,2,1,12
QUITMAN,5/24/2020,9,2,1,12
QUITMAN,5/25/2020,9,2,1,12
QUITMAN,5/26/2020,9,3,1,13
QUITMAN,5/27/2020,9,3,1,13
QUITMAN,5/28/2020,9,3,1,13
QUITMAN,5/29/2020,10,3,1,14
QUITMAN,5/30/2020,10,3,1,14
QUITMAN,5/31/2020,10,3,1,14
QUITMAN,6/1/2020,10,3,1,14
QUITMAN,6/2/2020,10,3,1,14
QUITMAN,6/3/2020,10,3,1,14
QUITMAN,6/4/2020,10,3,1,14
QUITMAN,6/5/2020,10,3,1,14
QUITMAN,6/6/2020,10,3,1,14
QUITMAN,6/7/2020,10,3,1,14
QUITMAN,6/8/2020,10,3,1,14
QUITMAN,6/9/2020,10,3,1,14
QUITMAN,6/10/2020,10,3,1,14
QUITMAN,6/11/2020,10,3,1,14
QUITMAN,6/12/2020,10,3,1,14
QUITMAN,6/13/2020,10,3,1,14
QUITMAN,6/14/2020,10,3,1,14
QUITMAN,6/15/2020,10,3,1,14
QUITMAN,6/16/2020,10,3,1,14
QUITMAN,6/17/2020,11,3,1,15
QUITMAN,6/18/2020,11,3,1,15
QUITMAN,6/19/2020,11,3,1,15
QUITMAN,6/20/2020,11,3,1,15
QUITMAN,6/21/2020,11,3,1,15
QUITMAN,6/22/2020,11,3,1,15
QUITMAN,6/23/2020,12,3,1,16
QUITMAN,6/24/2020,12,3,1,16
QUITMAN,6/25/2020,12,4,1,17
QUITMAN,6/26/2020,13,5,1,19
QUITMAN,6/27/2020,13,5,1,19
QUITMAN,6/28/2020,13,5,1,19
QUITMAN,6/29/2020,13,5,1,19
QUITMAN,6/30/2020,13,5,1,19
QUITMAN,7/1/2020,15,5,1,21
QUITMAN,7/2/2020,15,5,1,21
QUITMAN,7/3/2020,15,5,1,21
QUITMAN,7/4/2020,16,5,1,22
QUITMAN,7/5/2020,17,5,1,23
QUITMAN,7/6/2020,18,5,1,24
QUITMAN,7/7/2020,19,5,1,25
QUITMAN,7/8/2020,20,5,1,26
QUITMAN,7/9/2020,20,5,1,26
QUITMAN,7/10/2020,20,5,1,26
QUITMAN,7/11/2020,20,6,1,27
QUITMAN,7/12/2020,20,6,1,27
QUITMAN,7/13/2020,20,7,1,28
QUITMAN,7/14/2020,20,7,1,28
QUITMAN,7/15/2020,20,7,1,28
QUITMAN,7/16/2020,20,7,1,28
QUITMAN,7/17/2020,20,7,2,29
QUITMAN,7/18/2020,20,7,2,29
QUITMAN,7/19/2020,20,7,2,29
QUITMAN,7/20/2020,21,7,2,30
QUITMAN,7/21/2020,21,7,2,30
QUITMAN,7/22/2020,21,7,2,30
QUITMAN,7/23/2020,22,8,2,32
QUITMAN,7/24/2020,22,8,2,32
QUITMAN,7/25/2020,22,8,2,32
QUITMAN,7/26/2020,22,8,2,32
QUITMAN,7/27/2020,22,8,2,32
QUITMAN,7/28/2020,22,8,2,32
QUITMAN,7/29/2020,22,8,2,32
QUITMAN,7/30/2020,22,8,2,32
QUITMAN,7/31/2020,22,8,2,32
QUITMAN,8/1/2020,22,8,2,32
QUITMAN,8/2/2020,22,8,2,32
QUITMAN,8/3/2020,22,8,2,32
QUITMAN,8/4/2020,22,8,2,32
QUITMAN,8/5/2020,22,8,2,32
QUITMAN,8/6/2020,22,8,2,32
QUITMAN,8/7/2020,22,8,2,32
QUITMAN,8/8/2020,22,8,2,32
QUITMAN,8/9/2020,22,8,2,32
QUITMAN,8/10/2020,22,8,2,32
QUITMAN,8/11/2020,22,8,2,32
QUITMAN,8/12/2020,22,8,2,32
QUITMAN,8/13/2020,22,8,2,32
QUITMAN,8/14/2020,22,8,2,32
QUITMAN,8/15/2020,22,8,2,32
QUITMAN,8/16/2020,22,8,2,32
QUITMAN,8/17/2020,22,8,2,32
QUITMAN,8/18/2020,22,8,2,32
QUITMAN,8/19/2020,22,8,2,32
QUITMAN,8/20/2020,22,8,2,32
QUITMAN,8/21/2020,22,8,2,32
QUITMAN,8/22/2020,22,8,2,32
QUITMAN,8/23/2020,22,8,2,32
QUITMAN,8/24/2020,22,8,2,32
QUITMAN,8/25/2020,22,8,2,32
QUITMAN,8/26/2020,22,8,2,32
QUITMAN,8/27/2020,22,8,2,32
QUITMAN,8/28/2020,22,8,2,32
QUITMAN,8/29/2020,22,8,2,32
QUITMAN,8/30/2020,22,8,2,32
QUITMAN,8/31/2020,22,8,2,32
QUITMAN,9/1/2020,22,8,2,32
QUITMAN,9/2/2020,22,8,2,32
QUITMAN,9/3/2020,22,8,2,32
QUITMAN,9/4/2020,22,8,2,32
QUITMAN,9/5/2020,22,8,2,32
QUITMAN,9/6/2020,22,8,2,32
QUITMAN,9/7/2020,22,8,2,32
QUITMAN,9/8/2020,22,8,2,32
QUITMAN,9/9/2020,22,8,2,32
QUITMAN,9/10/2020,22,8,2,32
QUITMAN,9/11/2020,22,8,2,32
QUITMAN,9/12/2020,22,8,2,32
QUITMAN,9/13/2020,22,8,2,32
QUITMAN,9/14/2020,22,8,2,32
QUITMAN,9/15/2020,22,8,2,32
QUITMAN,9/16/2020,22,8,2,32
QUITMAN,9/17/2020,23,8,2,33
QUITMAN,9/18/2020,23,8,2,33
QUITMAN,9/19/2020,23,8,2,33
QUITMAN,9/20/2020,23,8,2,33
QUITMAN,9/21/2020,23,9,2,34
QUITMAN,9/22/2020,23,9,2,34
QUITMAN,9/23/2020,23,9,2,34
QUITMAN,9/24/2020,23,9,2,34
QUITMAN,9/25/2020,24,9,2,35
QUITMAN,9/26/2020,24,9,2,35
QUITMAN,9/27/2020,24,9,2,35
QUITMAN,9/28/2020,24,9,2,35
QUITMAN,9/29/2020,25,9,2,36
HART,9/5/2020,280,196,7,483
WILKINSON,3/27/2020,2,5,0,7
WILKINSON,3/28/2020,4,5,0,9
WILKINSON,3/29/2020,4,5,0,9
HANCOCK,3/4/2020,0,0,0,0
WILKINSON,3/30/2020,4,5,0,9
HANCOCK,3/5/2020,0,0,0,0
QUITMAN,9/30/2020,25,9,2,36
WILKINSON,3/31/2020,4,5,0,9
HANCOCK,3/6/2020,0,0,0,0
QUITMAN,10/1/2020,25,9,2,36
WILKINSON,4/1/2020,4,6,0,10
HANCOCK,3/7/2020,0,0,0,0
QUITMAN,10/2/2020,25,9,2,36
WILKINSON,4/2/2020,5,8,0,13
HANCOCK,3/8/2020,0,0,0,0
QUITMAN,10/3/2020,26,9,2,37
WILKINSON,4/3/2020,8,8,0,16
HANCOCK,3/9/2020,0,0,0,0
QUITMAN,10/4/2020,26,9,2,37
WILKINSON,4/4/2020,8,8,0,16
HANCOCK,3/10/2020,0,0,0,0
HANCOCK,3/11/2020,0,0,0,0
HANCOCK,3/12/2020,0,0,0,0
HANCOCK,3/13/2020,0,0,0,0
HANCOCK,3/14/2020,0,0,0,0
HANCOCK,3/15/2020,0,0,0,0
HANCOCK,3/16/2020,0,0,0,0
HANCOCK,3/17/2020,0,0,0,0
HANCOCK,3/18/2020,0,0,0,0
HANCOCK,3/19/2020,0,0,0,0
HANCOCK,3/20/2020,0,0,0,0
HANCOCK,3/21/2020,0,0,0,0
HANCOCK,3/22/2020,0,0,0,0
HANCOCK,3/23/2020,0,0,0,0
HANCOCK,3/24/2020,0,0,0,0
HANCOCK,3/25/2020,0,0,0,0
HANCOCK,3/26/2020,0,0,0,0
HANCOCK,3/27/2020,0,0,0,0
HANCOCK,3/28/2020,0,0,0,0
HART,9/6/2020,282,196,7,485
HANCOCK,3/29/2020,0,0,0,0
HANCOCK,3/30/2020,0,0,0,0
HANCOCK,3/31/2020,1,0,0,1
HANCOCK,4/1/2020,1,0,0,1
HANCOCK,4/2/2020,2,0,0,2
HANCOCK,4/3/2020,5,0,0,5
HANCOCK,4/4/2020,5,0,0,5
HANCOCK,4/5/2020,5,0,0,5
HANCOCK,4/6/2020,6,0,0,6
HANCOCK,4/7/2020,6,1,0,7
HANCOCK,4/8/2020,7,2,0,9
HANCOCK,4/9/2020,7,2,0,9
HANCOCK,4/10/2020,7,3,0,10
HANCOCK,4/11/2020,7,3,0,10
HANCOCK,4/12/2020,7,3,0,10
HANCOCK,4/13/2020,9,3,0,12
HANCOCK,4/14/2020,10,3,0,13
HANCOCK,4/15/2020,11,4,0,15
HANCOCK,4/16/2020,12,5,0,17
HANCOCK,4/17/2020,13,6,0,19
HANCOCK,4/18/2020,16,6,0,22
HANCOCK,4/19/2020,16,6,0,22
HANCOCK,4/20/2020,21,9,0,30
HANCOCK,4/21/2020,29,11,0,40
HANCOCK,4/22/2020,35,11,0,46
HANCOCK,4/23/2020,40,15,0,55
HANCOCK,4/24/2020,40,15,0,55
HANCOCK,4/25/2020,48,18,0,66
HANCOCK,4/26/2020,54,18,0,72
HANCOCK,4/27/2020,59,21,0,80
HANCOCK,4/28/2020,64,23,0,87
HANCOCK,4/29/2020,70,24,0,94
HANCOCK,4/30/2020,79,27,0,106
HANCOCK,5/1/2020,88,40,0,128
HANCOCK,5/2/2020,88,41,0,129
HANCOCK,5/3/2020,89,42,0,131
HANCOCK,5/4/2020,96,46,0,142
HANCOCK,5/5/2020,100,49,0,149
HANCOCK,5/6/2020,102,54,0,156
HANCOCK,5/7/2020,102,56,0,158
HANCOCK,5/8/2020,104,56,0,160
HANCOCK,5/9/2020,106,57,0,163
HANCOCK,5/10/2020,106,59,0,165
HANCOCK,5/11/2020,106,60,0,166
HANCOCK,5/12/2020,108,60,0,168
HANCOCK,5/13/2020,113,63,0,176
HANCOCK,5/14/2020,113,63,0,176
HANCOCK,5/15/2020,117,64,0,181
HANCOCK,5/16/2020,118,65,0,183
HANCOCK,5/17/2020,120,65,0,185
HANCOCK,5/18/2020,121,65,0,186
HANCOCK,5/19/2020,122,66,0,188
HANCOCK,5/20/2020,123,68,0,191
HANCOCK,5/21/2020,124,68,0,192
HANCOCK,5/22/2020,126,68,0,194
HANCOCK,5/23/2020,126,68,0,194
HANCOCK,5/24/2020,126,68,0,194
HANCOCK,5/25/2020,126,68,0,194
HANCOCK,5/26/2020,126,68,0,194
HANCOCK,5/27/2020,126,71,0,197
HANCOCK,5/28/2020,127,72,0,199
HANCOCK,5/29/2020,127,72,0,199
HANCOCK,5/30/2020,127,72,0,199
HANCOCK,5/31/2020,127,72,0,199
HANCOCK,6/1/2020,127,72,0,199
HANCOCK,6/2/2020,127,72,0,199
HANCOCK,6/3/2020,127,72,0,199
HANCOCK,6/4/2020,127,72,0,199
HANCOCK,6/5/2020,127,74,0,201
HANCOCK,6/6/2020,127,74,0,201
HANCOCK,6/7/2020,127,74,0,201
HANCOCK,6/8/2020,128,75,0,203
HANCOCK,6/9/2020,128,75,0,203
HANCOCK,6/10/2020,131,75,0,206
HANCOCK,6/11/2020,131,75,0,206
HANCOCK,6/12/2020,134,75,0,209
HANCOCK,6/13/2020,134,75,0,209
HANCOCK,6/14/2020,134,76,0,210
HANCOCK,6/15/2020,135,76,0,211
HANCOCK,6/16/2020,135,77,0,212
HANCOCK,6/17/2020,135,77,0,212
HANCOCK,6/18/2020,135,77,0,212
HANCOCK,6/19/2020,135,78,0,213
HANCOCK,6/20/2020,135,78,0,213
HANCOCK,6/21/2020,135,78,0,213
HANCOCK,6/22/2020,137,79,0,216
HANCOCK,6/23/2020,139,79,0,218
HANCOCK,6/24/2020,139,79,0,218
HANCOCK,6/25/2020,139,79,0,218
HANCOCK,6/26/2020,141,79,0,220
HANCOCK,6/27/2020,141,80,1,222
HANCOCK,6/28/2020,141,80,1,222
HANCOCK,6/29/2020,142,80,1,223
HANCOCK,6/30/2020,143,84,1,228
HANCOCK,7/1/2020,146,86,1,233
HANCOCK,7/2/2020,147,86,1,234
HANCOCK,7/3/2020,147,86,1,234
HANCOCK,7/4/2020,147,87,1,235
HANCOCK,7/5/2020,147,87,1,235
HANCOCK,7/6/2020,154,88,1,243
HANCOCK,7/7/2020,154,88,1,243
HANCOCK,7/8/2020,157,90,1,248
HANCOCK,7/9/2020,157,91,1,249
HANCOCK,7/10/2020,161,91,1,253
HANCOCK,7/11/2020,162,91,1,254
HANCOCK,7/12/2020,162,91,1,254
HANCOCK,7/13/2020,164,97,1,262
HANCOCK,7/14/2020,167,102,1,270
HANCOCK,7/15/2020,168,105,1,274
HANCOCK,7/16/2020,170,107,1,278
HANCOCK,7/17/2020,171,108,1,280
HANCOCK,7/18/2020,171,108,1,280
HANCOCK,7/19/2020,171,110,1,282
HANCOCK,7/20/2020,179,111,1,291
HANCOCK,7/21/2020,180,111,1,292
HANCOCK,7/22/2020,183,112,1,296
HANCOCK,7/23/2020,184,114,1,299
HANCOCK,7/24/2020,185,116,1,302
HANCOCK,7/25/2020,185,117,1,303
HANCOCK,7/26/2020,185,117,1,303
HANCOCK,7/27/2020,186,118,1,305
HANCOCK,7/28/2020,191,119,1,311
HANCOCK,7/29/2020,191,119,1,311
HANCOCK,7/30/2020,193,120,1,314
HANCOCK,7/31/2020,195,123,1,319
HANCOCK,8/1/2020,195,123,1,319
HANCOCK,8/2/2020,196,126,1,323
HANCOCK,8/3/2020,197,126,1,324
HANCOCK,8/4/2020,198,126,1,325
HANCOCK,8/5/2020,200,127,1,328
HANCOCK,8/6/2020,201,130,1,332
HANCOCK,8/7/2020,203,130,1,334
HANCOCK,8/8/2020,204,130,1,335
HANCOCK,8/9/2020,205,134,1,340
HANCOCK,8/10/2020,206,134,1,341
HANCOCK,8/11/2020,209,136,2,347
HANCOCK,8/12/2020,211,137,2,350
HANCOCK,8/13/2020,212,138,2,352
HANCOCK,8/14/2020,213,138,2,353
HANCOCK,8/15/2020,213,139,2,354
HANCOCK,8/16/2020,213,139,2,354
HANCOCK,8/17/2020,213,140,2,355
HANCOCK,8/18/2020,213,140,2,355
HANCOCK,8/19/2020,215,140,2,357
HANCOCK,8/20/2020,215,140,2,357
HANCOCK,8/21/2020,217,140,2,359
HANCOCK,8/22/2020,217,140,2,359
HANCOCK,8/23/2020,219,140,2,361
HANCOCK,8/24/2020,220,140,2,362
HANCOCK,8/25/2020,223,142,2,367
HANCOCK,8/26/2020,224,142,2,368
HANCOCK,8/27/2020,224,143,2,369
HANCOCK,8/28/2020,224,147,2,373
HANCOCK,8/29/2020,226,147,2,375
HANCOCK,8/30/2020,226,147,2,375
HANCOCK,8/31/2020,226,148,2,376
HANCOCK,9/1/2020,228,151,2,381
HANCOCK,9/2/2020,228,151,2,381
HANCOCK,9/3/2020,230,151,2,383
HANCOCK,9/4/2020,230,151,2,383
HANCOCK,9/5/2020,230,151,2,383
HANCOCK,9/6/2020,230,151,2,383
HANCOCK,9/7/2020,231,151,2,384
HANCOCK,9/8/2020,233,151,2,386
HANCOCK,9/9/2020,234,154,2,390
HANCOCK,9/10/2020,236,154,2,392
HANCOCK,9/11/2020,237,155,2,394
HANCOCK,9/12/2020,237,155,2,394
HANCOCK,9/13/2020,237,155,2,394
HANCOCK,9/14/2020,237,155,2,394
HANCOCK,9/15/2020,239,155,2,396
HANCOCK,9/16/2020,239,155,2,396
HANCOCK,9/17/2020,239,155,2,396
HANCOCK,9/18/2020,239,156,2,397
HANCOCK,9/19/2020,241,156,2,399
HANCOCK,9/20/2020,241,156,2,399
HANCOCK,9/21/2020,241,157,2,400
HANCOCK,9/22/2020,242,157,2,401
HANCOCK,9/23/2020,242,157,2,401
HANCOCK,9/24/2020,242,158,2,402
HANCOCK,9/25/2020,242,158,2,402
HANCOCK,9/26/2020,242,158,2,402
HANCOCK,9/27/2020,242,158,2,402
HANCOCK,9/28/2020,242,158,2,402
HANCOCK,9/29/2020,243,159,2,404
HANCOCK,9/30/2020,244,159,2,405
HANCOCK,10/1/2020,244,159,2,405
HANCOCK,10/2/2020,244,159,2,405
HANCOCK,10/3/2020,245,159,2,406
HANCOCK,10/4/2020,245,159,2,406
HANCOCK,10/5/2020,245,159,2,406
HANCOCK,10/6/2020,245,159,2,406
HANCOCK,10/7/2020,247,160,2,409
HANCOCK,10/8/2020,248,160,2,410
HANCOCK,10/9/2020,248,160,2,410
HANCOCK,10/10/2020,248,160,2,410
HANCOCK,10/11/2020,249,160,2,411
HANCOCK,10/12/2020,249,160,2,411
HANCOCK,10/13/2020,249,160,2,411
HANCOCK,10/14/2020,249,162,2,413
HANCOCK,10/15/2020,249,162,2,413
HANCOCK,10/16/2020,249,162,2,413
HANCOCK,10/17/2020,249,162,2,413
HANCOCK,10/18/2020,249,162,2,413
HANCOCK,10/19/2020,249,162,2,413
HANCOCK,10/20/2020,249,162,2,413
PIKE,1/1/2020,0,0,0,0
PIKE,1/2/2020,0,0,0,0
PIKE,1/3/2020,0,0,0,0
PIKE,1/4/2020,0,0,0,0
PIKE,1/5/2020,0,0,0,0
PIKE,1/6/2020,0,0,0,0
PIKE,1/7/2020,0,0,0,0
PIKE,1/8/2020,0,0,0,0
PIKE,1/9/2020,0,0,0,0
PIKE,1/10/2020,0,0,0,0
PIKE,1/11/2020,0,0,0,0
PIKE,1/12/2020,0,0,0,0
PIKE,1/13/2020,0,0,0,0
PIKE,1/14/2020,0,0,0,0
PIKE,1/15/2020,0,0,0,0
PIKE,1/16/2020,0,0,0,0
PIKE,1/17/2020,0,0,0,0
PIKE,1/18/2020,0,0,0,0
PIKE,1/19/2020,0,0,0,0
PIKE,1/20/2020,0,0,0,0
PIKE,1/21/2020,0,0,0,0
PIKE,1/22/2020,0,0,0,0
PIKE,1/23/2020,0,0,0,0
PIKE,1/24/2020,0,0,0,0
PIKE,1/25/2020,0,0,0,0
PIKE,1/26/2020,0,0,0,0
PIKE,1/27/2020,0,0,0,0
PIKE,1/28/2020,0,0,0,0
PIKE,1/29/2020,0,0,0,0
PIKE,1/30/2020,0,0,0,0
PIKE,1/31/2020,0,0,0,0
PIKE,2/1/2020,0,0,0,0
PIKE,2/2/2020,0,0,0,0
PIKE,2/3/2020,0,0,0,0
PIKE,2/4/2020,0,0,0,0
PIKE,2/5/2020,0,0,0,0
PIKE,2/6/2020,0,0,0,0
PIKE,2/7/2020,0,0,0,0
PIKE,2/8/2020,0,0,0,0
PIKE,2/9/2020,0,0,0,0
PIKE,2/10/2020,0,0,0,0
PIKE,2/11/2020,0,0,0,0
PIKE,2/12/2020,0,0,0,0
PIKE,2/13/2020,0,0,0,0
PIKE,2/14/2020,0,0,0,0
PIKE,2/15/2020,0,0,0,0
PIKE,2/16/2020,0,0,0,0
PIKE,2/17/2020,0,0,0,0
PIKE,2/18/2020,0,0,0,0
PIKE,2/19/2020,0,0,0,0
PIKE,2/20/2020,0,0,0,0
PIKE,2/21/2020,0,0,0,0
PIKE,2/22/2020,0,0,0,0
PIKE,2/23/2020,0,0,0,0
PIKE,2/24/2020,0,0,0,0
PIKE,2/25/2020,0,0,0,0
PIKE,2/26/2020,0,0,0,0
PIKE,2/27/2020,0,0,0,0
PIKE,2/28/2020,0,0,0,0
PIKE,2/29/2020,0,0,0,0
PIKE,3/1/2020,0,0,0,0
PIKE,3/2/2020,0,0,0,0
PIKE,3/3/2020,0,0,0,0
PIKE,3/4/2020,0,0,0,0
PIKE,3/5/2020,0,0,0,0
PIKE,3/6/2020,0,0,0,0
PIKE,3/7/2020,0,0,0,0
PIKE,3/8/2020,0,0,0,0
PIKE,3/9/2020,0,0,0,0
PIKE,3/10/2020,0,0,0,0
PIKE,3/11/2020,0,0,0,0
PIKE,3/12/2020,0,0,0,0
PIKE,3/13/2020,0,0,0,0
PIKE,3/14/2020,1,0,0,1
PIKE,3/15/2020,1,0,0,1
PIKE,3/16/2020,1,0,0,1
PIKE,3/17/2020,1,0,0,1
PIKE,3/18/2020,1,1,0,2
PIKE,3/19/2020,1,2,0,3
PIKE,3/20/2020,2,3,0,5
PIKE,3/21/2020,3,3,0,6
PIKE,3/22/2020,3,3,0,6
PIKE,3/23/2020,4,5,0,9
PIKE,3/24/2020,4,5,0,9
PIKE,3/25/2020,4,5,0,9
PIKE,3/26/2020,4,5,0,9
PIKE,3/27/2020,4,5,0,9
PIKE,3/28/2020,4,6,0,10
PIKE,3/29/2020,4,7,0,11
PIKE,3/30/2020,5,8,0,13
PIKE,3/31/2020,5,8,0,13
PIKE,4/1/2020,5,8,0,13
PIKE,4/2/2020,5,9,0,14
PIKE,4/3/2020,5,9,0,14
PIKE,4/4/2020,5,9,0,14
PIKE,4/5/2020,5,10,0,15
PIKE,4/6/2020,5,11,0,16
PIKE,4/7/2020,9,11,0,20
PIKE,4/8/2020,12,11,0,23
PIKE,4/9/2020,12,12,0,24
PIKE,4/10/2020,12,12,0,24
PIKE,4/11/2020,12,12,0,24
PIKE,4/12/2020,12,13,0,25
PIKE,4/13/2020,14,14,0,28
PIKE,4/14/2020,15,14,0,29
PIKE,4/15/2020,15,14,0,29
PIKE,4/16/2020,16,15,0,31
PIKE,4/17/2020,17,15,0,32
PIKE,4/18/2020,17,15,0,32
PIKE,4/19/2020,19,16,0,35
PIKE,4/20/2020,19,16,0,35
PIKE,4/21/2020,19,16,0,35
PIKE,4/22/2020,22,17,0,39
PIKE,4/23/2020,22,17,0,39
PIKE,4/24/2020,23,17,0,40
PIKE,4/25/2020,23,17,0,40
PIKE,4/26/2020,23,17,0,40
PIKE,4/27/2020,23,17,0,40
PIKE,4/28/2020,23,17,0,40
PIKE,4/29/2020,23,17,0,40
PIKE,4/30/2020,23,17,0,40
PIKE,5/1/2020,24,18,0,42
PIKE,5/2/2020,24,18,0,42
PIKE,5/3/2020,24,19,0,43
PIKE,5/4/2020,25,19,0,44
PIKE,5/5/2020,25,19,0,44
PIKE,5/6/2020,25,19,0,44
PIKE,5/7/2020,25,20,0,45
PIKE,5/8/2020,26,21,0,47
PIKE,5/9/2020,26,21,0,47
PIKE,5/10/2020,26,22,0,48
PIKE,5/11/2020,26,22,0,48
PIKE,5/12/2020,26,23,0,49
PIKE,5/13/2020,26,23,0,49
PIKE,5/14/2020,26,24,0,50
PIKE,5/15/2020,26,24,0,50
PIKE,5/16/2020,26,24,0,50
PIKE,5/17/2020,26,24,0,50
PIKE,5/18/2020,26,24,0,50
PIKE,5/19/2020,27,27,0,54
PIKE,5/20/2020,28,27,0,55
PIKE,5/21/2020,28,27,0,55
PIKE,5/22/2020,28,27,0,55
PIKE,5/23/2020,28,27,0,55
PIKE,5/24/2020,28,27,0,55
PIKE,5/25/2020,28,27,0,55
PIKE,5/26/2020,29,29,0,58
PIKE,5/27/2020,30,30,0,60
PIKE,5/28/2020,31,31,0,62
PIKE,5/29/2020,31,31,0,62
PIKE,5/30/2020,31,31,0,62
PIKE,5/31/2020,31,31,0,62
PIKE,6/1/2020,33,33,0,66
PIKE,6/2/2020,33,34,0,67
PIKE,6/3/2020,33,34,0,67
PIKE,6/4/2020,34,34,0,68
PIKE,6/5/2020,36,35,0,71
PIKE,6/6/2020,37,35,0,72
PIKE,6/7/2020,37,35,0,72
PIKE,6/8/2020,37,37,0,74
PIKE,6/9/2020,38,38,0,76
PIKE,6/10/2020,38,41,0,79
PIKE,6/11/2020,38,43,0,81
PIKE,6/12/2020,38,44,0,82
PIKE,6/13/2020,38,46,0,84
PIKE,6/14/2020,38,47,0,85
QUITMAN,10/5/2020,26,9,2,37
QUITMAN,10/6/2020,26,10,2,38
QUITMAN,10/7/2020,26,10,2,38
WILKINSON,4/5/2020,9,9,0,18
HART,9/7/2020,283,198,7,488
QUITMAN,10/8/2020,26,10,2,38
WILKINSON,4/6/2020,9,10,0,19
QUITMAN,10/9/2020,26,10,2,38
HART,9/8/2020,283,198,7,488
WILKINSON,4/7/2020,9,10,0,19
QUITMAN,10/10/2020,26,10,2,38
QUITMAN,10/11/2020,26,10,2,38
QUITMAN,10/12/2020,26,10,2,38
QUITMAN,10/13/2020,26,10,2,38
QUITMAN,10/14/2020,26,10,2,38
QUITMAN,10/15/2020,26,10,2,38
QUITMAN,10/16/2020,26,10,2,38
QUITMAN,10/17/2020,26,10,2,38
QUITMAN,10/18/2020,26,10,2,38
QUITMAN,10/19/2020,26,10,2,38
QUITMAN,10/20/2020,26,10,2,38
WARREN,1/1/2020,0,0,0,0
WARREN,1/2/2020,0,0,0,0
WARREN,1/3/2020,0,0,0,0
WARREN,1/4/2020,0,0,0,0
WARREN,1/5/2020,0,0,0,0
WARREN,1/6/2020,0,0,0,0
WARREN,1/7/2020,0,0,0,0
WARREN,1/8/2020,0,0,0,0
WARREN,1/9/2020,0,0,0,0
WARREN,1/10/2020,0,0,0,0
WARREN,1/11/2020,0,0,0,0
WARREN,1/12/2020,0,0,0,0
WARREN,1/13/2020,0,0,0,0
WARREN,1/14/2020,0,0,0,0
WARREN,1/15/2020,0,0,0,0
WARREN,1/16/2020,0,0,0,0
WARREN,1/17/2020,0,0,0,0
WARREN,1/18/2020,0,0,0,0
WARREN,1/19/2020,0,0,0,0
WARREN,1/20/2020,0,0,0,0
WARREN,1/21/2020,0,0,0,0
WARREN,1/22/2020,0,0,0,0
WARREN,1/23/2020,0,0,0,0
WARREN,1/24/2020,0,0,0,0
WARREN,1/25/2020,0,0,0,0
WARREN,1/26/2020,0,0,0,0
WARREN,1/27/2020,0,0,0,0
WARREN,1/28/2020,0,0,0,0
WARREN,1/29/2020,0,0,0,0
WARREN,1/30/2020,0,0,0,0
WARREN,1/31/2020,0,0,0,0
WARREN,2/1/2020,0,0,0,0
WARREN,2/2/2020,0,0,0,0
WARREN,2/3/2020,0,0,0,0
WARREN,2/4/2020,0,0,0,0
WARREN,2/5/2020,0,0,0,0
WARREN,2/6/2020,0,0,0,0
WARREN,2/7/2020,0,0,0,0
WARREN,2/8/2020,0,0,0,0
WARREN,2/9/2020,0,0,0,0
WARREN,2/10/2020,0,0,0,0
WARREN,2/11/2020,0,0,0,0
WARREN,2/12/2020,0,0,0,0
WARREN,2/13/2020,0,0,0,0
WARREN,2/14/2020,0,0,0,0
WARREN,2/15/2020,0,0,0,0
WARREN,2/16/2020,0,0,0,0
WARREN,2/17/2020,0,0,0,0
WARREN,2/18/2020,0,0,0,0
WARREN,2/19/2020,0,0,0,0
WARREN,2/20/2020,0,0,0,0
WARREN,2/21/2020,0,0,0,0
WARREN,2/22/2020,0,0,0,0
WARREN,2/23/2020,0,0,0,0
WARREN,2/24/2020,0,0,0,0
WARREN,2/25/2020,0,0,0,0
WARREN,2/26/2020,0,1,0,1
WARREN,2/27/2020,0,1,0,1
WARREN,2/28/2020,0,1,0,1
WARREN,2/29/2020,0,1,0,1
WARREN,3/1/2020,0,1,0,1
WARREN,3/2/2020,0,1,0,1
WARREN,3/3/2020,0,1,0,1
WARREN,3/4/2020,0,1,0,1
WARREN,3/5/2020,0,1,0,1
WARREN,3/6/2020,0,1,0,1
WARREN,3/7/2020,0,1,0,1
WARREN,3/8/2020,0,1,0,1
WARREN,3/9/2020,0,1,0,1
WARREN,3/10/2020,0,1,0,1
WARREN,3/11/2020,0,1,0,1
WARREN,3/12/2020,0,1,0,1
WARREN,3/13/2020,0,1,0,1
WARREN,3/14/2020,0,1,0,1
WARREN,3/15/2020,0,1,0,1
WARREN,3/16/2020,1,1,0,2
WARREN,3/17/2020,1,1,0,2
WARREN,3/18/2020,1,1,0,2
WARREN,3/19/2020,1,2,0,3
WARREN,3/20/2020,1,2,0,3
WARREN,3/21/2020,1,2,0,3
WARREN,3/22/2020,1,2,0,3
WARREN,3/23/2020,2,2,0,4
WARREN,3/24/2020,2,2,0,4
WARREN,3/25/2020,2,2,0,4
WARREN,3/26/2020,2,2,0,4
WARREN,3/27/2020,2,2,0,4
WARREN,3/28/2020,2,2,0,4
WARREN,3/29/2020,2,3,0,5
WARREN,3/30/2020,2,3,0,5
WARREN,3/31/2020,2,3,0,5
WARREN,4/1/2020,2,3,0,5
WARREN,4/2/2020,2,3,0,5
WARREN,4/3/2020,2,3,0,5
WARREN,4/4/2020,2,3,0,5
WARREN,4/5/2020,2,3,0,5
WARREN,4/6/2020,2,3,0,5
WARREN,4/7/2020,2,4,0,6
WARREN,4/8/2020,2,4,0,6
WARREN,4/9/2020,2,4,0,6
WARREN,4/10/2020,2,4,0,6
WARREN,4/11/2020,3,4,0,7
WARREN,4/12/2020,3,4,0,7
WARREN,4/13/2020,4,5,0,9
WARREN,4/14/2020,4,5,0,9
WARREN,4/15/2020,5,5,0,10
WARREN,4/16/2020,5,5,0,10
WARREN,4/17/2020,5,5,0,10
WARREN,4/18/2020,5,5,0,10
WARREN,4/19/2020,5,5,0,10
WARREN,4/20/2020,5,5,0,10
WARREN,4/21/2020,6,5,0,11
WARREN,4/22/2020,6,5,0,11
WARREN,4/23/2020,6,5,0,11
WARREN,4/24/2020,6,5,0,11
WARREN,4/25/2020,6,5,0,11
WARREN,4/26/2020,6,5,0,11
WARREN,4/27/2020,7,5,0,12
WARREN,4/28/2020,7,5,0,12
WARREN,4/29/2020,9,5,0,14
WARREN,4/30/2020,9,5,0,14
WARREN,5/1/2020,9,5,0,14
WARREN,5/2/2020,9,5,0,14
WARREN,5/3/2020,9,5,0,14
WARREN,5/4/2020,9,5,0,14
WARREN,5/5/2020,9,5,0,14
WARREN,5/6/2020,9,5,0,14
WARREN,5/7/2020,10,6,0,16
WARREN,5/8/2020,10,6,0,16
WARREN,5/9/2020,10,6,0,16
WARREN,5/10/2020,10,6,0,16
WARREN,5/11/2020,11,6,0,17
WARREN,5/12/2020,11,6,0,17
WARREN,5/13/2020,11,6,0,17
WARREN,5/14/2020,11,6,0,17
WARREN,5/15/2020,11,6,0,17
WARREN,5/16/2020,11,6,0,17
WARREN,5/17/2020,11,6,0,17
WARREN,5/18/2020,11,6,0,17
WARREN,5/19/2020,11,6,0,17
WARREN,5/20/2020,11,7,0,18
WARREN,5/21/2020,11,8,0,19
WARREN,5/22/2020,11,8,0,19
WARREN,5/23/2020,11,8,0,19
WARREN,5/24/2020,11,8,0,19
WARREN,5/25/2020,11,8,0,19
WARREN,5/26/2020,11,8,0,19
WARREN,5/27/2020,11,8,0,19
WARREN,5/28/2020,11,8,0,19
WARREN,5/29/2020,11,8,0,19
WARREN,5/30/2020,11,8,0,19
WARREN,5/31/2020,11,8,0,19
WARREN,6/1/2020,11,8,0,19
WARREN,6/2/2020,11,8,0,19
WARREN,6/3/2020,11,8,0,19
WARREN,6/4/2020,11,8,0,19
WARREN,6/5/2020,15,11,0,26
WARREN,6/6/2020,15,11,0,26
WARREN,6/7/2020,15,11,0,26
WARREN,6/8/2020,15,11,0,26
WARREN,6/9/2020,15,11,0,26
WARREN,6/10/2020,15,11,0,26
WARREN,6/11/2020,15,11,0,26
WARREN,6/12/2020,15,11,0,26
WARREN,6/13/2020,15,11,0,26
WARREN,6/14/2020,15,11,0,26
WARREN,6/15/2020,15,11,0,26
WARREN,6/16/2020,15,11,0,26
WARREN,6/17/2020,15,11,0,26
WARREN,6/18/2020,15,11,0,26
WARREN,6/19/2020,15,11,0,26
WARREN,6/20/2020,15,11,0,26
WARREN,6/21/2020,15,11,0,26
WARREN,6/22/2020,15,11,0,26
WARREN,6/23/2020,16,12,0,28
WARREN,6/24/2020,16,13,0,29
WARREN,6/25/2020,16,13,0,29
WARREN,6/26/2020,16,13,0,29
WARREN,6/27/2020,16,13,0,29
WARREN,6/28/2020,17,13,0,30
WARREN,6/29/2020,17,15,0,32
WARREN,6/30/2020,18,15,0,33
WARREN,7/1/2020,18,15,0,33
WARREN,7/2/2020,18,16,0,34
WARREN,7/3/2020,18,16,0,34
WARREN,7/4/2020,19,16,0,35
WARREN,7/5/2020,19,17,0,36
WARREN,7/6/2020,21,17,0,38
WARREN,7/7/2020,22,17,0,39
WARREN,7/8/2020,22,17,0,39
WARREN,7/9/2020,22,19,0,41
WARREN,7/10/2020,23,20,0,43
WARREN,7/11/2020,24,20,0,44
WARREN,7/12/2020,24,21,0,45
WARREN,7/13/2020,25,22,0,47
WARREN,7/14/2020,25,26,0,51
WARREN,7/15/2020,27,26,0,53
WARREN,7/16/2020,28,29,0,57
WARREN,7/17/2020,29,30,0,59
WARREN,7/18/2020,29,30,0,59
WARREN,7/19/2020,31,30,0,61
WARREN,7/20/2020,31,30,0,61
WARREN,7/21/2020,32,30,0,62
WARREN,7/22/2020,32,31,0,63
WARREN,7/23/2020,34,31,0,65
WARREN,7/24/2020,37,32,0,69
WARREN,7/25/2020,37,32,0,69
WARREN,7/26/2020,37,32,0,69
WARREN,7/27/2020,40,32,0,72
WARREN,7/28/2020,41,33,1,75
WARREN,7/29/2020,44,34,1,79
WARREN,7/30/2020,44,35,1,80
WARREN,7/31/2020,45,36,1,82
WARREN,8/1/2020,48,36,1,85
WARREN,8/2/2020,48,36,1,85
WARREN,8/3/2020,50,38,1,89
WARREN,8/4/2020,53,42,1,96
WARREN,8/5/2020,57,43,1,101
WARREN,8/6/2020,59,44,1,104
WARREN,8/7/2020,59,45,1,105
WARREN,8/8/2020,59,45,1,105
WARREN,8/9/2020,59,45,1,105
WARREN,8/10/2020,59,46,1,106
WARREN,8/11/2020,59,47,1,107
WARREN,8/12/2020,60,48,1,109
WARREN,8/13/2020,60,48,1,109
WARREN,8/14/2020,61,49,1,111
WARREN,8/15/2020,62,49,1,112
WARREN,8/16/2020,62,49,1,112
WARREN,8/17/2020,62,49,1,112
WARREN,8/18/2020,65,55,1,121
WARREN,8/19/2020,65,55,1,121
WARREN,8/20/2020,65,55,1,121
WARREN,8/21/2020,65,55,1,121
WARREN,8/22/2020,66,55,1,122
WARREN,8/23/2020,67,55,1,123
WARREN,8/24/2020,68,56,1,125
WARREN,8/25/2020,70,56,1,127
WARREN,8/26/2020,70,56,1,127
WARREN,8/27/2020,70,56,1,127
WARREN,8/28/2020,72,56,1,129
WARREN,8/29/2020,73,57,1,131
WARREN,8/30/2020,73,57,1,131
WARREN,8/31/2020,74,57,1,132
WARREN,9/1/2020,74,57,1,132
WARREN,9/2/2020,75,57,1,133
WARREN,9/3/2020,75,57,1,133
WARREN,9/4/2020,75,57,1,133
WARREN,9/5/2020,77,58,1,136
WARREN,9/6/2020,77,58,1,136
WARREN,9/7/2020,77,59,2,138
WARREN,9/8/2020,77,59,2,138
WARREN,9/9/2020,78,59,2,139
WARREN,9/10/2020,79,59,2,140
WARREN,9/11/2020,79,60,2,141
WARREN,9/12/2020,80,60,2,142
WARREN,9/13/2020,81,60,2,143
WARREN,9/14/2020,81,60,2,143
WARREN,9/15/2020,81,61,2,144
WARREN,9/16/2020,81,61,2,144
WARREN,9/17/2020,81,61,2,144
WARREN,9/18/2020,82,63,2,147
WARREN,9/19/2020,83,63,2,148
WARREN,9/20/2020,83,63,2,148
WARREN,9/21/2020,84,64,2,150
WARREN,9/22/2020,84,65,2,151
WARREN,9/23/2020,85,65,2,152
WARREN,9/24/2020,85,70,2,157
WARREN,9/25/2020,86,70,2,158
WARREN,9/26/2020,86,70,2,158
WARREN,9/27/2020,86,70,2,158
WARREN,9/28/2020,86,70,2,158
WARREN,9/29/2020,87,70,2,159
WARREN,9/30/2020,88,70,2,160
WARREN,10/1/2020,88,70,2,160
WARREN,10/2/2020,88,70,2,160
WARREN,10/3/2020,88,70,2,160
WARREN,10/4/2020,88,71,2,161
WARREN,10/5/2020,88,71,2,161
WARREN,10/6/2020,88,71,2,161
WARREN,10/7/2020,89,71,2,162
WARREN,10/8/2020,89,71,2,162
WARREN,10/9/2020,89,71,2,162
WARREN,10/10/2020,89,71,2,162
WARREN,10/11/2020,89,71,2,162
WARREN,10/12/2020,90,71,2,163
WARREN,10/13/2020,90,71,2,163
WARREN,10/14/2020,90,71,2,163
WARREN,10/15/2020,90,71,2,163
WARREN,10/16/2020,90,71,2,163
WARREN,10/17/2020,90,71,2,163
WARREN,10/18/2020,90,71,2,163
WARREN,10/19/2020,90,71,2,163
WARREN,10/20/2020,90,71,2,163
WILKINSON,1/1/2020,0,0,0,0
WILKINSON,1/2/2020,0,0,0,0
WILKINSON,1/3/2020,0,0,0,0
WILKINSON,1/4/2020,0,0,0,0
WILKINSON,1/5/2020,0,0,0,0
WILKINSON,1/6/2020,0,0,0,0
WILKINSON,1/7/2020,0,0,0,0
WILKINSON,1/8/2020,0,0,0,0
WILKINSON,1/9/2020,0,0,0,0
WILKINSON,1/10/2020,0,0,0,0
WILKINSON,1/11/2020,0,0,0,0
WILKINSON,1/12/2020,0,0,0,0
WILKINSON,1/13/2020,0,0,0,0
WILKINSON,1/14/2020,0,0,0,0
WILKINSON,1/15/2020,0,0,0,0
WILKINSON,1/16/2020,0,0,0,0
WILKINSON,1/17/2020,0,0,0,0
WILKINSON,1/18/2020,0,0,0,0
WILKINSON,1/19/2020,0,0,0,0
WILKINSON,1/20/2020,0,0,0,0
WILKINSON,1/21/2020,0,0,0,0
WILKINSON,1/22/2020,0,0,0,0
WILKINSON,1/23/2020,0,0,0,0
WILKINSON,1/24/2020,0,0,0,0
WILKINSON,1/25/2020,0,0,0,0
WILKINSON,1/26/2020,0,0,0,0
WILKINSON,1/27/2020,0,0,0,0
WILKINSON,1/28/2020,0,0,0,0
WILKINSON,1/29/2020,0,0,0,0
WILKINSON,1/30/2020,0,0,0,0
WILKINSON,1/31/2020,0,0,0,0
WILKINSON,2/1/2020,0,0,0,0
WILKINSON,2/2/2020,0,0,0,0
WILKINSON,2/3/2020,0,0,0,0
WILKINSON,2/4/2020,0,0,0,0
WILKINSON,2/5/2020,0,0,0,0
WILKINSON,2/6/2020,0,0,0,0
WILKINSON,2/7/2020,0,0,0,0
WILKINSON,2/8/2020,0,0,0,0
WILKINSON,2/9/2020,0,0,0,0
WILKINSON,2/10/2020,0,0,0,0
WILKINSON,2/11/2020,0,0,0,0
WILKINSON,2/12/2020,0,0,0,0
WILKINSON,2/13/2020,0,0,0,0
WILKINSON,2/14/2020,0,0,0,0
WILKINSON,2/15/2020,0,0,0,0
WILKINSON,2/16/2020,0,0,0,0
WILKINSON,2/17/2020,0,0,0,0
WILKINSON,2/18/2020,0,0,0,0
WILKINSON,2/19/2020,0,0,0,0
WILKINSON,2/20/2020,0,0,0,0
WILKINSON,2/21/2020,0,0,0,0
WILKINSON,2/22/2020,0,0,0,0
WILKINSON,2/23/2020,0,0,0,0
WILKINSON,2/24/2020,0,0,0,0
WILKINSON,2/25/2020,0,0,0,0
WILKINSON,2/26/2020,0,0,0,0
WILKINSON,2/27/2020,0,0,0,0
WILKINSON,2/28/2020,0,0,0,0
WILKINSON,2/29/2020,0,0,0,0
WILKINSON,3/1/2020,0,1,0,1
WILKINSON,3/2/2020,0,1,0,1
WILKINSON,3/3/2020,0,1,0,1
WILKINSON,3/4/2020,0,1,0,1
WILKINSON,3/5/2020,0,1,0,1
WILKINSON,3/6/2020,0,1,0,1
WILKINSON,3/7/2020,0,1,0,1
WILKINSON,3/8/2020,0,1,0,1
WILKINSON,3/9/2020,0,1,0,1
WILKINSON,3/10/2020,0,1,0,1
WILKINSON,3/11/2020,0,1,0,1
WILKINSON,3/12/2020,0,1,0,1
WILKINSON,3/13/2020,0,1,0,1
WILKINSON,3/14/2020,0,1,0,1
WILKINSON,3/15/2020,0,1,0,1
WILKINSON,3/16/2020,0,2,0,2
WILKINSON,3/17/2020,0,2,0,2
WILKINSON,3/18/2020,0,2,0,2
WILKINSON,3/19/2020,0,2,0,2
WILKINSON,3/20/2020,0,2,0,2
WILKINSON,3/21/2020,0,2,0,2
WILKINSON,3/22/2020,0,2,0,2
WILKINSON,3/23/2020,0,3,0,3
WILKINSON,3/24/2020,0,3,0,3
HART,9/9/2020,283,200,7,490
HART,9/10/2020,285,200,7,492
WILKINSON,4/8/2020,9,11,0,20
HART,9/11/2020,286,202,7,495
HART,9/12/2020,286,203,7,496
WILKINSON,4/9/2020,9,11,0,20
HART,9/13/2020,288,203,7,498
WILKINSON,4/10/2020,12,12,0,24
HART,9/14/2020,288,205,7,500
WILKINSON,4/11/2020,12,12,0,24
HART,9/15/2020,288,207,7,502
WILKINSON,4/12/2020,13,13,0,26
WILKINSON,4/13/2020,14,14,0,28
WILKINSON,4/14/2020,14,15,0,29
WILKINSON,4/15/2020,14,15,0,29
WILKINSON,4/16/2020,16,15,0,31
WILKINSON,4/17/2020,16,15,0,31
WILKINSON,4/18/2020,17,15,0,32
WILKINSON,4/19/2020,17,16,0,33
WILKINSON,4/20/2020,18,16,0,34
WILKINSON,4/21/2020,19,16,0,35
WILKINSON,4/22/2020,20,16,0,36
WILKINSON,4/23/2020,21,17,0,38
WILKINSON,4/24/2020,21,17,0,38
WILKINSON,4/25/2020,21,17,0,38
WILKINSON,4/26/2020,21,17,0,38
WILKINSON,4/27/2020,21,17,0,38
WILKINSON,4/28/2020,21,17,0,38
WILKINSON,4/29/2020,21,17,0,38
WILKINSON,4/30/2020,22,20,0,42
WILKINSON,5/1/2020,22,20,0,42
WILKINSON,5/2/2020,22,20,0,42
WILKINSON,5/3/2020,22,20,0,42
WILKINSON,5/4/2020,22,20,0,42
WILKINSON,5/5/2020,22,20,0,42
WILKINSON,5/6/2020,22,20,0,42
WILKINSON,5/7/2020,23,20,0,43
WILKINSON,5/8/2020,23,20,0,43
WILKINSON,5/9/2020,24,20,0,44
WILKINSON,5/10/2020,24,20,0,44
WILKINSON,5/11/2020,24,20,0,44
WILKINSON,5/12/2020,24,20,0,44
WILKINSON,5/13/2020,27,21,0,48
WILKINSON,5/14/2020,30,21,0,51
WILKINSON,5/15/2020,33,22,0,55
WILKINSON,5/16/2020,34,22,0,56
WILKINSON,5/17/2020,34,22,0,56
WILKINSON,5/18/2020,42,23,0,65
WILKINSON,5/19/2020,42,23,0,65
WILKINSON,5/20/2020,42,23,0,65
WILKINSON,5/21/2020,42,23,0,65
WILKINSON,5/22/2020,42,23,0,65
WILKINSON,5/23/2020,42,23,0,65
WILKINSON,5/24/2020,42,23,0,65
WILKINSON,5/25/2020,42,23,0,65
WILKINSON,5/26/2020,42,23,0,65
WILKINSON,5/27/2020,43,23,0,66
WILKINSON,5/28/2020,43,23,0,66
WILKINSON,5/29/2020,43,23,0,66
WILKINSON,5/30/2020,43,24,0,67
WILKINSON,5/31/2020,43,24,0,67
WILKINSON,6/1/2020,44,24,0,68
WILKINSON,6/2/2020,44,24,0,68
WILKINSON,6/3/2020,44,24,0,68
WILKINSON,6/4/2020,45,24,0,69
WILKINSON,6/5/2020,45,25,0,70
WILKINSON,6/6/2020,45,25,0,70
WILKINSON,6/7/2020,45,25,0,70
WILKINSON,6/8/2020,46,25,0,71
WILKINSON,6/9/2020,46,25,0,71
WILKINSON,6/10/2020,46,25,0,71
WILKINSON,6/11/2020,46,25,0,71
WILKINSON,6/12/2020,47,25,0,72
WILKINSON,6/13/2020,47,25,0,72
WILKINSON,6/14/2020,47,25,0,72
WILKINSON,6/15/2020,47,25,0,72
WILKINSON,6/16/2020,47,25,0,72
WILKINSON,6/17/2020,47,25,0,72
WILKINSON,6/18/2020,47,26,0,73
WILKINSON,6/19/2020,47,26,0,73
WILKINSON,6/20/2020,47,26,0,73
WILKINSON,6/21/2020,47,26,0,73
WILKINSON,6/22/2020,48,26,0,74
WILKINSON,6/23/2020,48,26,0,74
WILKINSON,6/24/2020,48,27,0,75
WILKINSON,6/25/2020,48,27,0,75
WILKINSON,6/26/2020,50,28,0,78
WILKINSON,6/27/2020,51,30,0,81
WILKINSON,6/28/2020,51,30,0,81
WILKINSON,6/29/2020,54,31,0,85
WILKINSON,6/30/2020,59,32,0,91
WILKINSON,7/1/2020,67,37,0,104
WILKINSON,7/2/2020,69,38,0,107
WILKINSON,7/3/2020,71,41,0,112
WILKINSON,7/4/2020,71,41,0,112
WILKINSON,7/5/2020,71,42,0,113
WILKINSON,7/6/2020,75,47,0,122
WILKINSON,7/7/2020,78,48,0,126
WILKINSON,7/8/2020,78,52,0,130
WILKINSON,7/9/2020,80,53,0,133
WILKINSON,7/10/2020,83,53,0,136
WILKINSON,7/11/2020,85,56,0,141
WILKINSON,7/12/2020,87,57,0,144
WILKINSON,7/13/2020,89,62,0,151
WILKINSON,7/14/2020,92,63,0,155
WILKINSON,7/15/2020,94,67,0,161
WILKINSON,7/16/2020,95,68,0,163
WILKINSON,7/17/2020,97,69,0,166
WILKINSON,7/18/2020,97,69,0,166
WILKINSON,7/19/2020,99,70,0,169
WILKINSON,7/20/2020,99,74,0,173
WILKINSON,7/21/2020,100,75,0,175
WILKINSON,7/22/2020,103,77,0,180
WILKINSON,7/23/2020,104,79,0,183
WILKINSON,7/24/2020,109,80,0,189
WILKINSON,7/25/2020,109,80,0,189
WILKINSON,7/26/2020,110,80,0,190
WILKINSON,7/27/2020,111,81,0,192
WILKINSON,7/28/2020,114,82,0,196
WILKINSON,7/29/2020,114,83,0,197
WILKINSON,7/30/2020,116,84,0,200
WILKINSON,7/31/2020,118,85,0,203
WILKINSON,8/1/2020,120,88,0,208
WILKINSON,8/2/2020,122,89,0,211
WILKINSON,8/3/2020,129,93,0,222
WILKINSON,8/4/2020,132,93,1,226
WILKINSON,8/5/2020,138,95,1,234
WILKINSON,8/6/2020,140,99,1,240
WILKINSON,8/7/2020,140,101,1,242
WILKINSON,8/8/2020,142,102,1,245
WILKINSON,8/9/2020,143,103,1,247
WILKINSON,8/10/2020,145,107,1,253
WILKINSON,8/11/2020,145,109,1,255
WILKINSON,8/12/2020,145,109,1,255
WILKINSON,8/13/2020,147,110,1,258
WILKINSON,8/14/2020,149,111,1,261
WILKINSON,8/15/2020,149,111,1,261
WILKINSON,8/16/2020,151,112,1,264
WILKINSON,8/17/2020,152,113,1,266
WILKINSON,8/18/2020,154,114,1,269
WILKINSON,8/19/2020,158,116,1,275
WILKINSON,8/20/2020,160,116,1,277
WILKINSON,8/21/2020,162,120,1,283
WILKINSON,8/22/2020,163,120,1,284
WILKINSON,8/23/2020,166,124,1,291
WILKINSON,8/24/2020,166,124,1,291
WILKINSON,8/25/2020,169,126,1,296
WILKINSON,8/26/2020,170,126,1,297
WILKINSON,8/27/2020,173,127,1,301
WILKINSON,8/28/2020,176,130,1,307
WILKINSON,8/29/2020,176,130,1,307
WILKINSON,8/30/2020,176,130,1,307
WILKINSON,8/31/2020,177,130,1,308
WILKINSON,9/1/2020,178,133,1,312
WILKINSON,9/2/2020,178,134,1,313
WILKINSON,9/3/2020,178,138,1,317
WILKINSON,9/4/2020,182,140,1,323
WILKINSON,9/5/2020,183,141,1,325
WILKINSON,9/6/2020,183,142,1,326
WILKINSON,9/7/2020,183,142,1,326
WILKINSON,9/8/2020,183,143,1,327
WILKINSON,9/9/2020,183,144,1,328
WILKINSON,9/10/2020,183,146,1,330
WILKINSON,9/11/2020,184,146,1,331
WILKINSON,9/12/2020,184,146,1,331
WILKINSON,9/13/2020,184,146,1,331
WILKINSON,9/14/2020,184,147,1,332
WILKINSON,9/15/2020,185,147,1,333
WILKINSON,9/16/2020,186,147,1,334
WILKINSON,9/17/2020,186,148,1,335
WILKINSON,9/18/2020,187,148,1,336
WILKINSON,9/19/2020,188,149,1,338
WILKINSON,9/20/2020,188,149,1,338
WILKINSON,9/21/2020,189,149,1,339
WILKINSON,9/22/2020,190,150,1,341
WILKINSON,9/23/2020,190,150,1,341
WILKINSON,9/24/2020,191,151,1,343
WILKINSON,9/25/2020,191,152,1,344
WILKINSON,9/26/2020,191,152,1,344
WILKINSON,9/27/2020,192,153,1,346
WILKINSON,9/28/2020,194,153,1,348
WILKINSON,9/29/2020,194,153,1,348
WILKINSON,9/30/2020,194,153,1,348
WILKINSON,10/1/2020,197,153,1,351
WILKINSON,10/2/2020,197,154,1,352
WILKINSON,10/3/2020,197,154,1,352
WILKINSON,10/4/2020,197,154,1,352
WILKINSON,10/5/2020,197,155,1,353
WILKINSON,10/6/2020,199,155,1,355
WILKINSON,10/7/2020,199,155,1,355
WILKINSON,10/8/2020,200,155,1,356
WILKINSON,10/9/2020,200,155,1,356
WILKINSON,10/10/2020,200,155,1,356
WILKINSON,10/11/2020,200,155,1,356
WILKINSON,10/12/2020,200,155,1,356
WILKINSON,10/13/2020,201,156,1,358
WILKINSON,10/14/2020,201,156,1,358
WILKINSON,10/15/2020,201,156,1,358
WILKINSON,10/16/2020,201,157,1,359
WILKINSON,10/17/2020,201,157,1,359
WILKINSON,10/18/2020,201,157,1,359
WILKINSON,10/19/2020,201,157,1,359
WILKINSON,10/20/2020,201,157,1,359
CAMDEN,1/1/2020,0,0,0,0
CAMDEN,1/2/2020,0,0,0,0
CAMDEN,1/3/2020,0,0,0,0
CAMDEN,1/4/2020,0,0,0,0
CAMDEN,1/5/2020,0,0,0,0
CAMDEN,1/6/2020,0,0,0,0
CAMDEN,1/7/2020,0,0,0,0
CAMDEN,1/8/2020,0,0,0,0
CAMDEN,1/9/2020,0,0,0,0
CAMDEN,1/10/2020,0,0,0,0
CAMDEN,1/11/2020,0,0,0,0
CAMDEN,1/12/2020,0,0,0,0
CAMDEN,1/13/2020,0,0,0,0
CAMDEN,1/14/2020,0,0,0,0
CAMDEN,1/15/2020,0,0,0,0
CAMDEN,1/16/2020,0,0,0,0
CAMDEN,1/17/2020,0,0,0,0
CAMDEN,1/18/2020,0,0,0,0
CAMDEN,1/19/2020,0,0,0,0
CAMDEN,1/20/2020,0,0,0,0
CAMDEN,1/21/2020,0,0,0,0
CAMDEN,1/22/2020,0,0,0,0
CAMDEN,1/23/2020,0,0,0,0
CAMDEN,1/24/2020,0,0,0,0
CAMDEN,1/25/2020,0,0,0,0
CAMDEN,1/26/2020,0,0,0,0
CAMDEN,1/27/2020,0,0,0,0
CAMDEN,1/28/2020,0,0,0,0
CAMDEN,1/29/2020,0,0,0,0
CAMDEN,1/30/2020,0,0,0,0
CAMDEN,1/31/2020,0,0,0,0
CAMDEN,2/1/2020,0,0,0,0
CAMDEN,2/2/2020,0,0,0,0
CAMDEN,2/3/2020,0,0,0,0
CAMDEN,2/4/2020,0,0,0,0
CAMDEN,2/5/2020,0,0,0,0
CAMDEN,2/6/2020,0,0,0,0
CAMDEN,2/7/2020,0,0,0,0
CAMDEN,2/8/2020,0,0,0,0
CAMDEN,2/9/2020,0,0,0,0
CAMDEN,2/10/2020,0,0,0,0
CAMDEN,2/11/2020,0,0,0,0
CAMDEN,2/12/2020,0,0,0,0
CAMDEN,2/13/2020,0,0,0,0
CAMDEN,2/14/2020,0,0,0,0
CAMDEN,2/15/2020,0,0,0,0
CAMDEN,2/16/2020,0,0,0,0
CAMDEN,2/17/2020,0,0,0,0
CAMDEN,2/18/2020,0,0,0,0
CAMDEN,2/19/2020,0,0,0,0
CAMDEN,2/20/2020,0,0,0,0
CAMDEN,2/21/2020,0,0,0,0
CAMDEN,2/22/2020,0,0,0,0
CAMDEN,2/23/2020,0,0,0,0
CAMDEN,2/24/2020,0,0,0,0
CAMDEN,2/25/2020,0,0,0,0
CAMDEN,2/26/2020,0,0,0,0
CAMDEN,2/27/2020,0,0,0,0
CAMDEN,2/28/2020,0,0,0,0
CAMDEN,2/29/2020,0,0,0,0
CAMDEN,3/1/2020,0,0,0,0
CAMDEN,3/2/2020,0,0,0,0
CAMDEN,3/3/2020,0,0,0,0
CAMDEN,3/4/2020,0,0,0,0
CAMDEN,3/5/2020,0,0,0,0
CAMDEN,3/6/2020,0,0,0,0
CAMDEN,3/7/2020,0,0,0,0
CAMDEN,3/8/2020,0,0,0,0
CAMDEN,3/9/2020,0,0,0,0
CAMDEN,3/10/2020,0,0,0,0
CAMDEN,3/11/2020,0,0,0,0
CAMDEN,3/12/2020,0,0,0,0
CAMDEN,3/13/2020,0,0,0,0
CAMDEN,3/14/2020,1,0,0,1
CAMDEN,3/15/2020,2,0,0,2
CAMDEN,3/16/2020,2,1,0,3
CAMDEN,3/17/2020,3,1,0,4
CAMDEN,3/18/2020,3,1,0,4
CAMDEN,3/19/2020,4,1,0,5
CAMDEN,3/20/2020,5,2,0,7
CAMDEN,3/21/2020,5,3,0,8
CAMDEN,3/22/2020,6,4,0,10
CAMDEN,3/23/2020,7,4,0,11
CAMDEN,3/24/2020,7,5,0,12
CAMDEN,3/25/2020,7,6,0,13
CAMDEN,3/26/2020,7,6,0,13
CAMDEN,3/27/2020,9,6,0,15
CAMDEN,3/28/2020,10,8,0,18
CAMDEN,3/29/2020,10,8,0,18
CAMDEN,3/30/2020,10,10,0,20
CAMDEN,3/31/2020,10,11,0,21
CAMDEN,4/1/2020,11,11,0,22
CAMDEN,4/2/2020,12,11,0,23
CAMDEN,4/3/2020,12,11,0,23
CAMDEN,4/4/2020,12,11,0,23
CAMDEN,4/5/2020,12,11,0,23
CAMDEN,4/6/2020,12,11,0,23
CAMDEN,4/7/2020,13,11,0,24
CAMDEN,4/8/2020,15,12,0,27
CAMDEN,4/9/2020,15,12,0,27
CAMDEN,4/10/2020,15,12,0,27
CAMDEN,4/11/2020,15,12,0,27
CAMDEN,4/12/2020,15,13,0,28
CAMDEN,4/13/2020,15,14,0,29
CAMDEN,4/14/2020,15,14,0,29
CAMDEN,4/15/2020,16,14,0,30
CAMDEN,4/16/2020,17,14,0,31
CAMDEN,4/17/2020,18,14,0,32
CAMDEN,4/18/2020,19,14,0,33
CAMDEN,4/19/2020,19,14,0,33
CAMDEN,4/20/2020,20,14,0,34
CAMDEN,4/21/2020,20,14,0,34
CAMDEN,4/22/2020,21,14,0,35
CAMDEN,4/23/2020,22,14,0,36
CAMDEN,4/24/2020,22,14,0,36
CAMDEN,4/25/2020,22,14,0,36
CAMDEN,4/26/2020,22,15,0,37
CAMDEN,4/27/2020,22,15,0,37
CAMDEN,4/28/2020,22,15,0,37
CAMDEN,4/29/2020,22,15,0,37
CAMDEN,4/30/2020,23,15,0,38
CAMDEN,5/1/2020,24,15,0,39
CAMDEN,5/2/2020,24,15,0,39
CAMDEN,5/3/2020,25,15,0,40
CAMDEN,5/4/2020,26,15,0,41
CAMDEN,5/5/2020,30,17,0,47
CAMDEN,5/6/2020,33,17,0,50
CAMDEN,5/7/2020,37,18,0,55
CAMDEN,5/8/2020,37,18,0,55
CAMDEN,5/9/2020,37,18,0,55
CAMDEN,5/10/2020,38,18,0,56
CAMDEN,5/11/2020,39,22,0,61
CAMDEN,5/12/2020,39,22,0,61
CAMDEN,5/13/2020,39,22,0,61
CAMDEN,5/14/2020,40,22,0,62
CAMDEN,5/15/2020,42,22,0,64
CAMDEN,5/16/2020,42,22,0,64
CAMDEN,5/17/2020,42,22,0,64
CAMDEN,5/18/2020,45,25,0,70
CAMDEN,5/19/2020,45,25,0,70
CAMDEN,5/20/2020,45,25,0,70
CAMDEN,5/21/2020,47,25,0,72
CAMDEN,5/22/2020,48,25,0,73
CAMDEN,5/23/2020,49,26,0,75
CAMDEN,5/24/2020,49,26,0,75
CAMDEN,5/25/2020,49,26,0,75
CAMDEN,5/26/2020,49,26,0,75
CAMDEN,5/27/2020,50,27,0,77
CAMDEN,5/28/2020,51,27,0,78
CAMDEN,5/29/2020,52,27,0,79
CAMDEN,5/30/2020,52,27,0,79
CAMDEN,5/31/2020,52,28,0,80
CAMDEN,6/1/2020,53,28,0,81
CAMDEN,6/2/2020,54,28,0,82
CAMDEN,6/3/2020,57,29,0,86
CAMDEN,6/4/2020,57,29,0,86
CAMDEN,6/5/2020,57,29,0,86
CAMDEN,6/6/2020,57,30,0,87
CAMDEN,6/7/2020,57,30,0,87
CAMDEN,6/8/2020,58,30,0,88
CAMDEN,6/9/2020,58,30,0,88
CAMDEN,6/10/2020,59,31,0,90
CAMDEN,6/11/2020,60,32,0,92
CAMDEN,6/12/2020,60,34,0,94
CAMDEN,6/13/2020,60,34,0,94
CAMDEN,6/14/2020,63,35,0,98
CAMDEN,6/15/2020,66,39,0,105
CAMDEN,6/16/2020,69,41,0,110
CAMDEN,6/17/2020,73,44,0,117
CAMDEN,6/18/2020,75,44,0,119
CAMDEN,6/19/2020,77,47,1,125
CAMDEN,6/20/2020,78,50,1,129
CAMDEN,6/21/2020,80,51,1,132
CAMDEN,6/22/2020,86,53,1,140
CAMDEN,6/23/2020,89,55,1,145
CAMDEN,6/24/2020,92,60,1,153
CAMDEN,6/25/2020,98,67,1,166
CAMDEN,6/26/2020,106,70,1,177
CAMDEN,6/27/2020,109,74,1,184
CAMDEN,6/28/2020,111,74,1,186
CAMDEN,6/29/2020,120,84,1,205
CAMDEN,6/30/2020,127,92,1,220
CAMDEN,7/1/2020,140,100,1,241
CAMDEN,7/2/2020,151,112,1,264
CAMDEN,7/3/2020,156,121,1,278
CAMDEN,7/4/2020,159,126,1,286
CAMDEN,7/5/2020,167,133,1,301
CAMDEN,7/6/2020,174,140,1,315
CAMDEN,7/7/2020,187,146,1,334
CAMDEN,7/8/2020,196,159,1,356
HART,9/16/2020,293,207,7,507
HART,9/17/2020,294,210,7,511
HART,9/18/2020,295,212,7,514
HART,9/19/2020,296,215,7,518
HART,9/20/2020,296,219,7,522
HART,9/21/2020,300,221,7,528
HART,9/22/2020,300,223,7,530
HART,9/23/2020,302,224,7,533
HART,9/24/2020,303,225,7,535
HART,9/25/2020,306,227,8,541
HART,9/26/2020,306,227,8,541
HART,9/27/2020,306,227,8,541
HART,9/28/2020,307,227,8,542
HART,9/29/2020,308,228,8,544
HART,9/30/2020,308,228,8,544
HART,10/1/2020,308,228,8,544
HART,10/2/2020,309,228,8,545
HART,10/3/2020,310,228,8,546
HART,10/4/2020,310,229,8,547
HART,10/5/2020,310,230,8,548
HART,10/6/2020,311,231,8,550
HART,10/7/2020,312,231,8,551
HART,10/8/2020,312,231,8,551
HART,10/9/2020,313,231,9,553
HART,10/10/2020,315,231,9,555
HART,10/11/2020,315,231,9,555
HART,10/12/2020,316,231,9,556
HART,10/13/2020,316,232,9,557
HART,10/14/2020,317,232,9,558
HART,10/15/2020,317,232,9,558
HART,10/16/2020,319,232,9,560
HART,10/17/2020,319,232,9,560
HART,10/18/2020,320,233,9,562
HART,10/19/2020,320,233,9,562
HART,10/20/2020,320,233,9,562
BERRIEN,1/1/2020,0,0,0,0
BERRIEN,1/2/2020,0,0,0,0
BERRIEN,1/3/2020,0,0,0,0
BERRIEN,1/4/2020,0,0,0,0
BERRIEN,1/5/2020,0,0,0,0
BERRIEN,1/6/2020,0,0,0,0
BERRIEN,1/7/2020,0,0,0,0
BERRIEN,1/8/2020,0,0,0,0
BERRIEN,1/9/2020,0,0,0,0
BERRIEN,1/10/2020,0,0,0,0
BERRIEN,1/11/2020,0,0,0,0
BERRIEN,1/12/2020,0,0,0,0
BERRIEN,1/13/2020,0,0,0,0
BERRIEN,1/14/2020,0,0,0,0
BERRIEN,1/15/2020,0,0,0,0
BERRIEN,1/16/2020,0,0,0,0
BERRIEN,1/17/2020,0,0,0,0
BERRIEN,1/18/2020,0,0,0,0
BERRIEN,1/19/2020,0,0,0,0
BERRIEN,1/20/2020,0,0,0,0
BERRIEN,1/21/2020,0,0,0,0
BERRIEN,1/22/2020,0,0,0,0
BERRIEN,1/23/2020,0,0,0,0
BERRIEN,1/24/2020,0,0,0,0
BERRIEN,1/25/2020,0,0,0,0
BERRIEN,1/26/2020,0,0,0,0
BERRIEN,1/27/2020,0,0,0,0
BERRIEN,1/28/2020,0,0,0,0
BERRIEN,1/29/2020,0,0,0,0
BERRIEN,1/30/2020,0,0,0,0
BERRIEN,1/31/2020,0,0,0,0
BERRIEN,2/1/2020,0,0,0,0
BERRIEN,2/2/2020,0,0,0,0
BERRIEN,2/3/2020,0,0,0,0
BERRIEN,2/4/2020,0,0,0,0
BERRIEN,2/5/2020,0,0,0,0
BERRIEN,2/6/2020,0,0,0,0
BERRIEN,2/7/2020,0,0,0,0
BERRIEN,2/8/2020,0,0,0,0
BERRIEN,2/9/2020,0,0,0,0
BERRIEN,2/10/2020,0,0,0,0
BERRIEN,2/11/2020,0,0,0,0
BERRIEN,2/12/2020,0,0,0,0
BERRIEN,2/13/2020,0,0,0,0
BERRIEN,2/14/2020,0,0,0,0
BERRIEN,2/15/2020,0,0,0,0
BERRIEN,2/16/2020,0,0,0,0
BERRIEN,2/17/2020,0,0,0,0
BERRIEN,2/18/2020,0,0,0,0
BERRIEN,2/19/2020,0,0,0,0
BERRIEN,2/20/2020,0,0,0,0
BERRIEN,2/21/2020,0,0,0,0
BERRIEN,2/22/2020,0,0,0,0
BERRIEN,2/23/2020,0,0,0,0
BERRIEN,2/24/2020,0,0,0,0
BERRIEN,2/25/2020,0,0,0,0
BERRIEN,2/26/2020,0,0,0,0
BERRIEN,2/27/2020,0,0,0,0
BERRIEN,2/28/2020,0,0,0,0
BERRIEN,2/29/2020,0,0,0,0
BERRIEN,3/1/2020,0,0,0,0
BERRIEN,3/2/2020,0,0,0,0
BERRIEN,3/3/2020,0,0,0,0
BERRIEN,3/4/2020,0,0,0,0
BERRIEN,3/5/2020,0,0,0,0
BERRIEN,3/6/2020,0,0,0,0
BERRIEN,3/7/2020,0,0,0,0
BERRIEN,3/8/2020,0,0,0,0
BERRIEN,3/9/2020,0,1,0,1
BERRIEN,3/10/2020,0,1,0,1
BERRIEN,3/11/2020,0,1,0,1
BERRIEN,3/12/2020,0,1,0,1
BERRIEN,3/13/2020,0,1,0,1
BERRIEN,3/14/2020,0,1,0,1
BERRIEN,3/15/2020,0,1,0,1
BERRIEN,3/16/2020,0,1,0,1
BERRIEN,3/17/2020,0,1,0,1
BERRIEN,3/18/2020,0,1,0,1
BERRIEN,3/19/2020,0,1,0,1
BERRIEN,3/20/2020,0,1,0,1
BERRIEN,3/21/2020,0,1,0,1
BERRIEN,3/22/2020,0,1,0,1
BERRIEN,3/23/2020,0,1,0,1
BERRIEN,3/24/2020,0,1,0,1
BERRIEN,3/25/2020,0,1,0,1
BERRIEN,3/26/2020,2,1,0,3
BERRIEN,3/27/2020,2,1,0,3
BERRIEN,3/28/2020,2,1,0,3
BERRIEN,3/29/2020,2,1,0,3
BERRIEN,3/30/2020,2,3,0,5
BERRIEN,3/31/2020,2,3,0,5
BERRIEN,4/1/2020,2,4,0,6
BERRIEN,4/2/2020,2,4,0,6
BERRIEN,4/3/2020,3,4,0,7
BERRIEN,4/4/2020,3,4,0,7
BERRIEN,4/5/2020,4,4,0,8
BERRIEN,4/6/2020,5,4,0,9
BERRIEN,4/7/2020,7,4,0,11
BERRIEN,4/8/2020,7,4,0,11
BERRIEN,4/9/2020,7,4,0,11
BERRIEN,4/10/2020,7,5,0,12
BERRIEN,4/11/2020,7,5,0,12
BERRIEN,4/12/2020,7,5,0,12
BERRIEN,4/13/2020,7,5,0,12
BERRIEN,4/14/2020,7,6,0,13
BERRIEN,4/15/2020,7,6,0,13
BERRIEN,4/16/2020,7,6,0,13
BERRIEN,4/17/2020,7,6,0,13
BERRIEN,4/18/2020,7,6,0,13
BERRIEN,4/19/2020,7,6,0,13
BERRIEN,4/20/2020,8,7,0,15
BERRIEN,4/21/2020,8,7,0,15
BERRIEN,4/22/2020,9,7,0,16
BERRIEN,4/23/2020,9,8,0,17
BERRIEN,4/24/2020,9,8,0,17
BERRIEN,4/25/2020,9,8,0,17
BERRIEN,4/26/2020,9,9,0,18
BERRIEN,4/27/2020,9,10,0,19
BERRIEN,4/28/2020,9,10,0,19
BERRIEN,4/29/2020,9,10,0,19
BERRIEN,4/30/2020,9,10,0,19
BERRIEN,5/1/2020,9,10,0,19
BERRIEN,5/2/2020,9,10,0,19
BERRIEN,5/3/2020,9,10,0,19
BERRIEN,5/4/2020,9,11,0,20
BERRIEN,5/5/2020,9,11,0,20
BERRIEN,5/6/2020,9,11,0,20
BERRIEN,5/7/2020,9,11,0,20
BERRIEN,5/8/2020,9,11,0,20
BERRIEN,5/9/2020,9,11,0,20
BERRIEN,5/10/2020,9,12,0,21
BERRIEN,5/11/2020,9,12,0,21
BERRIEN,5/12/2020,9,13,0,22
BERRIEN,5/13/2020,9,13,0,22
BERRIEN,5/14/2020,9,14,0,23
BERRIEN,5/15/2020,10,15,0,25
BERRIEN,5/16/2020,10,16,0,26
BERRIEN,5/17/2020,11,16,0,27
BERRIEN,5/18/2020,13,17,0,30
BERRIEN,5/19/2020,16,18,0,34
BERRIEN,5/20/2020,17,18,0,35
BERRIEN,5/21/2020,18,18,0,36
BERRIEN,5/22/2020,18,19,0,37
BERRIEN,5/23/2020,18,19,0,37
BERRIEN,5/24/2020,19,20,0,39
BERRIEN,5/25/2020,20,20,0,40
BERRIEN,5/26/2020,21,22,0,43
BERRIEN,5/27/2020,22,25,0,47
BERRIEN,5/28/2020,23,25,0,48
BERRIEN,5/29/2020,23,25,0,48
BERRIEN,5/30/2020,23,25,0,48
BERRIEN,5/31/2020,23,25,0,48
BERRIEN,6/1/2020,25,25,1,51
BERRIEN,6/2/2020,26,26,1,53
BERRIEN,6/3/2020,27,26,1,54
BERRIEN,6/4/2020,30,29,1,60
BERRIEN,6/5/2020,32,29,1,62
BERRIEN,6/6/2020,33,30,1,64
BERRIEN,6/7/2020,33,31,1,65
BERRIEN,6/8/2020,35,32,1,68
BERRIEN,6/9/2020,36,33,4,73
BERRIEN,6/10/2020,36,34,4,74
BERRIEN,6/11/2020,37,36,4,77
BERRIEN,6/12/2020,39,36,4,79
BERRIEN,6/13/2020,40,38,4,82
BERRIEN,6/14/2020,41,39,4,84
BERRIEN,6/15/2020,47,41,4,92
BERRIEN,6/16/2020,47,42,4,93
BERRIEN,6/17/2020,48,44,4,96
BERRIEN,6/18/2020,50,47,4,101
BERRIEN,6/19/2020,50,48,4,102
BERRIEN,6/20/2020,50,48,4,102
BERRIEN,6/21/2020,52,50,4,106
BERRIEN,6/22/2020,54,53,4,111
BERRIEN,6/23/2020,58,55,4,117
BERRIEN,6/24/2020,58,57,4,119
BERRIEN,6/25/2020,59,58,5,122
BERRIEN,6/26/2020,60,58,5,123
BERRIEN,6/27/2020,60,59,5,124
BERRIEN,6/28/2020,62,59,5,126
BERRIEN,6/29/2020,67,61,5,133
BERRIEN,6/30/2020,71,66,5,142
BERRIEN,7/1/2020,72,67,5,144
BERRIEN,7/2/2020,75,68,5,148
BERRIEN,7/3/2020,76,68,5,149
BERRIEN,7/4/2020,78,68,6,152
BERRIEN,7/5/2020,79,68,6,153
BERRIEN,7/6/2020,83,72,6,161
BERRIEN,7/7/2020,87,78,6,171
BERRIEN,7/8/2020,88,81,6,175
BERRIEN,7/9/2020,89,82,6,177
BERRIEN,7/10/2020,93,84,6,183
BERRIEN,7/11/2020,93,84,6,183
BERRIEN,7/12/2020,97,84,6,187
BERRIEN,7/13/2020,104,86,6,196
BERRIEN,7/14/2020,108,87,6,201
BERRIEN,7/15/2020,110,87,6,203
BERRIEN,7/16/2020,110,87,6,203
BERRIEN,7/17/2020,115,88,6,209
BERRIEN,7/18/2020,116,89,6,211
BERRIEN,7/19/2020,119,91,6,216
BERRIEN,7/20/2020,122,93,6,221
BERRIEN,7/21/2020,124,96,6,226
BERRIEN,7/22/2020,128,99,6,233
BERRIEN,7/23/2020,129,99,6,234
BERRIEN,7/24/2020,131,103,6,240
BERRIEN,7/25/2020,131,103,6,240
BERRIEN,7/26/2020,132,104,6,242
BERRIEN,7/27/2020,133,110,6,249
BERRIEN,7/28/2020,134,110,6,250
BERRIEN,7/29/2020,136,114,6,256
BERRIEN,7/30/2020,141,117,6,264
BERRIEN,7/31/2020,142,117,7,266
BERRIEN,8/1/2020,144,117,7,268
BERRIEN,8/2/2020,146,118,7,271
BERRIEN,8/3/2020,159,121,8,288
BERRIEN,8/4/2020,165,125,8,298
BERRIEN,8/5/2020,167,127,8,302
BERRIEN,8/6/2020,169,128,8,305
BERRIEN,8/7/2020,169,133,8,310
BERRIEN,8/8/2020,174,133,8,315
BERRIEN,8/9/2020,174,137,8,319
BERRIEN,8/10/2020,182,143,8,333
BERRIEN,8/11/2020,184,146,8,338
BERRIEN,8/12/2020,184,150,8,342
BERRIEN,8/13/2020,189,151,8,348
BERRIEN,8/14/2020,192,152,8,352
BERRIEN,8/15/2020,192,153,8,353
BERRIEN,8/16/2020,192,153,8,353
BERRIEN,8/17/2020,198,156,8,362
BERRIEN,8/18/2020,202,160,8,370
BERRIEN,8/19/2020,203,161,8,372
BERRIEN,8/20/2020,205,161,8,374
BERRIEN,8/21/2020,207,162,8,377
BERRIEN,8/22/2020,208,163,8,379
BERRIEN,8/23/2020,211,164,8,383
BERRIEN,8/24/2020,212,164,8,384
BERRIEN,8/25/2020,216,165,8,389
BERRIEN,8/26/2020,218,165,8,391
BERRIEN,8/27/2020,218,167,8,393
BERRIEN,8/28/2020,218,170,8,396
BERRIEN,8/29/2020,219,171,8,398
BERRIEN,8/30/2020,219,174,8,401
BERRIEN,8/31/2020,219,175,8,402
BERRIEN,9/1/2020,224,176,8,408
BERRIEN,9/2/2020,226,177,8,411
BERRIEN,9/3/2020,229,178,8,415
BERRIEN,9/4/2020,230,179,8,417
BERRIEN,9/5/2020,231,180,8,419
BERRIEN,9/6/2020,233,180,8,421
BERRIEN,9/7/2020,233,181,8,422
BERRIEN,9/8/2020,234,181,8,423
BERRIEN,9/9/2020,234,182,8,424
BERRIEN,9/10/2020,235,183,8,426
BERRIEN,9/11/2020,235,183,8,426
BERRIEN,9/12/2020,236,183,8,427
BERRIEN,9/13/2020,237,184,8,429
BERRIEN,9/14/2020,239,185,8,432
BERRIEN,9/15/2020,240,185,8,433
BERRIEN,9/16/2020,244,186,8,438
BERRIEN,9/17/2020,247,187,8,442
BERRIEN,9/18/2020,247,188,8,443
BERRIEN,9/19/2020,247,188,8,443
BERRIEN,9/20/2020,247,188,8,443
BERRIEN,9/21/2020,248,189,8,445
BERRIEN,9/22/2020,249,190,8,447
BERRIEN,9/23/2020,249,190,8,447
BERRIEN,9/24/2020,249,191,8,448
BERRIEN,9/25/2020,252,192,8,452
BERRIEN,9/26/2020,253,193,8,454
BERRIEN,9/27/2020,254,193,8,455
BERRIEN,9/28/2020,257,196,8,461
BERRIEN,9/29/2020,257,196,8,461
BERRIEN,9/30/2020,259,196,8,463
BERRIEN,10/1/2020,259,196,8,463
BERRIEN,10/2/2020,259,196,8,463
BERRIEN,10/3/2020,259,197,8,464
BERRIEN,10/4/2020,260,198,8,466
BERRIEN,10/5/2020,261,198,8,467
BERRIEN,10/6/2020,263,198,8,469
BERRIEN,10/7/2020,264,198,8,470
BERRIEN,10/8/2020,264,199,8,471
BERRIEN,10/9/2020,265,200,8,473
BERRIEN,10/10/2020,266,200,8,474
BERRIEN,10/11/2020,267,201,8,476
BERRIEN,10/12/2020,267,202,8,477
BERRIEN,10/13/2020,267,202,8,477
BERRIEN,10/14/2020,268,202,8,478
BERRIEN,10/15/2020,268,202,8,478
BERRIEN,10/16/2020,268,203,8,479
BERRIEN,10/17/2020,268,204,8,480
BERRIEN,10/18/2020,268,204,8,480
BERRIEN,10/19/2020,268,204,8,480
BERRIEN,10/20/2020,268,204,8,480
HANCOCK,1/1/2020,0,0,0,0
HANCOCK,1/2/2020,0,0,0,0
HANCOCK,1/3/2020,0,0,0,0
HANCOCK,1/4/2020,0,0,0,0
HANCOCK,1/5/2020,0,0,0,0
HANCOCK,1/6/2020,0,0,0,0
HANCOCK,1/7/2020,0,0,0,0
HANCOCK,1/8/2020,0,0,0,0
HANCOCK,1/9/2020,0,0,0,0
HANCOCK,1/10/2020,0,0,0,0
HANCOCK,1/11/2020,0,0,0,0
HANCOCK,1/12/2020,0,0,0,0
HANCOCK,1/13/2020,0,0,0,0
HANCOCK,1/14/2020,0,0,0,0
HANCOCK,1/15/2020,0,0,0,0
HANCOCK,1/16/2020,0,0,0,0
HANCOCK,1/17/2020,0,0,0,0
HANCOCK,1/18/2020,0,0,0,0
HANCOCK,1/19/2020,0,0,0,0
HANCOCK,1/20/2020,0,0,0,0
HANCOCK,1/21/2020,0,0,0,0
HANCOCK,1/22/2020,0,0,0,0
HANCOCK,1/23/2020,0,0,0,0
HANCOCK,1/24/2020,0,0,0,0
HANCOCK,1/25/2020,0,0,0,0
HANCOCK,1/26/2020,0,0,0,0
HANCOCK,1/27/2020,0,0,0,0
HANCOCK,1/28/2020,0,0,0,0
HANCOCK,1/29/2020,0,0,0,0
HANCOCK,1/30/2020,0,0,0,0
HANCOCK,1/31/2020,0,0,0,0
HANCOCK,2/1/2020,0,0,0,0
HANCOCK,2/2/2020,0,0,0,0
HANCOCK,2/3/2020,0,0,0,0
HANCOCK,2/4/2020,0,0,0,0
HANCOCK,2/5/2020,0,0,0,0
HANCOCK,2/6/2020,0,0,0,0
HANCOCK,2/7/2020,0,0,0,0
HANCOCK,2/8/2020,0,0,0,0
HANCOCK,2/9/2020,0,0,0,0
HANCOCK,2/10/2020,0,0,0,0
HANCOCK,2/11/2020,0,0,0,0
HANCOCK,2/12/2020,0,0,0,0
HANCOCK,2/13/2020,0,0,0,0
HANCOCK,2/14/2020,0,0,0,0
HANCOCK,2/15/2020,0,0,0,0
HANCOCK,2/16/2020,0,0,0,0
HANCOCK,2/17/2020,0,0,0,0
HANCOCK,2/18/2020,0,0,0,0
HANCOCK,2/19/2020,0,0,0,0
HANCOCK,2/20/2020,0,0,0,0
HANCOCK,2/21/2020,0,0,0,0
HANCOCK,2/22/2020,0,0,0,0
HANCOCK,2/23/2020,0,0,0,0
HANCOCK,2/24/2020,0,0,0,0
HANCOCK,2/25/2020,0,0,0,0
HANCOCK,2/26/2020,0,0,0,0
HANCOCK,2/27/2020,0,0,0,0
HANCOCK,2/28/2020,0,0,0,0
HANCOCK,2/29/2020,0,0,0,0
DODGE,4/18/2020,19,7,0,26
DODGE,4/19/2020,19,7,0,26
DODGE,4/20/2020,19,7,0,26
DODGE,4/21/2020,21,8,0,29
DODGE,4/22/2020,21,8,0,29
DODGE,4/23/2020,22,8,0,30
DODGE,4/24/2020,23,8,0,31
DODGE,4/25/2020,23,8,0,31
DODGE,4/26/2020,23,8,0,31
DODGE,4/27/2020,25,9,0,34
DODGE,4/28/2020,25,9,0,34
DODGE,4/29/2020,25,10,0,35
DODGE,4/30/2020,25,10,0,35
DODGE,5/1/2020,27,10,0,37
DODGE,5/2/2020,28,12,0,40
DODGE,5/3/2020,28,12,0,40
DODGE,5/4/2020,28,12,0,40
DODGE,5/5/2020,28,12,0,40
DODGE,5/6/2020,28,13,0,41
DODGE,5/7/2020,28,14,0,42
DODGE,5/8/2020,31,14,0,45
DODGE,5/9/2020,31,14,0,45
DODGE,5/10/2020,31,14,0,45
DODGE,5/11/2020,33,16,0,49
DODGE,5/12/2020,33,16,0,49
DODGE,5/13/2020,34,17,0,51
DODGE,5/14/2020,34,17,0,51
DODGE,5/15/2020,34,17,0,51
DODGE,5/16/2020,34,17,0,51
DODGE,5/17/2020,34,17,0,51
DODGE,5/18/2020,34,18,0,52
DODGE,5/19/2020,34,18,0,52
DODGE,5/20/2020,35,18,0,53
DODGE,5/21/2020,36,18,0,54
DODGE,5/22/2020,36,19,0,55
DODGE,5/23/2020,36,19,0,55
DODGE,5/24/2020,36,19,0,55
DODGE,5/25/2020,36,19,0,55
DODGE,5/26/2020,36,19,0,55
DODGE,5/27/2020,36,19,0,55
DODGE,5/28/2020,36,21,0,57
DODGE,5/29/2020,36,21,0,57
DODGE,5/30/2020,36,21,0,57
DODGE,5/31/2020,36,21,0,57
DODGE,6/1/2020,36,22,0,58
DODGE,6/2/2020,36,23,0,59
DODGE,6/3/2020,36,24,0,60
DODGE,6/4/2020,36,24,0,60
DODGE,6/5/2020,36,24,0,60
DODGE,6/6/2020,36,24,0,60
DODGE,6/7/2020,37,24,0,61
DODGE,6/8/2020,38,24,0,62
DODGE,6/9/2020,38,24,0,62
DODGE,6/10/2020,39,27,0,66
DODGE,6/11/2020,41,27,0,68
DODGE,6/12/2020,41,29,0,70
DODGE,6/13/2020,43,29,0,72
DODGE,6/14/2020,43,29,0,72
DODGE,6/15/2020,46,30,0,76
DODGE,6/16/2020,46,31,0,77
DODGE,6/17/2020,47,32,0,79
DODGE,6/18/2020,50,33,0,83
DODGE,6/19/2020,51,33,0,84
DODGE,6/20/2020,53,34,0,87
DODGE,6/21/2020,54,34,0,88
DODGE,6/22/2020,57,35,0,92
DODGE,6/23/2020,57,38,0,95
DODGE,6/24/2020,60,40,0,100
DODGE,6/25/2020,64,42,0,106
DODGE,6/26/2020,66,42,0,108
DODGE,6/27/2020,66,42,0,108
DODGE,6/28/2020,66,42,0,108
DODGE,6/29/2020,67,42,0,109
DODGE,6/30/2020,68,42,0,110
DODGE,7/1/2020,70,42,0,112
DODGE,7/2/2020,75,46,0,121
DODGE,7/3/2020,76,46,0,122
DODGE,7/4/2020,76,46,0,122
DODGE,7/5/2020,76,47,0,123
DODGE,7/6/2020,78,47,0,125
DODGE,7/7/2020,78,47,0,125
DODGE,7/8/2020,79,50,0,129
DODGE,7/9/2020,82,52,0,134
DODGE,7/10/2020,82,54,0,136
DODGE,7/11/2020,82,56,0,138
DODGE,7/12/2020,84,59,0,143
DODGE,7/13/2020,88,59,0,147
DODGE,7/14/2020,91,59,0,150
DODGE,7/15/2020,94,60,0,154
DODGE,7/16/2020,95,61,0,156
DODGE,7/17/2020,98,63,0,161
DODGE,7/18/2020,103,70,0,173
DODGE,7/19/2020,105,72,0,177
DODGE,7/20/2020,107,73,0,180
DODGE,7/21/2020,112,76,0,188
DODGE,7/22/2020,114,76,0,190
DODGE,7/23/2020,114,76,0,190
DODGE,7/24/2020,115,77,0,192
DODGE,7/25/2020,116,77,0,193
DODGE,7/26/2020,120,79,0,199
DODGE,7/27/2020,125,81,0,206
DODGE,7/28/2020,128,83,0,211
DODGE,7/29/2020,128,85,0,213
DODGE,7/30/2020,134,88,0,222
DODGE,7/31/2020,137,89,0,226
DODGE,8/1/2020,140,90,0,230
DODGE,8/2/2020,144,90,0,234
DODGE,8/3/2020,148,92,0,240
DODGE,8/4/2020,150,94,2,246
DODGE,8/5/2020,151,95,2,248
DODGE,8/6/2020,151,97,2,250
DODGE,8/7/2020,152,97,2,251
DODGE,8/8/2020,155,100,2,257
DODGE,8/9/2020,158,103,2,263
DODGE,8/10/2020,160,105,2,267
DODGE,8/11/2020,164,107,2,273
DODGE,8/12/2020,167,116,2,285
DODGE,8/13/2020,171,117,2,290
DODGE,8/14/2020,172,119,2,293
DODGE,8/15/2020,176,120,4,300
DODGE,8/16/2020,179,124,4,307
DODGE,8/17/2020,179,126,4,309
DODGE,8/18/2020,181,126,4,311
DODGE,8/19/2020,182,128,4,314
DODGE,8/20/2020,185,131,4,320
DODGE,8/21/2020,189,134,4,327
DODGE,8/22/2020,189,139,4,332
DODGE,8/23/2020,191,140,4,335
DODGE,8/24/2020,196,144,4,344
DODGE,8/25/2020,196,145,4,345
DODGE,8/26/2020,199,148,4,351
DODGE,8/27/2020,204,150,4,358
DODGE,8/28/2020,206,153,4,363
DODGE,8/29/2020,208,153,5,366
DODGE,8/30/2020,208,155,5,368
DODGE,8/31/2020,209,156,5,370
DODGE,9/1/2020,210,162,5,377
DODGE,9/2/2020,214,162,5,381
DODGE,9/3/2020,217,164,5,386
DODGE,9/4/2020,217,165,5,387
DODGE,9/5/2020,217,166,5,388
DODGE,9/6/2020,218,166,5,389
DODGE,9/7/2020,218,168,5,391
DODGE,9/8/2020,221,170,5,396
DODGE,9/9/2020,224,171,5,400
DODGE,9/10/2020,227,173,5,405
DODGE,9/11/2020,228,174,5,407
DODGE,9/12/2020,229,175,5,409
DODGE,9/13/2020,233,175,5,413
DODGE,9/14/2020,235,175,5,415
DODGE,9/15/2020,235,177,5,417
DODGE,9/16/2020,236,182,5,423
DODGE,9/17/2020,238,182,5,425
DODGE,9/18/2020,241,184,5,430
DODGE,9/19/2020,242,185,5,432
DODGE,9/20/2020,243,186,5,434
DODGE,9/21/2020,245,189,5,439
DODGE,9/22/2020,248,189,5,442
DODGE,9/23/2020,249,191,5,445
DODGE,9/24/2020,250,194,5,449
DODGE,9/25/2020,251,194,5,450
DODGE,9/26/2020,251,194,5,450
DODGE,9/27/2020,251,194,5,450
DODGE,9/28/2020,251,195,5,451
DODGE,9/29/2020,252,195,5,452
DODGE,9/30/2020,254,195,5,454
DODGE,10/1/2020,255,197,5,457
DODGE,10/2/2020,257,199,5,461
DODGE,10/3/2020,257,202,5,464
DODGE,10/4/2020,257,202,5,464
DODGE,10/5/2020,261,202,5,468
DODGE,10/6/2020,261,203,5,469
DODGE,10/7/2020,262,205,5,472
DODGE,10/8/2020,264,206,5,475
DODGE,10/9/2020,272,209,5,486
DODGE,10/10/2020,274,210,5,489
DODGE,10/11/2020,278,213,5,496
DODGE,10/12/2020,279,214,5,498
DODGE,10/13/2020,285,218,5,508
DODGE,10/14/2020,295,223,5,523
DODGE,10/15/2020,297,226,5,528
DODGE,10/16/2020,297,226,5,528
DODGE,10/17/2020,298,226,5,529
DODGE,10/18/2020,299,226,5,530
DODGE,10/19/2020,299,226,5,530
DODGE,10/20/2020,299,226,5,530
PIERCE,1/1/2020,0,0,0,0
PIERCE,1/2/2020,0,0,0,0
PIERCE,1/3/2020,0,0,0,0
PIERCE,1/4/2020,0,0,0,0
PIERCE,1/5/2020,0,0,0,0
PIERCE,1/6/2020,0,0,0,0
PIERCE,1/7/2020,0,0,0,0
PIERCE,1/8/2020,0,0,0,0
PIERCE,1/9/2020,0,0,0,0
PIERCE,1/10/2020,0,0,0,0
PIERCE,1/11/2020,0,0,0,0
PIERCE,1/12/2020,0,0,0,0
PIERCE,1/13/2020,0,0,0,0
PIERCE,1/14/2020,0,0,0,0
PIERCE,1/15/2020,0,0,0,0
PIERCE,1/16/2020,0,0,0,0
PIERCE,1/17/2020,0,0,0,0
PIERCE,1/18/2020,0,0,0,0
PIERCE,1/19/2020,0,0,0,0
PIERCE,1/20/2020,0,0,0,0
PIERCE,1/21/2020,0,0,0,0
PIERCE,1/22/2020,0,0,0,0
PIERCE,1/23/2020,0,0,0,0
PIERCE,1/24/2020,0,0,0,0
PIERCE,1/25/2020,0,0,0,0
PIERCE,1/26/2020,0,0,0,0
PIERCE,1/27/2020,0,0,0,0
PIERCE,1/28/2020,0,0,0,0
PIERCE,1/29/2020,0,0,0,0
PIERCE,1/30/2020,0,0,0,0
PIERCE,1/31/2020,0,0,0,0
PIERCE,2/1/2020,0,0,0,0
PIERCE,2/2/2020,0,0,0,0
PIERCE,2/3/2020,0,0,0,0
PIERCE,2/4/2020,0,0,0,0
PIERCE,2/5/2020,0,0,0,0
PIERCE,2/6/2020,0,0,0,0
PIERCE,2/7/2020,0,0,0,0
PIERCE,2/8/2020,0,0,0,0
PIERCE,2/9/2020,0,0,0,0
PIERCE,2/10/2020,0,0,0,0
PIERCE,2/11/2020,0,0,0,0
PIERCE,2/12/2020,0,0,0,0
PIERCE,2/13/2020,0,0,0,0
PIERCE,2/14/2020,0,0,0,0
PIERCE,2/15/2020,0,0,0,0
PIERCE,2/16/2020,0,0,0,0
PIERCE,2/17/2020,0,0,0,0
PIERCE,2/18/2020,0,0,0,0
PIERCE,2/19/2020,0,0,0,0
PIERCE,2/20/2020,0,0,0,0
PIERCE,2/21/2020,0,0,0,0
PIERCE,2/22/2020,0,0,0,0
PIERCE,2/23/2020,0,0,0,0
PIERCE,2/24/2020,0,0,0,0
PIERCE,2/25/2020,0,0,0,0
PIERCE,2/26/2020,0,0,0,0
PIERCE,2/27/2020,0,0,0,0
PIERCE,2/28/2020,0,0,0,0
PIERCE,2/29/2020,0,0,0,0
PIERCE,3/1/2020,0,0,0,0
PIERCE,3/2/2020,0,0,0,0
PIERCE,3/3/2020,0,0,0,0
PIERCE,3/4/2020,0,0,0,0
PIERCE,3/5/2020,0,0,0,0
PIERCE,3/6/2020,0,0,0,0
PIERCE,3/7/2020,0,0,0,0
PIERCE,3/8/2020,0,0,0,0
PIERCE,3/9/2020,0,0,0,0
PIERCE,3/10/2020,0,0,0,0
PIERCE,3/11/2020,0,0,0,0
PIERCE,3/12/2020,0,0,0,0
PIERCE,3/13/2020,0,1,0,1
PIERCE,3/14/2020,0,1,0,1
PIERCE,3/15/2020,0,1,0,1
PIERCE,3/16/2020,0,1,0,1
PIERCE,3/17/2020,1,2,0,3
PIERCE,3/18/2020,1,2,0,3
PIERCE,3/19/2020,1,3,0,4
PIERCE,3/20/2020,3,5,0,8
PIERCE,3/21/2020,4,5,0,9
PIERCE,3/22/2020,4,5,0,9
PIERCE,3/23/2020,4,6,0,10
PIERCE,3/24/2020,6,8,0,14
PIERCE,3/25/2020,8,8,0,16
PIERCE,3/26/2020,12,9,0,21
PIERCE,3/27/2020,13,9,0,22
PIERCE,3/28/2020,14,9,0,23
PIERCE,3/29/2020,14,12,0,26
PIERCE,3/30/2020,15,13,0,28
PIERCE,3/31/2020,17,14,0,31
PIERCE,4/1/2020,18,14,0,32
PIERCE,4/2/2020,21,15,0,36
PIERCE,4/3/2020,22,16,0,38
PIERCE,4/4/2020,23,17,0,40
PIERCE,4/5/2020,23,17,0,40
PIERCE,4/6/2020,24,19,0,43
PIERCE,4/7/2020,26,19,0,45
PIERCE,4/8/2020,27,19,0,46
PIERCE,4/9/2020,27,21,0,48
PIERCE,4/10/2020,27,22,0,49
PIERCE,4/11/2020,27,23,0,50
PIERCE,4/12/2020,27,23,0,50
PIERCE,4/13/2020,27,24,0,51
PIERCE,4/14/2020,27,24,0,51
PIERCE,4/15/2020,27,24,0,51
PIERCE,4/16/2020,27,24,0,51
PIERCE,4/17/2020,27,25,0,52
PIERCE,4/18/2020,27,25,0,52
PIERCE,4/19/2020,27,25,0,52
PIERCE,4/20/2020,27,25,0,52
PIERCE,4/21/2020,28,25,0,53
PIERCE,4/22/2020,29,26,0,55
PIERCE,4/23/2020,29,26,0,55
PIERCE,4/24/2020,30,28,0,58
PIERCE,4/25/2020,30,28,0,58
PIERCE,4/26/2020,30,28,0,58
PIERCE,4/27/2020,30,29,0,59
PIERCE,4/28/2020,30,30,0,60
PIERCE,4/29/2020,33,32,0,65
PIERCE,4/30/2020,33,33,0,66
PIERCE,5/1/2020,33,33,0,66
PIERCE,5/2/2020,33,34,0,67
PIERCE,5/3/2020,33,34,0,67
PIERCE,5/4/2020,33,35,0,68
PIERCE,5/5/2020,33,35,0,68
PIERCE,5/6/2020,33,36,0,69
PIERCE,5/7/2020,34,36,0,70
PIERCE,5/8/2020,34,36,0,70
PIERCE,5/9/2020,34,37,0,71
PIERCE,5/10/2020,34,38,0,72
PIERCE,5/11/2020,35,39,0,74
PIERCE,5/12/2020,38,41,0,79
PIERCE,5/13/2020,41,43,0,84
PIERCE,5/14/2020,41,44,0,85
PIERCE,5/15/2020,42,46,0,88
PIERCE,5/16/2020,42,47,0,89
PIERCE,5/17/2020,43,48,0,91
PIERCE,5/18/2020,45,49,0,94
PIERCE,5/19/2020,47,50,0,97
PIERCE,5/20/2020,47,50,0,97
PIERCE,5/21/2020,50,50,0,100
PIERCE,5/22/2020,50,50,0,100
PIERCE,5/23/2020,52,50,0,102
PIERCE,5/24/2020,52,51,0,103
PIERCE,5/25/2020,53,51,0,104
PIERCE,5/26/2020,56,52,0,108
PIERCE,5/27/2020,56,55,0,111
PIERCE,5/28/2020,58,56,0,114
PIERCE,5/29/2020,59,57,0,116
PIERCE,5/30/2020,59,58,0,117
PIERCE,5/31/2020,61,58,0,119
PIERCE,6/1/2020,62,60,0,122
PIERCE,6/2/2020,63,62,1,126
PIERCE,6/3/2020,65,64,1,130
PIERCE,6/4/2020,67,64,1,132
PIERCE,6/5/2020,67,64,1,132
PIERCE,6/6/2020,67,64,1,132
PIERCE,6/7/2020,68,64,1,133
PIERCE,6/8/2020,69,64,1,134
PIERCE,6/9/2020,69,65,1,135
PIERCE,6/10/2020,69,67,1,137
PIERCE,6/11/2020,69,67,1,137
PIERCE,6/12/2020,72,68,1,141
PIERCE,6/13/2020,73,69,1,143
PIERCE,6/14/2020,75,69,1,145
PIERCE,6/15/2020,77,70,1,148
PIERCE,6/16/2020,77,71,1,149
PIERCE,6/17/2020,81,72,1,154
PIERCE,6/18/2020,84,74,1,159
PIERCE,6/19/2020,85,77,1,163
PIERCE,6/20/2020,86,77,1,164
PIERCE,6/21/2020,87,79,1,167
PIERCE,6/22/2020,91,80,1,172
PIERCE,6/23/2020,98,85,1,184
PIERCE,6/24/2020,102,88,1,191
PIERCE,6/25/2020,107,90,1,198
PIERCE,6/26/2020,116,94,1,211
PIERCE,6/27/2020,121,96,1,218
PIERCE,6/28/2020,122,99,1,222
PIERCE,6/29/2020,128,105,1,234
PIERCE,6/30/2020,136,109,1,246
PIERCE,7/1/2020,140,114,1,255
PIERCE,7/2/2020,143,120,1,264
PIERCE,7/3/2020,149,124,1,274
PIERCE,7/4/2020,154,126,1,281
PIERCE,7/5/2020,157,127,1,285
PIERCE,7/6/2020,165,128,1,294
PIERCE,7/7/2020,171,134,1,306
PIERCE,7/8/2020,175,140,1,316
PIERCE,7/9/2020,180,146,2,328
PIERCE,7/10/2020,182,148,2,332
PIERCE,7/11/2020,184,148,2,334
PIERCE,7/12/2020,187,151,2,340
PIERCE,7/13/2020,191,156,2,349
PIERCE,7/14/2020,192,158,2,352
PIERCE,7/15/2020,195,160,2,357
PIERCE,7/16/2020,199,163,2,364
PIERCE,7/17/2020,200,164,2,366
PIERCE,7/18/2020,201,165,2,368
PIERCE,7/19/2020,203,166,2,371
PIERCE,7/20/2020,209,167,2,378
PIERCE,7/21/2020,214,169,2,385
PIERCE,7/22/2020,215,170,2,387
PIERCE,7/23/2020,217,172,2,391
PIERCE,7/24/2020,220,175,2,397
PIERCE,7/25/2020,220,176,2,398
PIERCE,7/26/2020,220,176,2,398
PIERCE,7/27/2020,222,176,2,400
PIERCE,7/28/2020,222,178,2,402
PIERCE,7/29/2020,227,181,2,410
PIERCE,7/30/2020,229,183,2,414
PIERCE,7/31/2020,229,190,2,421
PIERCE,8/1/2020,230,192,2,424
PIERCE,8/2/2020,230,193,2,425
WORTH,1/3/2020,0,0,0,0
CAMDEN,7/9/2020,206,165,1,372
LINCOLN,1/27/2020,0,0,0,0
PIERCE,8/3/2020,233,197,2,432
WORTH,1/4/2020,0,0,0,0
CAMDEN,7/10/2020,213,177,1,391
LINCOLN,1/28/2020,0,0,0,0
PIERCE,8/4/2020,236,199,2,437
WORTH,1/5/2020,0,0,0,0
CAMDEN,7/11/2020,222,181,1,404
CAMDEN,7/12/2020,227,184,1,412
CAMDEN,7/13/2020,240,191,2,433
CAMDEN,7/14/2020,253,201,3,457
CAMDEN,7/15/2020,271,215,3,489
CAMDEN,7/16/2020,284,226,3,513
CAMDEN,7/17/2020,293,233,3,529
CAMDEN,7/18/2020,296,241,3,540
CAMDEN,7/19/2020,297,248,3,548
CAMDEN,7/20/2020,303,260,4,567
CAMDEN,7/21/2020,314,269,5,588
CAMDEN,7/22/2020,317,277,5,599
CAMDEN,7/23/2020,322,288,5,615
CAMDEN,7/24/2020,334,303,5,642
CAMDEN,7/25/2020,338,313,5,656
CAMDEN,7/26/2020,340,317,5,662
CAMDEN,7/27/2020,348,327,5,680
CAMDEN,7/28/2020,359,340,5,704
CAMDEN,7/29/2020,368,354,6,728
CAMDEN,7/30/2020,374,367,6,747
CAMDEN,7/31/2020,382,373,6,761
CAMDEN,8/1/2020,384,375,6,765
CAMDEN,8/2/2020,389,375,6,770
CAMDEN,8/3/2020,396,383,6,785
CAMDEN,8/4/2020,403,387,6,796
CAMDEN,8/5/2020,410,393,6,809
CAMDEN,8/6/2020,413,401,7,821
CAMDEN,8/7/2020,417,404,7,828
CAMDEN,8/8/2020,424,406,7,837
CAMDEN,8/9/2020,430,414,7,851
CAMDEN,8/10/2020,436,424,7,867
CAMDEN,8/11/2020,440,429,7,876
CAMDEN,8/12/2020,443,435,7,885
CAMDEN,8/13/2020,456,441,8,905
CAMDEN,8/14/2020,463,445,9,917
CAMDEN,8/15/2020,472,449,9,930
CAMDEN,8/16/2020,475,452,9,936
CAMDEN,8/17/2020,486,459,9,954
CAMDEN,8/18/2020,491,467,9,967
CAMDEN,8/19/2020,499,471,9,979
CAMDEN,8/20/2020,507,473,9,989
CAMDEN,8/21/2020,510,480,10,1000
CAMDEN,8/22/2020,517,482,10,1009
CAMDEN,8/23/2020,519,487,10,1016
CAMDEN,8/24/2020,528,492,10,1030
CAMDEN,8/25/2020,534,496,10,1040
CAMDEN,8/26/2020,539,499,10,1048
CAMDEN,8/27/2020,545,502,10,1057
CAMDEN,8/28/2020,551,505,10,1066
CAMDEN,8/29/2020,555,509,10,1074
CAMDEN,8/30/2020,561,516,10,1087
CAMDEN,8/31/2020,569,522,10,1101
CAMDEN,9/1/2020,575,528,10,1113
CAMDEN,9/2/2020,581,529,10,1120
CAMDEN,9/3/2020,586,533,10,1129
CAMDEN,9/4/2020,591,542,10,1143
CAMDEN,9/5/2020,595,543,10,1148
CAMDEN,9/6/2020,597,551,10,1158
CAMDEN,9/7/2020,599,556,10,1165
CAMDEN,9/8/2020,601,557,10,1168
CAMDEN,9/9/2020,604,561,10,1175
CAMDEN,9/10/2020,610,569,10,1189
CAMDEN,9/11/2020,616,576,10,1202
CAMDEN,9/12/2020,619,577,10,1206
CAMDEN,9/13/2020,625,585,10,1220
CAMDEN,9/14/2020,634,590,10,1234
CAMDEN,9/15/2020,643,600,10,1253
CAMDEN,9/16/2020,646,602,10,1258
CAMDEN,9/17/2020,649,606,10,1265
CAMDEN,9/18/2020,652,608,10,1270
CAMDEN,9/19/2020,655,611,10,1276
CAMDEN,9/20/2020,660,612,10,1282
CAMDEN,9/21/2020,661,615,10,1286
CAMDEN,9/22/2020,664,620,10,1294
CAMDEN,9/23/2020,667,621,10,1298
CAMDEN,9/24/2020,668,623,10,1301
CAMDEN,9/25/2020,676,627,10,1313
CAMDEN,9/26/2020,677,627,10,1314
CAMDEN,9/27/2020,678,628,10,1316
CAMDEN,9/28/2020,683,631,10,1324
CAMDEN,9/29/2020,687,633,10,1330
CAMDEN,9/30/2020,691,636,10,1337
CAMDEN,10/1/2020,691,637,10,1338
CAMDEN,10/2/2020,692,637,10,1339
CAMDEN,10/3/2020,694,640,10,1344
CAMDEN,10/4/2020,696,642,10,1348
CAMDEN,10/5/2020,699,643,10,1352
CAMDEN,10/6/2020,701,644,10,1355
CAMDEN,10/7/2020,704,647,10,1361
CAMDEN,10/8/2020,706,650,10,1366
CAMDEN,10/9/2020,709,650,10,1369
CAMDEN,10/10/2020,709,652,10,1371
CAMDEN,10/11/2020,709,653,10,1372
CAMDEN,10/12/2020,711,655,10,1376
CAMDEN,10/13/2020,712,656,10,1378
CAMDEN,10/14/2020,715,656,10,1381
CAMDEN,10/15/2020,717,657,10,1384
CAMDEN,10/16/2020,717,659,10,1386
CAMDEN,10/17/2020,718,659,10,1387
CAMDEN,10/18/2020,718,659,10,1387
CAMDEN,10/19/2020,718,659,10,1387
CAMDEN,10/20/2020,718,659,10,1387
DEKALB,1/1/2020,0,0,0,0
DEKALB,1/2/2020,0,0,0,0
DEKALB,1/3/2020,0,0,0,0
DEKALB,1/4/2020,0,0,0,0
DEKALB,1/5/2020,0,0,0,0
DEKALB,1/6/2020,0,0,0,0
DEKALB,1/7/2020,0,0,0,0
DEKALB,1/8/2020,0,0,0,0
DEKALB,1/9/2020,0,0,0,0
DEKALB,1/10/2020,0,0,0,0
DEKALB,1/11/2020,0,0,0,0
DEKALB,1/12/2020,0,0,0,0
DEKALB,1/13/2020,0,0,0,0
DEKALB,1/14/2020,0,0,0,0
DEKALB,1/15/2020,0,0,0,0
DEKALB,1/16/2020,0,0,0,0
DEKALB,1/17/2020,0,0,0,0
DEKALB,1/18/2020,0,0,0,0
DEKALB,1/19/2020,0,0,0,0
DEKALB,1/20/2020,1,0,0,1
DEKALB,1/21/2020,1,0,0,1
DEKALB,1/22/2020,1,0,0,1
DEKALB,1/23/2020,1,0,0,1
DEKALB,1/24/2020,1,0,0,1
DEKALB,1/25/2020,1,0,0,1
DEKALB,1/26/2020,1,0,0,1
DEKALB,1/27/2020,1,0,0,1
DEKALB,1/28/2020,1,0,0,1
DEKALB,1/29/2020,1,0,0,1
DEKALB,1/30/2020,1,0,0,1
DEKALB,1/31/2020,1,0,0,1
DEKALB,2/1/2020,1,0,0,1
DEKALB,2/2/2020,1,0,0,1
DEKALB,2/3/2020,1,0,0,1
DEKALB,2/4/2020,1,0,0,1
DEKALB,2/5/2020,1,0,0,1
DEKALB,2/6/2020,1,0,0,1
DEKALB,2/7/2020,1,0,0,1
DEKALB,2/8/2020,1,0,0,1
DEKALB,2/9/2020,1,0,0,1
DEKALB,2/10/2020,2,0,0,2
DEKALB,2/11/2020,2,0,0,2
DEKALB,2/12/2020,2,0,0,2
DEKALB,2/13/2020,2,0,0,2
DEKALB,2/14/2020,2,0,0,2
DEKALB,2/15/2020,2,0,0,2
DEKALB,2/16/2020,2,0,0,2
DEKALB,2/17/2020,2,0,0,2
DEKALB,2/18/2020,2,0,0,2
DEKALB,2/19/2020,3,0,0,3
DEKALB,2/20/2020,5,0,0,5
DEKALB,2/21/2020,5,0,0,5
DEKALB,2/22/2020,5,0,0,5
DEKALB,2/23/2020,5,0,0,5
DEKALB,2/24/2020,7,2,0,9
DEKALB,2/25/2020,9,5,0,14
DEKALB,2/26/2020,10,6,0,16
DEKALB,2/27/2020,10,7,0,17
DEKALB,2/28/2020,12,8,0,20
DEKALB,2/29/2020,13,8,0,21
DEKALB,3/1/2020,18,13,0,31
DEKALB,3/2/2020,21,13,0,34
DEKALB,3/3/2020,22,16,0,38
DEKALB,3/4/2020,25,18,0,43
DEKALB,3/5/2020,26,23,0,49
DEKALB,3/6/2020,29,25,0,54
DEKALB,3/7/2020,30,31,0,61
DEKALB,3/8/2020,32,33,0,65
DEKALB,3/9/2020,41,39,0,80
DEKALB,3/10/2020,51,45,0,96
DEKALB,3/11/2020,58,57,0,115
DEKALB,3/12/2020,67,68,0,135
DEKALB,3/13/2020,79,83,0,162
DEKALB,3/14/2020,90,96,0,186
DEKALB,3/15/2020,110,108,0,218
DEKALB,3/16/2020,133,118,0,251
DEKALB,3/17/2020,152,128,0,280
DEKALB,3/18/2020,172,150,0,322
DEKALB,3/19/2020,189,159,0,348
DEKALB,3/20/2020,202,171,0,373
DEKALB,3/21/2020,209,183,0,392
DEKALB,3/22/2020,219,199,0,418
DEKALB,3/23/2020,239,220,0,459
DEKALB,3/24/2020,262,237,0,499
DEKALB,3/25/2020,286,260,1,547
DEKALB,3/26/2020,303,279,1,583
DEKALB,3/27/2020,324,301,2,627
DEKALB,3/28/2020,338,319,2,659
DEKALB,3/29/2020,354,331,2,687
DEKALB,3/30/2020,376,358,3,737
DEKALB,3/31/2020,397,385,3,785
DEKALB,4/1/2020,423,399,3,825
DEKALB,4/2/2020,448,422,6,876
DEKALB,4/3/2020,471,445,10,926
DEKALB,4/4/2020,485,461,10,956
DEKALB,4/5/2020,497,477,11,985
DEKALB,4/6/2020,531,506,11,1048
DEKALB,4/7/2020,556,532,11,1099
DEKALB,4/8/2020,580,549,11,1140
DEKALB,4/9/2020,622,574,11,1207
DEKALB,4/10/2020,659,589,11,1259
DEKALB,4/11/2020,695,607,11,1313
DEKALB,4/12/2020,710,619,11,1340
DEKALB,4/13/2020,764,648,12,1424
DEKALB,4/14/2020,802,680,13,1495
DEKALB,4/15/2020,824,711,13,1548
DEKALB,4/16/2020,852,743,13,1608
DEKALB,4/17/2020,881,774,13,1668
DEKALB,4/18/2020,902,791,13,1706
DEKALB,4/19/2020,916,801,13,1730
DEKALB,4/20/2020,951,826,13,1790
DEKALB,4/21/2020,984,848,14,1846
DEKALB,4/22/2020,1032,874,16,1922
DEKALB,4/23/2020,1073,899,17,1989
DEKALB,4/24/2020,1105,915,18,2038
DEKALB,4/25/2020,1123,928,18,2069
DEKALB,4/26/2020,1135,938,19,2092
DEKALB,4/27/2020,1174,972,19,2165
DEKALB,4/28/2020,1206,1008,20,2234
DEKALB,4/29/2020,1252,1042,22,2316
DEKALB,4/30/2020,1288,1070,23,2381
DEKALB,5/1/2020,1317,1092,23,2432
DEKALB,5/2/2020,1346,1112,23,2481
DEKALB,5/3/2020,1354,1123,23,2500
DEKALB,5/4/2020,1396,1148,23,2567
DEKALB,5/5/2020,1422,1186,25,2633
DEKALB,5/6/2020,1453,1218,25,2696
DEKALB,5/7/2020,1481,1237,27,2745
DEKALB,5/8/2020,1510,1268,27,2805
DEKALB,5/9/2020,1531,1288,27,2846
DEKALB,5/10/2020,1548,1298,27,2873
DEKALB,5/11/2020,1586,1345,27,2958
DEKALB,5/12/2020,1631,1392,27,3050
DEKALB,5/13/2020,1654,1424,28,3106
DEKALB,5/14/2020,1691,1473,30,3194
DEKALB,5/15/2020,1733,1504,31,3268
DEKALB,5/16/2020,1758,1529,31,3318
DEKALB,5/17/2020,1773,1539,31,3343
DEKALB,5/18/2020,1801,1561,33,3395
DEKALB,5/19/2020,1841,1595,33,3469
DEKALB,5/20/2020,1869,1629,33,3531
DEKALB,5/21/2020,1898,1651,33,3582
DEKALB,5/22/2020,1939,1693,33,3665
DEKALB,5/23/2020,1955,1710,33,3698
DEKALB,5/24/2020,1972,1726,33,3731
DEKALB,5/25/2020,1988,1745,33,3766
DEKALB,5/26/2020,2024,1774,33,3831
DEKALB,5/27/2020,2061,1809,33,3903
DEKALB,5/28/2020,2088,1832,34,3954
DEKALB,5/29/2020,2113,1858,34,4005
DEKALB,5/30/2020,2126,1872,35,4033
DEKALB,5/31/2020,2134,1895,35,4064
DEKALB,6/1/2020,2204,1957,36,4197
DEKALB,6/2/2020,2232,1995,37,4264
DEKALB,6/3/2020,2263,2022,40,4325
DEKALB,6/4/2020,2305,2043,40,4388
DEKALB,6/5/2020,2328,2069,40,4437
DEKALB,6/6/2020,2362,2089,41,4492
DEKALB,6/7/2020,2381,2104,41,4526
DEKALB,6/8/2020,2422,2137,44,4603
DEKALB,6/9/2020,2460,2171,47,4678
DEKALB,6/10/2020,2491,2202,49,4742
DEKALB,6/11/2020,2518,2228,51,4797
DEKALB,6/12/2020,2558,2255,53,4866
DEKALB,6/13/2020,2584,2288,54,4926
DEKALB,6/14/2020,2613,2308,54,4975
DEKALB,6/15/2020,2671,2351,54,5076
DEKALB,6/16/2020,2732,2409,57,5198
DEKALB,6/17/2020,2791,2468,57,5316
DEKALB,6/18/2020,2847,2521,59,5427
DEKALB,6/19/2020,2914,2583,61,5558
DEKALB,6/20/2020,2999,2638,63,5700
DEKALB,6/21/2020,3066,2699,63,5828
DEKALB,6/22/2020,3170,2793,66,6029
DEKALB,6/23/2020,3304,2886,70,6260
DEKALB,6/24/2020,3408,2989,75,6472
DEKALB,6/25/2020,3542,3113,83,6738
DEKALB,6/26/2020,3663,3213,99,6975
DEKALB,6/27/2020,3739,3270,107,7116
DEKALB,6/28/2020,3840,3360,114,7314
DEKALB,6/29/2020,4013,3495,133,7641
DEKALB,6/30/2020,4218,3658,147,8023
DEKALB,7/1/2020,4405,3781,155,8341
DEKALB,7/2/2020,4551,3897,166,8614
DEKALB,7/3/2020,4658,3999,173,8830
DEKALB,7/4/2020,4752,4073,176,9001
DEKALB,7/5/2020,4837,4156,178,9171
DEKALB,7/6/2020,5008,4318,188,9514
DEKALB,7/7/2020,5167,4459,207,9833
DEKALB,7/8/2020,5330,4612,220,10162
DEKALB,7/9/2020,5490,4744,231,10465
DEKALB,7/10/2020,5656,4855,243,10754
DEKALB,7/11/2020,5760,4936,247,10943
DEKALB,7/12/2020,5822,5009,251,11082
DEKALB,7/13/2020,6013,5146,259,11418
DEKALB,7/14/2020,6186,5259,263,11708
DEKALB,7/15/2020,6337,5398,278,12013
DEKALB,7/16/2020,6453,5493,288,12234
DEKALB,7/17/2020,6572,5587,297,12456
DEKALB,7/18/2020,6674,5643,304,12621
DEKALB,7/19/2020,6756,5687,306,12749
DEKALB,7/20/2020,6904,5812,311,13027
DEKALB,7/21/2020,7027,5892,314,13233
DEKALB,7/22/2020,7143,5985,320,13448
DEKALB,7/23/2020,7238,6056,323,13617
DEKALB,7/24/2020,7330,6141,329,13800
DEKALB,7/25/2020,7398,6195,329,13922
DEKALB,7/26/2020,7442,6236,331,14009
DEKALB,7/27/2020,7545,6325,333,14203
DEKALB,7/28/2020,7638,6397,338,14373
DEKALB,7/29/2020,7729,6469,339,14537
DEKALB,7/30/2020,7803,6535,339,14677
DEKALB,7/31/2020,7874,6594,343,14811
DEKALB,8/1/2020,7946,6661,344,14951
DEKALB,8/2/2020,7995,6696,345,15036
DEKALB,8/3/2020,8090,6778,347,15215
DEKALB,8/4/2020,8168,6848,350,15366
DEKALB,8/5/2020,8234,6912,352,15498
DEKALB,8/6/2020,8294,6978,352,15624
DEKALB,8/7/2020,8374,7044,353,15771
DEKALB,8/8/2020,8432,7082,353,15867
DEKALB,8/9/2020,8480,7103,353,15936
DEKALB,8/10/2020,8569,7185,355,16109
DEKALB,8/11/2020,8624,7229,356,16209
DEKALB,8/12/2020,8688,7274,357,16319
DEKALB,8/13/2020,8726,7328,357,16411
DEKALB,8/14/2020,8773,7369,358,16500
DEKALB,8/15/2020,8807,7400,358,16565
DEKALB,8/16/2020,8849,7427,358,16634
DEKALB,8/17/2020,8904,7464,358,16726
DEKALB,8/18/2020,8943,7501,359,16803
DEKALB,8/19/2020,8985,7542,362,16889
DEKALB,8/20/2020,9030,7577,362,16969
DEKALB,8/21/2020,9073,7613,362,17048
DEKALB,8/22/2020,9105,7641,363,17109
DEKALB,8/23/2020,9126,7664,363,17153
DEKALB,8/24/2020,9176,7704,366,17246
DEKALB,8/25/2020,9210,7744,366,17320
DEKALB,8/26/2020,9257,7782,367,17406
DEKALB,8/27/2020,9297,7813,367,17477
DEKALB,8/28/2020,9335,7842,367,17544
DEKALB,8/29/2020,9362,7875,368,17605
DEKALB,8/30/2020,9386,7900,368,17654
DEKALB,8/31/2020,9430,7936,368,17734
DEKALB,9/1/2020,9477,7976,368,17821
DEKALB,9/2/2020,9517,8013,368,17898
DEKALB,9/3/2020,9559,8051,368,17978
DEKALB,9/4/2020,9596,8083,369,18048
DEKALB,9/5/2020,9619,8098,370,18087
DEKALB,9/6/2020,9635,8113,370,18118
DEKALB,9/7/2020,9671,8143,370,18184
DEKALB,9/8/2020,9719,8178,370,18267
DEKALB,9/9/2020,9759,8208,370,18337
DEKALB,9/10/2020,9786,8240,370,18396
DEKALB,9/11/2020,9808,8279,370,18457
DEKALB,9/12/2020,9841,8300,370,18511
DEKALB,9/13/2020,9861,8321,370,18552
DEKALB,9/14/2020,9903,8362,370,18635
DEKALB,9/15/2020,9929,8385,371,18685
DEKALB,9/16/2020,9962,8411,372,18745
DEKALB,9/17/2020,9976,8437,372,18785
DEKALB,9/18/2020,10011,8466,372,18849
DEKALB,9/19/2020,10029,8484,372,18885
DEKALB,9/20/2020,10050,8497,372,18919
DEKALB,9/21/2020,10088,8522,372,18982
DEKALB,9/22/2020,10120,8546,372,19038
DEKALB,9/23/2020,10154,8581,372,19107
DEKALB,9/24/2020,10181,8602,372,19155
DEKALB,9/25/2020,10209,8636,372,19217
DEKALB,9/26/2020,10234,8658,372,19264
DEKALB,9/27/2020,10253,8674,373,19300
DEKALB,9/28/2020,10295,8701,373,19369
DEKALB,9/29/2020,10320,8721,373,19414
DEKALB,9/30/2020,10353,8746,373,19472
DEKALB,10/1/2020,10379,8770,373,19522
DEKALB,10/2/2020,10413,8793,373,19579
DEKALB,10/3/2020,10439,8808,373,19620
DEKALB,10/4/2020,10465,8831,373,19669
DEKALB,10/5/2020,10511,8868,373,19752
DEKALB,10/6/2020,10549,8898,373,19820
DEKALB,10/7/2020,10571,8928,374,19873
DEKALB,10/8/2020,10614,8947,374,19935
DEKALB,10/9/2020,10638,8964,375,19977
DEKALB,10/10/2020,10655,8983,375,20013
DEKALB,10/11/2020,10672,9000,375,20047
DEKALB,10/12/2020,10711,9024,376,20111
DEKALB,10/13/2020,10743,9054,377,20174
DEKALB,10/14/2020,10772,9082,377,20231
DEKALB,10/15/2020,10801,9117,377,20295
DEKALB,10/16/2020,10834,9137,379,20350
DEKALB,10/17/2020,10849,9150,379,20378
DEKALB,10/18/2020,10853,9154,381,20388
DEKALB,10/19/2020,10855,9155,381,20391
DEKALB,10/20/2020,10855,9155,384,20394
WORTH,1/1/2020,0,0,0,0
WORTH,1/2/2020,0,0,0,0
PIERCE,8/5/2020,237,200,2,439
LINCOLN,1/29/2020,0,0,0,0
WORTH,1/6/2020,0,0,0,0
LINCOLN,1/30/2020,0,0,0,0
LINCOLN,1/31/2020,0,0,0,0
LINCOLN,2/1/2020,0,0,0,0
LINCOLN,2/2/2020,0,0,0,0
LINCOLN,2/3/2020,0,0,0,0
LINCOLN,2/4/2020,0,0,0,0
LINCOLN,2/5/2020,0,0,0,0
LINCOLN,2/6/2020,0,0,0,0
LINCOLN,2/7/2020,0,0,0,0
LINCOLN,2/8/2020,0,0,0,0
LINCOLN,2/9/2020,0,0,0,0
LINCOLN,2/10/2020,0,0,0,0
LINCOLN,2/11/2020,0,0,0,0
LINCOLN,2/12/2020,0,0,0,0
LINCOLN,2/13/2020,0,0,0,0
LINCOLN,2/14/2020,0,0,0,0
LINCOLN,2/15/2020,0,0,0,0
LINCOLN,2/16/2020,0,0,0,0
LINCOLN,2/17/2020,0,0,0,0
LINCOLN,2/18/2020,0,0,0,0
LINCOLN,2/19/2020,0,0,0,0
LINCOLN,2/20/2020,0,0,0,0
LINCOLN,2/21/2020,0,0,0,0
LINCOLN,2/22/2020,0,0,0,0
LINCOLN,2/23/2020,0,0,0,0
LINCOLN,2/24/2020,0,0,0,0
LINCOLN,2/25/2020,0,0,0,0
LINCOLN,2/26/2020,0,0,0,0
LINCOLN,2/27/2020,0,0,0,0
LINCOLN,2/28/2020,0,0,0,0
LINCOLN,2/29/2020,0,0,0,0
LINCOLN,3/1/2020,0,0,0,0
LINCOLN,3/2/2020,0,0,0,0
LINCOLN,3/3/2020,0,0,0,0
LINCOLN,3/4/2020,0,0,0,0
LINCOLN,3/5/2020,0,0,0,0
LINCOLN,3/6/2020,0,0,0,0
LINCOLN,3/7/2020,0,0,0,0
LINCOLN,3/8/2020,0,0,0,0
LINCOLN,3/9/2020,1,1,0,2
LINCOLN,3/10/2020,2,1,0,3
LINCOLN,3/11/2020,2,1,0,3
LINCOLN,3/12/2020,2,1,0,3
LINCOLN,3/13/2020,3,1,0,4
LINCOLN,3/14/2020,3,1,0,4
LINCOLN,3/15/2020,3,1,0,4
LINCOLN,3/16/2020,3,2,0,5
LINCOLN,3/17/2020,3,2,0,5
LINCOLN,3/18/2020,3,2,0,5
LINCOLN,3/19/2020,3,2,0,5
LINCOLN,3/20/2020,3,2,0,5
LINCOLN,3/21/2020,3,2,0,5
LINCOLN,3/22/2020,3,2,0,5
LINCOLN,3/23/2020,3,2,0,5
LINCOLN,3/24/2020,4,2,0,6
LINCOLN,3/25/2020,4,2,0,6
LINCOLN,3/26/2020,4,2,0,6
LINCOLN,3/27/2020,4,2,0,6
LINCOLN,3/28/2020,4,2,0,6
LINCOLN,3/29/2020,4,2,0,6
LINCOLN,3/30/2020,4,3,0,7
LINCOLN,3/31/2020,4,3,0,7
LINCOLN,4/1/2020,5,3,0,8
LINCOLN,4/2/2020,5,3,0,8
LINCOLN,4/3/2020,5,3,0,8
LINCOLN,4/4/2020,5,3,0,8
LINCOLN,4/5/2020,5,3,0,8
LINCOLN,4/6/2020,5,3,0,8
LINCOLN,4/7/2020,5,4,0,9
LINCOLN,4/8/2020,7,4,0,11
LINCOLN,4/9/2020,7,4,0,11
LINCOLN,4/10/2020,7,4,0,11
LINCOLN,4/11/2020,7,4,0,11
LINCOLN,4/12/2020,7,4,0,11
LINCOLN,4/13/2020,7,4,0,11
LINCOLN,4/14/2020,7,4,0,11
LINCOLN,4/15/2020,7,4,0,11
LINCOLN,4/16/2020,7,4,0,11
LINCOLN,4/17/2020,7,4,0,11
LINCOLN,4/18/2020,7,4,0,11
LINCOLN,4/19/2020,7,4,0,11
LINCOLN,4/20/2020,8,4,0,12
LINCOLN,4/21/2020,8,4,0,12
LINCOLN,4/22/2020,9,4,0,13
LINCOLN,4/23/2020,9,4,0,13
LINCOLN,4/24/2020,9,4,0,13
LINCOLN,4/25/2020,9,4,0,13
LINCOLN,4/26/2020,9,4,0,13
LINCOLN,4/27/2020,9,4,0,13
LINCOLN,4/28/2020,9,4,0,13
LINCOLN,4/29/2020,9,4,0,13
LINCOLN,4/30/2020,9,4,0,13
LINCOLN,5/1/2020,9,4,0,13
LINCOLN,5/2/2020,9,4,0,13
LINCOLN,5/3/2020,9,4,0,13
LINCOLN,5/4/2020,9,4,0,13
LINCOLN,5/5/2020,9,4,0,13
LINCOLN,5/6/2020,9,4,0,13
LINCOLN,5/7/2020,9,4,0,13
LINCOLN,5/8/2020,9,4,0,13
LINCOLN,5/9/2020,9,4,0,13
LINCOLN,5/10/2020,9,4,0,13
LINCOLN,5/11/2020,9,4,0,13
LINCOLN,5/12/2020,9,4,0,13
LINCOLN,5/13/2020,9,4,0,13
LINCOLN,5/14/2020,9,4,0,13
LINCOLN,5/15/2020,9,4,0,13
LINCOLN,5/16/2020,9,4,0,13
LINCOLN,5/17/2020,9,4,0,13
LINCOLN,5/18/2020,12,4,0,16
LINCOLN,5/19/2020,12,4,0,16
LINCOLN,5/20/2020,12,4,0,16
LINCOLN,5/21/2020,12,4,0,16
LINCOLN,5/22/2020,12,4,0,16
LINCOLN,5/23/2020,13,4,0,17
LINCOLN,5/24/2020,13,4,0,17
LINCOLN,5/25/2020,13,4,0,17
LINCOLN,5/26/2020,13,4,0,17
LINCOLN,5/27/2020,13,4,0,17
LINCOLN,5/28/2020,13,4,0,17
LINCOLN,5/29/2020,13,4,0,17
LINCOLN,5/30/2020,13,4,0,17
LINCOLN,5/31/2020,13,4,0,17
LINCOLN,6/1/2020,13,4,0,17
LINCOLN,6/2/2020,13,4,0,17
LINCOLN,6/3/2020,13,4,0,17
LINCOLN,6/4/2020,13,5,0,18
LINCOLN,6/5/2020,13,5,0,18
LINCOLN,6/6/2020,13,5,0,18
LINCOLN,6/7/2020,13,5,0,18
LINCOLN,6/8/2020,13,5,0,18
LINCOLN,6/9/2020,13,6,0,19
LINCOLN,6/10/2020,13,7,0,20
LINCOLN,6/11/2020,14,7,0,21
LINCOLN,6/12/2020,14,8,0,22
LINCOLN,6/13/2020,14,8,0,22
LINCOLN,6/14/2020,14,8,0,22
LINCOLN,6/15/2020,14,8,0,22
LINCOLN,6/16/2020,16,8,0,24
LINCOLN,6/17/2020,18,10,0,28
LINCOLN,6/18/2020,19,10,0,29
LINCOLN,6/19/2020,19,10,0,29
LINCOLN,6/20/2020,21,11,0,32
LINCOLN,6/21/2020,22,12,0,34
LINCOLN,6/22/2020,24,13,0,37
LINCOLN,6/23/2020,27,13,0,40
LINCOLN,6/24/2020,28,14,0,42
LINCOLN,6/25/2020,31,15,0,46
LINCOLN,6/26/2020,33,18,0,51
LINCOLN,6/27/2020,34,18,0,52
LINCOLN,6/28/2020,36,21,0,57
LINCOLN,6/29/2020,40,21,0,61
LINCOLN,6/30/2020,41,23,0,64
LINCOLN,7/1/2020,44,27,0,71
LINCOLN,7/2/2020,45,27,0,72
LINCOLN,7/3/2020,46,27,0,73
LINCOLN,7/4/2020,46,28,0,74
LINCOLN,7/5/2020,47,28,0,75
LINCOLN,7/6/2020,50,29,0,79
LINCOLN,7/7/2020,51,29,0,80
LINCOLN,7/8/2020,56,34,0,90
LINCOLN,7/9/2020,56,35,0,91
LINCOLN,7/10/2020,57,35,0,92
LINCOLN,7/11/2020,57,36,0,93
LINCOLN,7/12/2020,58,36,0,94
LINCOLN,7/13/2020,60,42,0,102
LINCOLN,7/14/2020,63,43,0,106
LINCOLN,7/15/2020,66,45,0,111
LINCOLN,7/16/2020,69,46,0,115
LINCOLN,7/17/2020,70,47,0,117
LINCOLN,7/18/2020,72,47,0,119
LINCOLN,7/19/2020,72,48,0,120
LINCOLN,7/20/2020,75,50,0,125
LINCOLN,7/21/2020,75,50,0,125
LINCOLN,7/22/2020,77,52,0,129
LINCOLN,7/23/2020,80,54,0,134
LINCOLN,7/24/2020,83,54,0,137
LINCOLN,7/25/2020,83,56,0,139
LINCOLN,7/26/2020,84,58,0,142
LINCOLN,7/27/2020,87,61,0,148
LINCOLN,7/28/2020,88,62,0,150
LINCOLN,7/29/2020,92,62,0,154
LINCOLN,7/30/2020,95,64,0,159
LINCOLN,7/31/2020,95,65,0,160
LINCOLN,8/1/2020,97,66,0,163
LINCOLN,8/2/2020,98,66,0,164
LINCOLN,8/3/2020,101,69,0,170
LINCOLN,8/4/2020,102,70,0,172
LINCOLN,8/5/2020,103,71,1,175
LINCOLN,8/6/2020,105,71,1,177
LINCOLN,8/7/2020,107,72,1,180
LINCOLN,8/8/2020,108,72,1,181
LINCOLN,8/9/2020,109,72,1,182
LINCOLN,8/10/2020,111,73,1,185
LINCOLN,8/11/2020,113,73,1,187
LINCOLN,8/12/2020,115,73,1,189
LINCOLN,8/13/2020,115,73,1,189
LINCOLN,8/14/2020,115,74,1,190
LINCOLN,8/15/2020,115,74,1,190
LINCOLN,8/16/2020,115,74,1,190
LINCOLN,8/17/2020,115,74,1,190
LINCOLN,8/18/2020,115,76,1,192
LINCOLN,8/19/2020,115,77,1,193
LINCOLN,8/20/2020,116,77,1,194
LINCOLN,8/21/2020,117,77,1,195
LINCOLN,8/22/2020,117,79,1,197
LINCOLN,8/23/2020,117,79,1,197
LINCOLN,8/24/2020,118,81,1,200
LINCOLN,8/25/2020,118,81,1,200
LINCOLN,8/26/2020,118,81,1,200
LINCOLN,8/27/2020,119,81,1,201
LINCOLN,8/28/2020,121,82,1,204
LINCOLN,8/29/2020,121,82,1,204
LINCOLN,8/30/2020,122,82,1,205
LINCOLN,8/31/2020,123,83,1,207
LINCOLN,9/1/2020,123,83,1,207
LINCOLN,9/2/2020,124,83,1,208
LINCOLN,9/3/2020,124,83,1,208
LINCOLN,9/4/2020,124,83,1,208
LINCOLN,9/5/2020,124,83,1,208
LINCOLN,9/6/2020,124,83,1,208
LINCOLN,9/7/2020,124,83,1,208
LINCOLN,9/8/2020,125,83,1,209
LINCOLN,9/9/2020,126,83,1,210
LINCOLN,9/10/2020,126,84,1,211
LINCOLN,9/11/2020,126,85,1,212
LINCOLN,9/12/2020,127,85,1,213
LINCOLN,9/13/2020,127,85,1,213
LINCOLN,9/14/2020,127,85,1,213
LINCOLN,9/15/2020,127,85,1,213
LINCOLN,9/16/2020,127,85,1,213
LINCOLN,9/17/2020,127,85,1,213
LINCOLN,9/18/2020,127,87,1,215
LINCOLN,9/19/2020,128,87,1,216
LINCOLN,9/20/2020,128,87,1,216
LINCOLN,9/21/2020,128,87,1,216
LINCOLN,9/22/2020,128,87,1,216
LINCOLN,9/23/2020,128,87,1,216
LINCOLN,9/24/2020,128,87,1,216
LINCOLN,9/25/2020,128,87,1,216
LINCOLN,9/26/2020,129,87,1,217
LINCOLN,9/27/2020,129,87,1,217
LINCOLN,9/28/2020,129,87,1,217
LINCOLN,9/29/2020,129,87,1,217
LINCOLN,9/30/2020,129,87,1,217
LINCOLN,10/1/2020,130,87,1,218
LINCOLN,10/2/2020,130,87,1,218
LINCOLN,10/3/2020,130,87,1,218
LINCOLN,10/4/2020,130,87,1,218
LINCOLN,10/5/2020,131,87,1,219
LINCOLN,10/6/2020,131,87,1,219
LINCOLN,10/7/2020,131,87,1,219
LINCOLN,10/8/2020,132,88,1,221
LINCOLN,10/9/2020,132,88,1,221
LINCOLN,10/10/2020,132,88,1,221
LINCOLN,10/11/2020,132,88,1,221
LINCOLN,10/12/2020,132,88,1,221
LINCOLN,10/13/2020,132,88,1,221
LINCOLN,10/14/2020,132,88,1,221
LINCOLN,10/15/2020,132,89,1,222
LINCOLN,10/16/2020,133,89,1,223
LINCOLN,10/17/2020,133,89,1,223
LINCOLN,10/18/2020,134,90,1,225
LINCOLN,10/19/2020,134,90,1,225
LINCOLN,10/20/2020,134,90,1,225
UNION,1/1/2020,0,0,0,0
UNION,1/2/2020,0,0,0,0
UNION,1/3/2020,0,0,0,0
UNION,1/4/2020,0,0,0,0
UNION,1/5/2020,0,0,0,0
UNION,1/6/2020,0,0,0,0
UNION,1/7/2020,0,0,0,0
UNION,1/8/2020,0,0,0,0
UNION,1/9/2020,0,0,0,0
UNION,1/10/2020,0,0,0,0
UNION,1/11/2020,0,0,0,0
UNION,1/12/2020,0,0,0,0
UNION,1/13/2020,0,0,0,0
UNION,1/14/2020,0,0,0,0
UNION,1/15/2020,0,0,0,0
UNION,1/16/2020,0,0,0,0
UNION,1/17/2020,0,0,0,0
UNION,1/18/2020,0,0,0,0
UNION,1/19/2020,0,0,0,0
UNION,1/20/2020,0,0,0,0
UNION,1/21/2020,0,0,0,0
UNION,1/22/2020,0,0,0,0
UNION,1/23/2020,0,0,0,0
UNION,1/24/2020,0,0,0,0
UNION,1/25/2020,0,0,0,0
UNION,1/26/2020,0,0,0,0
UNION,1/27/2020,0,0,0,0
UNION,1/28/2020,0,0,0,0
UNION,1/29/2020,0,0,0,0
UNION,1/30/2020,0,0,0,0
UNION,1/31/2020,0,0,0,0
UNION,2/1/2020,0,0,0,0
UNION,2/2/2020,0,0,0,0
UNION,2/3/2020,0,0,0,0
UNION,2/4/2020,0,0,0,0
UNION,2/5/2020,0,0,0,0
UNION,2/6/2020,0,0,0,0
UNION,2/7/2020,0,0,0,0
UNION,2/8/2020,0,0,0,0
UNION,2/9/2020,0,0,0,0
UNION,2/10/2020,0,0,0,0
UNION,2/11/2020,0,0,0,0
UNION,2/12/2020,0,0,0,0
UNION,2/13/2020,0,0,0,0
UNION,2/14/2020,0,0,0,0
UNION,2/15/2020,0,0,0,0
UNION,2/16/2020,0,0,0,0
UNION,2/17/2020,0,0,0,0
UNION,2/18/2020,0,0,0,0
UNION,2/19/2020,0,0,0,0
UNION,2/20/2020,0,0,0,0
UNION,2/21/2020,0,0,0,0
UNION,2/22/2020,0,0,0,0
UNION,2/23/2020,0,0,0,0
UNION,2/24/2020,0,0,0,0
UNION,2/25/2020,0,0,0,0
UNION,2/26/2020,0,0,0,0
UNION,2/27/2020,0,0,0,0
UNION,2/28/2020,0,0,0,0
UNION,2/29/2020,0,0,0,0
UNION,3/1/2020,0,0,0,0
UNION,3/2/2020,0,0,0,0
UNION,3/3/2020,0,0,0,0
UNION,3/4/2020,0,0,0,0
UNION,3/5/2020,0,0,0,0
UNION,3/6/2020,0,0,0,0
UNION,3/7/2020,0,0,0,0
UNION,3/8/2020,0,0,0,0
UNION,3/9/2020,0,0,0,0
UNION,3/10/2020,0,0,0,0
UNION,3/11/2020,0,0,0,0
UNION,3/12/2020,0,0,0,0
UNION,3/13/2020,0,0,0,0
UNION,3/14/2020,0,0,0,0
UNION,3/15/2020,0,0,0,0
UNION,3/16/2020,0,0,0,0
UNION,3/17/2020,0,0,0,0
UNION,3/18/2020,0,0,0,0
UNION,3/19/2020,0,0,0,0
UNION,3/20/2020,0,0,0,0
UNION,3/21/2020,0,0,0,0
UNION,3/22/2020,0,1,0,1
UNION,3/23/2020,0,1,0,1
UNION,3/24/2020,0,2,0,2
UNION,3/25/2020,0,2,0,2
UNION,3/26/2020,0,2,0,2
UNION,3/27/2020,0,2,0,2
UNION,3/28/2020,0,2,0,2
UNION,3/29/2020,0,2,0,2
UNION,3/30/2020,0,3,0,3
UNION,3/31/2020,0,3,0,3
UNION,4/1/2020,0,3,0,3
UNION,4/2/2020,1,3,0,4
UNION,4/3/2020,1,3,0,4
UNION,4/4/2020,1,3,0,4
UNION,4/5/2020,1,4,0,5
UNION,4/6/2020,1,5,0,6
UNION,4/7/2020,1,5,0,6
UNION,4/8/2020,1,5,0,6
UNION,4/9/2020,1,5,0,6
UNION,4/10/2020,1,5,0,6
UNION,4/11/2020,1,5,0,6
UNION,4/12/2020,1,5,0,6
UNION,4/13/2020,3,5,0,8
UNION,4/14/2020,3,5,0,8
UNION,4/15/2020,3,5,0,8
UNION,4/16/2020,3,5,0,8
UNION,4/17/2020,5,6,0,11
UNION,4/18/2020,8,6,0,14
UNION,4/19/2020,9,7,0,16
UNION,4/20/2020,13,9,0,22
UNION,4/21/2020,13,10,0,23
UNION,4/22/2020,17,11,0,28
UNION,4/23/2020,17,11,0,28
UNION,4/24/2020,18,12,0,30
UNION,4/25/2020,18,12,0,30
UNION,4/26/2020,18,15,0,33
UNION,4/27/2020,18,15,0,33
UNION,4/28/2020,18,15,0,33
UNION,4/29/2020,18,15,0,33
UNION,4/30/2020,18,15,0,33
UNION,5/1/2020,18,15,0,33
UNION,5/2/2020,18,15,0,33
UNION,5/3/2020,18,16,0,34
UNION,5/4/2020,18,16,0,34
UNION,5/5/2020,18,18,0,36
UNION,5/6/2020,18,18,0,36
UNION,5/7/2020,18,19,0,37
UNION,5/8/2020,19,19,0,38
UNION,5/9/2020,19,19,0,38
UNION,5/10/2020,19,19,0,38
UNION,5/11/2020,19,19,0,38
WORTH,1/7/2020,0,0,0,0
WORTH,1/8/2020,0,0,0,0
PIERCE,8/6/2020,237,204,2,443
WORTH,1/9/2020,0,0,0,0
WORTH,1/10/2020,0,0,0,0
WORTH,1/11/2020,0,0,0,0
WORTH,1/12/2020,0,0,0,0
WORTH,1/13/2020,0,0,0,0
WORTH,1/14/2020,0,0,0,0
WORTH,1/15/2020,0,0,0,0
WORTH,1/16/2020,0,0,0,0
WORTH,1/17/2020,0,0,0,0
WORTH,1/18/2020,0,0,0,0
WORTH,1/19/2020,0,0,0,0
WORTH,1/20/2020,0,0,0,0
WORTH,1/21/2020,0,0,0,0
WORTH,1/22/2020,0,0,0,0
WORTH,1/23/2020,0,0,0,0
WORTH,1/24/2020,0,0,0,0
WORTH,1/25/2020,0,0,0,0
WORTH,1/26/2020,0,0,0,0
WORTH,1/27/2020,0,0,0,0
WORTH,1/28/2020,0,0,0,0
WORTH,1/29/2020,0,0,0,0
WORTH,1/30/2020,0,0,0,0
WORTH,1/31/2020,0,0,0,0
WORTH,2/1/2020,1,0,0,1
WORTH,2/2/2020,1,0,0,1
WORTH,2/3/2020,1,0,0,1
WORTH,2/4/2020,1,0,0,1
WORTH,2/5/2020,1,0,0,1
WORTH,2/6/2020,1,0,0,1
WORTH,2/7/2020,1,0,0,1
WORTH,2/8/2020,1,0,0,1
WORTH,2/9/2020,1,0,0,1
WORTH,2/10/2020,1,0,0,1
WORTH,2/11/2020,1,0,0,1
WORTH,2/12/2020,1,0,0,1
WORTH,2/13/2020,1,0,0,1
WORTH,2/14/2020,1,0,0,1
WORTH,2/15/2020,1,0,0,1
WORTH,2/16/2020,1,0,0,1
WORTH,2/17/2020,1,0,0,1
WORTH,2/18/2020,1,0,0,1
WORTH,2/19/2020,1,0,0,1
WORTH,2/20/2020,1,0,0,1
WORTH,2/21/2020,1,0,0,1
WORTH,2/22/2020,1,0,0,1
WORTH,2/23/2020,1,0,0,1
WORTH,2/24/2020,1,0,0,1
WORTH,2/25/2020,1,0,0,1
WORTH,2/26/2020,1,0,0,1
WORTH,2/27/2020,1,0,0,1
WORTH,2/28/2020,1,0,0,1
WORTH,2/29/2020,1,0,0,1
WORTH,3/1/2020,1,0,0,1
WORTH,3/2/2020,1,0,0,1
WORTH,3/3/2020,1,0,0,1
WORTH,3/4/2020,1,0,0,1
WORTH,3/5/2020,1,0,0,1
WORTH,3/6/2020,1,1,0,2
WORTH,3/7/2020,1,1,0,2
WORTH,3/8/2020,1,1,0,2
WORTH,3/9/2020,1,1,0,2
WORTH,3/10/2020,2,1,0,3
WORTH,3/11/2020,2,1,0,3
WORTH,3/12/2020,2,1,0,3
WORTH,3/13/2020,3,1,0,4
WORTH,3/14/2020,3,1,0,4
WORTH,3/15/2020,4,3,0,7
WORTH,3/16/2020,5,4,0,9
WORTH,3/17/2020,6,5,0,11
WORTH,3/18/2020,8,7,0,15
WORTH,3/19/2020,13,9,0,22
WORTH,3/20/2020,13,11,0,24
WORTH,3/21/2020,14,11,0,25
WORTH,3/22/2020,16,11,0,27
WORTH,3/23/2020,18,13,0,31
WORTH,3/24/2020,20,14,0,34
WORTH,3/25/2020,22,16,0,38
WORTH,3/26/2020,24,19,1,44
WORTH,3/27/2020,26,22,1,49
WORTH,3/28/2020,28,23,1,52
WORTH,3/29/2020,31,27,1,59
WORTH,3/30/2020,33,32,1,66
WORTH,3/31/2020,35,35,1,71
WORTH,4/1/2020,39,37,1,77
WORTH,4/2/2020,41,39,1,81
WORTH,4/3/2020,42,41,1,84
WORTH,4/4/2020,44,41,1,86
WORTH,4/5/2020,45,42,1,88
WORTH,4/6/2020,47,44,1,92
WORTH,4/7/2020,51,45,1,97
WORTH,4/8/2020,54,47,1,102
WORTH,4/9/2020,57,49,1,107
WORTH,4/10/2020,59,50,1,110
WORTH,4/11/2020,60,52,1,113
WORTH,4/12/2020,61,54,1,116
WORTH,4/13/2020,61,60,1,122
WORTH,4/14/2020,62,62,1,125
WORTH,4/15/2020,64,63,1,128
WORTH,4/16/2020,68,63,1,132
WORTH,4/17/2020,74,64,1,139
WORTH,4/18/2020,75,67,1,143
WORTH,4/19/2020,75,67,1,143
WORTH,4/20/2020,75,67,2,144
WORTH,4/21/2020,76,69,2,147
WORTH,4/22/2020,78,72,2,152
WORTH,4/23/2020,78,72,2,152
WORTH,4/24/2020,79,72,2,153
WORTH,4/25/2020,81,72,2,155
WORTH,4/26/2020,82,72,2,156
WORTH,4/27/2020,85,73,2,160
WORTH,4/28/2020,91,76,2,169
WORTH,4/29/2020,92,78,2,172
WORTH,4/30/2020,95,78,2,175
WORTH,5/1/2020,97,79,2,178
WORTH,5/2/2020,97,79,2,178
WORTH,5/3/2020,98,79,2,179
WORTH,5/4/2020,98,79,2,179
WORTH,5/5/2020,99,79,2,180
WORTH,5/6/2020,101,79,2,182
WORTH,5/7/2020,101,79,2,182
WORTH,5/8/2020,102,81,2,185
WORTH,5/9/2020,102,83,2,187
WORTH,5/10/2020,102,83,2,187
WORTH,5/11/2020,108,83,2,193
WORTH,5/12/2020,110,85,2,197
WORTH,5/13/2020,110,86,2,198
WORTH,5/14/2020,113,87,2,202
WORTH,5/15/2020,114,88,2,204
WORTH,5/16/2020,114,88,2,204
WORTH,5/17/2020,114,88,2,204
WORTH,5/18/2020,116,90,2,208
WORTH,5/19/2020,117,92,2,211
WORTH,5/20/2020,117,93,2,212
WORTH,5/21/2020,118,94,2,214
WORTH,5/22/2020,118,94,2,214
WORTH,5/23/2020,118,94,2,214
WORTH,5/24/2020,119,95,2,216
WORTH,5/25/2020,120,96,2,218
WORTH,5/26/2020,122,98,2,222
WORTH,5/27/2020,123,98,2,223
WORTH,5/28/2020,127,100,2,229
WORTH,5/29/2020,128,101,2,231
WORTH,5/30/2020,129,102,2,233
WORTH,5/31/2020,131,102,2,235
WORTH,6/1/2020,134,106,2,242
WORTH,6/2/2020,135,107,2,244
WORTH,6/3/2020,138,109,2,249
WORTH,6/4/2020,144,112,2,258
WORTH,6/5/2020,145,112,2,259
WORTH,6/6/2020,149,112,2,263
WORTH,6/7/2020,149,114,2,265
WORTH,6/8/2020,150,115,2,267
WORTH,6/9/2020,151,116,2,269
WORTH,6/10/2020,154,121,2,277
WORTH,6/11/2020,156,121,2,279
WORTH,6/12/2020,159,123,2,284
WORTH,6/13/2020,161,124,2,287
WORTH,6/14/2020,162,124,2,288
WORTH,6/15/2020,163,125,2,290
WORTH,6/16/2020,165,126,2,293
WORTH,6/17/2020,165,128,2,295
WORTH,6/18/2020,172,132,2,306
WORTH,6/19/2020,176,133,2,311
WORTH,6/20/2020,176,133,2,311
WORTH,6/21/2020,179,134,2,315
WORTH,6/22/2020,180,136,2,318
WORTH,6/23/2020,182,137,2,321
WORTH,6/24/2020,183,138,2,323
WORTH,6/25/2020,183,141,2,326
WORTH,6/26/2020,186,143,2,331
WORTH,6/27/2020,186,144,2,332
WORTH,6/28/2020,186,144,2,332
WORTH,6/29/2020,188,145,2,335
WORTH,6/30/2020,192,145,2,339
WORTH,7/1/2020,193,148,2,343
WORTH,7/2/2020,198,150,2,350
WORTH,7/3/2020,202,150,2,354
WORTH,7/4/2020,202,151,2,355
WORTH,7/5/2020,203,151,2,356
WORTH,7/6/2020,205,157,2,364
WORTH,7/7/2020,207,158,2,367
WORTH,7/8/2020,211,159,2,372
WORTH,7/9/2020,214,160,2,376
WORTH,7/10/2020,218,161,2,381
WORTH,7/11/2020,223,161,2,386
WORTH,7/12/2020,224,161,2,387
WORTH,7/13/2020,226,166,2,394
WORTH,7/14/2020,227,166,2,395
WORTH,7/15/2020,227,167,2,396
WORTH,7/16/2020,229,167,2,398
WORTH,7/17/2020,232,168,2,402
WORTH,7/18/2020,233,168,2,403
WORTH,7/19/2020,234,169,2,405
WORTH,7/20/2020,235,171,2,408
WORTH,7/21/2020,235,171,2,408
WORTH,7/22/2020,237,173,2,412
WORTH,7/23/2020,240,175,2,417
WORTH,7/24/2020,241,176,2,419
WORTH,7/25/2020,244,177,2,423
WORTH,7/26/2020,246,178,2,426
WORTH,7/27/2020,250,179,2,431
WORTH,7/28/2020,253,179,2,434
WORTH,7/29/2020,254,180,2,436
WORTH,7/30/2020,255,180,2,437
WORTH,7/31/2020,255,182,2,439
WORTH,8/1/2020,256,182,2,440
WORTH,8/2/2020,258,182,2,442
WORTH,8/3/2020,262,184,2,448
WORTH,8/4/2020,262,184,2,448
WORTH,8/5/2020,264,185,3,452
WORTH,8/6/2020,265,186,3,454
WORTH,8/7/2020,265,187,3,455
WORTH,8/8/2020,268,189,3,460
WORTH,8/9/2020,269,191,3,463
WORTH,8/10/2020,271,192,3,466
WORTH,8/11/2020,271,192,3,466
WORTH,8/12/2020,275,193,3,471
WORTH,8/13/2020,277,193,3,473
WORTH,8/14/2020,277,194,3,474
WORTH,8/15/2020,278,194,3,475
WORTH,8/16/2020,278,195,3,476
WORTH,8/17/2020,280,195,3,478
WORTH,8/18/2020,280,196,3,479
WORTH,8/19/2020,284,196,3,483
WORTH,8/20/2020,284,198,3,485
WORTH,8/21/2020,285,198,3,486
WORTH,8/22/2020,285,198,3,486
WORTH,8/23/2020,286,198,3,487
WORTH,8/24/2020,287,198,3,488
WORTH,8/25/2020,290,202,3,495
WORTH,8/26/2020,291,203,3,497
WORTH,8/27/2020,294,203,3,500
WORTH,8/28/2020,296,204,3,503
WORTH,8/29/2020,296,204,3,503
WORTH,8/30/2020,297,204,3,504
WORTH,8/31/2020,297,205,3,505
WORTH,9/1/2020,297,205,3,505
WORTH,9/2/2020,297,205,3,505
WORTH,9/3/2020,298,205,3,506
WORTH,9/4/2020,299,205,3,507
WORTH,9/5/2020,299,206,3,508
WORTH,9/6/2020,299,206,3,508
WORTH,9/7/2020,299,206,3,508
WORTH,9/8/2020,301,206,3,510
WORTH,9/9/2020,302,207,3,512
WORTH,9/10/2020,303,208,3,514
WORTH,9/11/2020,304,208,3,515
WORTH,9/12/2020,305,208,3,516
WORTH,9/13/2020,306,209,3,518
WORTH,9/14/2020,309,209,3,521
WORTH,9/15/2020,310,209,3,522
WORTH,9/16/2020,311,209,3,523
WORTH,9/17/2020,313,209,3,525
WORTH,9/18/2020,314,209,3,526
WORTH,9/19/2020,315,210,3,528
WORTH,9/20/2020,316,211,3,530
WORTH,9/21/2020,317,212,3,532
WORTH,9/22/2020,320,212,3,535
WORTH,9/23/2020,321,212,3,536
WORTH,9/24/2020,321,212,3,536
WORTH,9/25/2020,324,212,3,539
WORTH,9/26/2020,324,212,3,539
WORTH,9/27/2020,325,213,3,541
WORTH,9/28/2020,328,214,3,545
WORTH,9/29/2020,329,214,3,546
WORTH,9/30/2020,333,217,3,553
WORTH,10/1/2020,334,218,3,555
WORTH,10/2/2020,339,219,3,561
WORTH,10/3/2020,339,219,3,561
WORTH,10/4/2020,341,219,3,563
WORTH,10/5/2020,345,221,3,569
WORTH,10/6/2020,346,221,3,570
WORTH,10/7/2020,348,223,3,574
WORTH,10/8/2020,350,224,3,577
WORTH,10/9/2020,351,224,3,578
WORTH,10/10/2020,353,224,3,580
WORTH,10/11/2020,353,225,3,581
WORTH,10/12/2020,355,227,3,585
WORTH,10/13/2020,356,227,3,586
WORTH,10/14/2020,358,229,3,590
WORTH,10/15/2020,358,230,3,591
WORTH,10/16/2020,358,230,3,591
WORTH,10/17/2020,358,230,3,591
WORTH,10/18/2020,359,231,3,593
WORTH,10/19/2020,359,231,3,593
WORTH,10/20/2020,359,231,3,593
DODGE,1/1/2020,0,0,0,0
DODGE,1/2/2020,1,0,0,1
DODGE,1/3/2020,1,0,0,1
DODGE,1/4/2020,1,0,0,1
DODGE,1/5/2020,1,0,0,1
DODGE,1/6/2020,1,0,0,1
DODGE,1/7/2020,1,0,0,1
DODGE,1/8/2020,1,0,0,1
DODGE,1/9/2020,1,0,0,1
DODGE,1/10/2020,1,0,0,1
DODGE,1/11/2020,1,0,0,1
DODGE,1/12/2020,1,0,0,1
DODGE,1/13/2020,1,0,0,1
DODGE,1/14/2020,1,0,0,1
DODGE,1/15/2020,1,0,0,1
DODGE,1/16/2020,1,0,0,1
DODGE,1/17/2020,1,0,0,1
DODGE,1/18/2020,1,0,0,1
DODGE,1/19/2020,1,0,0,1
DODGE,1/20/2020,1,0,0,1
DODGE,1/21/2020,1,0,0,1
DODGE,1/22/2020,1,0,0,1
DODGE,1/23/2020,1,0,0,1
DODGE,1/24/2020,1,0,0,1
DODGE,1/25/2020,1,0,0,1
DODGE,1/26/2020,1,0,0,1
DODGE,1/27/2020,1,0,0,1
DODGE,1/28/2020,1,0,0,1
DODGE,1/29/2020,1,0,0,1
DODGE,1/30/2020,1,0,0,1
DODGE,1/31/2020,1,0,0,1
DODGE,2/1/2020,1,0,0,1
DODGE,2/2/2020,1,0,0,1
DODGE,2/3/2020,1,0,0,1
DODGE,2/4/2020,1,0,0,1
DODGE,2/5/2020,1,0,0,1
DODGE,2/6/2020,1,0,0,1
DODGE,2/7/2020,1,0,0,1
DODGE,2/8/2020,1,0,0,1
DODGE,2/9/2020,1,0,0,1
DODGE,2/10/2020,1,0,0,1
DODGE,2/11/2020,1,0,0,1
DODGE,2/12/2020,1,0,0,1
DODGE,2/13/2020,1,0,0,1
DODGE,2/14/2020,1,0,0,1
DODGE,2/15/2020,1,0,0,1
DODGE,2/16/2020,1,0,0,1
DODGE,2/17/2020,1,0,0,1
DODGE,2/18/2020,1,0,0,1
DODGE,2/19/2020,1,0,0,1
DODGE,2/20/2020,1,0,0,1
DODGE,2/21/2020,1,0,0,1
DODGE,2/22/2020,1,0,0,1
DODGE,2/23/2020,1,0,0,1
DODGE,2/24/2020,1,0,0,1
DODGE,2/25/2020,1,0,0,1
DODGE,2/26/2020,1,0,0,1
DODGE,2/27/2020,1,0,0,1
DODGE,2/28/2020,1,0,0,1
DODGE,2/29/2020,1,0,0,1
DODGE,3/1/2020,1,0,0,1
DODGE,3/2/2020,1,0,0,1
DODGE,3/3/2020,1,0,0,1
DODGE,3/4/2020,1,0,0,1
DODGE,3/5/2020,1,0,0,1
DODGE,3/6/2020,2,0,0,2
DODGE,3/7/2020,2,0,0,2
DODGE,3/8/2020,2,0,0,2
DODGE,3/9/2020,2,0,0,2
DODGE,3/10/2020,2,0,0,2
DODGE,3/11/2020,2,0,0,2
DODGE,3/12/2020,2,0,0,2
DODGE,3/13/2020,2,0,0,2
DODGE,3/14/2020,2,0,0,2
DODGE,3/15/2020,2,0,0,2
DODGE,3/16/2020,2,0,0,2
DODGE,3/17/2020,2,0,0,2
DODGE,3/18/2020,2,0,0,2
DODGE,3/19/2020,2,0,0,2
DODGE,3/20/2020,2,0,0,2
DODGE,3/21/2020,2,1,0,3
DODGE,3/22/2020,3,1,0,4
DODGE,3/23/2020,3,1,0,4
DODGE,3/24/2020,4,2,0,6
DODGE,3/25/2020,4,2,0,6
DODGE,3/26/2020,5,2,0,7
DODGE,3/27/2020,5,2,0,7
DODGE,3/28/2020,5,2,0,7
DODGE,3/29/2020,5,3,0,8
DODGE,3/30/2020,7,3,0,10
DODGE,3/31/2020,7,3,0,10
DODGE,4/1/2020,8,3,0,11
DODGE,4/2/2020,8,4,0,12
DODGE,4/3/2020,10,5,0,15
DODGE,4/4/2020,12,6,0,18
DODGE,4/5/2020,13,6,0,19
DODGE,4/6/2020,13,6,0,19
DODGE,4/7/2020,14,7,0,21
DODGE,4/8/2020,14,7,0,21
DODGE,4/9/2020,15,7,0,22
DODGE,4/10/2020,16,7,0,23
DODGE,4/11/2020,16,7,0,23
DODGE,4/12/2020,16,7,0,23
DODGE,4/13/2020,16,7,0,23
DODGE,4/14/2020,17,7,0,24
DODGE,4/15/2020,18,7,0,25
DODGE,4/16/2020,19,7,0,26
DODGE,4/17/2020,19,7,0,26
PIERCE,8/7/2020,239,205,2,446
PIERCE,8/8/2020,242,206,2,450
PIERCE,8/9/2020,245,206,2,453
PIERCE,8/10/2020,265,212,2,479
PIERCE,8/11/2020,270,215,2,487
PIERCE,8/12/2020,271,217,2,490
PIERCE,8/13/2020,273,218,2,493
PIERCE,8/14/2020,276,219,2,497
PIERCE,8/15/2020,278,220,2,500
PIERCE,8/16/2020,279,220,2,501
PIERCE,8/17/2020,279,221,2,502
PIERCE,8/18/2020,280,224,2,506
PIERCE,8/19/2020,281,229,2,512
PIERCE,8/20/2020,286,231,3,520
PIERCE,8/21/2020,289,233,3,525
PIERCE,8/22/2020,289,235,3,527
PIERCE,8/23/2020,290,235,3,528
PIERCE,8/24/2020,293,240,3,536
PIERCE,8/25/2020,297,241,3,541
PIERCE,8/26/2020,299,244,3,546
PIERCE,8/27/2020,302,245,3,550
PIERCE,8/28/2020,305,246,3,554
PIERCE,8/29/2020,308,247,3,558
PIERCE,8/30/2020,308,248,3,559
PIERCE,8/31/2020,311,250,3,564
PIERCE,9/1/2020,313,250,3,566
PIERCE,9/2/2020,316,250,3,569
PIERCE,9/3/2020,316,250,3,569
PIERCE,9/4/2020,316,253,3,572
PIERCE,9/5/2020,317,254,3,574
PIERCE,9/6/2020,317,256,3,576
PIERCE,9/7/2020,319,258,3,580
PIERCE,9/8/2020,320,261,3,584
PIERCE,9/9/2020,322,262,3,587
PIERCE,9/10/2020,323,262,4,589
PIERCE,9/11/2020,324,262,4,590
PIERCE,9/12/2020,325,263,4,592
PIERCE,9/13/2020,326,265,4,595
PIERCE,9/14/2020,327,269,4,600
PIERCE,9/15/2020,328,271,4,603
PIERCE,9/16/2020,329,273,4,606
PIERCE,9/17/2020,331,273,4,608
PIERCE,9/18/2020,331,274,4,609
PIERCE,9/19/2020,332,276,4,612
PIERCE,9/20/2020,333,277,4,614
PIERCE,9/21/2020,333,277,4,614
PIERCE,9/22/2020,335,277,4,616
PIERCE,9/23/2020,336,278,4,618
PIERCE,9/24/2020,336,278,4,618
PIERCE,9/25/2020,337,279,4,620
PIERCE,9/26/2020,337,279,4,620
PIERCE,9/27/2020,337,280,4,621
PIERCE,9/28/2020,342,280,4,626
PIERCE,9/29/2020,342,280,4,626
PIERCE,9/30/2020,342,282,4,628
PIERCE,10/1/2020,343,284,4,631
PIERCE,10/2/2020,343,284,4,631
PIERCE,10/3/2020,344,284,4,632
PIERCE,10/4/2020,344,285,4,633
PIERCE,10/5/2020,345,286,4,635
PIERCE,10/6/2020,345,286,4,635
PIERCE,10/7/2020,345,286,4,635
PIERCE,10/8/2020,345,288,4,637
PIERCE,10/9/2020,346,289,4,639
PIERCE,10/10/2020,346,289,4,639
PIERCE,10/11/2020,346,289,4,639
PIERCE,10/12/2020,347,290,4,641
PIERCE,10/13/2020,349,291,4,644
PIERCE,10/14/2020,349,292,4,645
PIERCE,10/15/2020,349,293,4,646
PIERCE,10/16/2020,351,293,4,648
PIERCE,10/17/2020,351,293,4,648
PIERCE,10/18/2020,351,293,4,648
PIERCE,10/19/2020,351,293,4,648
PIERCE,10/20/2020,351,293,4,648
WEBSTER,1/1/2020,0,0,0,0
WEBSTER,1/2/2020,0,0,0,0
WEBSTER,1/3/2020,0,0,0,0
WEBSTER,1/4/2020,0,0,0,0
WEBSTER,1/5/2020,0,0,0,0
WEBSTER,1/6/2020,0,0,0,0
WEBSTER,1/7/2020,0,0,0,0
WEBSTER,1/8/2020,0,0,0,0
WEBSTER,1/9/2020,0,0,0,0
WEBSTER,1/10/2020,0,0,0,0
WEBSTER,1/11/2020,0,0,0,0
WEBSTER,1/12/2020,0,0,0,0
WEBSTER,1/13/2020,0,0,0,0
WEBSTER,1/14/2020,0,0,0,0
WEBSTER,1/15/2020,0,0,0,0
WEBSTER,1/16/2020,0,0,0,0
WEBSTER,1/17/2020,0,0,0,0
WEBSTER,1/18/2020,0,0,0,0
WEBSTER,1/19/2020,0,0,0,0
WEBSTER,1/20/2020,0,0,0,0
WEBSTER,1/21/2020,0,0,0,0
WEBSTER,1/22/2020,0,0,0,0
WEBSTER,1/23/2020,0,0,0,0
WEBSTER,1/24/2020,0,0,0,0
WEBSTER,1/25/2020,0,0,0,0
WEBSTER,1/26/2020,0,0,0,0
WEBSTER,1/27/2020,0,0,0,0
WEBSTER,1/28/2020,0,0,0,0
WEBSTER,1/29/2020,0,0,0,0
WEBSTER,1/30/2020,0,0,0,0
WEBSTER,1/31/2020,0,0,0,0
WEBSTER,2/1/2020,0,0,0,0
WEBSTER,2/2/2020,0,0,0,0
WEBSTER,2/3/2020,0,0,0,0
WEBSTER,2/4/2020,0,0,0,0
WEBSTER,2/5/2020,0,0,0,0
WEBSTER,2/6/2020,0,0,0,0
WEBSTER,2/7/2020,0,0,0,0
WEBSTER,2/8/2020,0,0,0,0
WEBSTER,2/9/2020,0,0,0,0
WEBSTER,2/10/2020,0,0,0,0
WEBSTER,2/11/2020,0,0,0,0
WEBSTER,2/12/2020,0,0,0,0
WEBSTER,2/13/2020,0,0,0,0
WEBSTER,2/14/2020,0,0,0,0
WEBSTER,2/15/2020,0,0,0,0
WEBSTER,2/16/2020,0,0,0,0
WEBSTER,2/17/2020,0,0,0,0
WEBSTER,2/18/2020,0,0,0,0
WEBSTER,2/19/2020,0,0,0,0
WEBSTER,2/20/2020,0,0,0,0
WEBSTER,2/21/2020,0,0,0,0
WEBSTER,2/22/2020,0,0,0,0
WEBSTER,2/23/2020,0,0,0,0
WEBSTER,2/24/2020,0,0,0,0
WEBSTER,2/25/2020,0,0,0,0
WEBSTER,2/26/2020,0,0,0,0
WEBSTER,2/27/2020,0,0,0,0
WEBSTER,2/28/2020,0,0,0,0
WEBSTER,2/29/2020,0,0,0,0
WEBSTER,3/1/2020,0,0,0,0
WEBSTER,3/2/2020,0,0,0,0
WEBSTER,3/3/2020,0,0,0,0
WEBSTER,3/4/2020,0,0,0,0
WEBSTER,3/5/2020,0,0,0,0
WEBSTER,3/6/2020,0,0,0,0
WEBSTER,3/7/2020,0,0,0,0
WEBSTER,3/8/2020,0,0,0,0
WEBSTER,3/9/2020,0,0,0,0
WEBSTER,3/10/2020,0,0,0,0
WEBSTER,3/11/2020,0,0,0,0
WEBSTER,3/12/2020,0,0,0,0
WEBSTER,3/13/2020,0,0,0,0
WEBSTER,3/14/2020,0,0,0,0
WEBSTER,3/15/2020,0,0,0,0
WEBSTER,3/16/2020,0,0,0,0
WEBSTER,3/17/2020,0,0,0,0
WEBSTER,3/18/2020,0,0,0,0
WEBSTER,3/19/2020,0,0,0,0
WEBSTER,3/20/2020,0,0,0,0
WEBSTER,3/21/2020,0,0,0,0
WEBSTER,3/22/2020,0,0,0,0
WEBSTER,3/23/2020,0,0,0,0
WEBSTER,3/24/2020,0,0,0,0
WEBSTER,3/25/2020,0,0,0,0
WEBSTER,3/26/2020,1,0,0,1
WEBSTER,3/27/2020,1,0,0,1
WEBSTER,3/28/2020,1,0,0,1
WEBSTER,3/29/2020,1,0,0,1
WEBSTER,3/30/2020,1,0,0,1
WEBSTER,3/31/2020,1,1,0,2
WEBSTER,4/1/2020,1,1,0,2
WEBSTER,4/2/2020,1,1,0,2
WEBSTER,4/3/2020,1,1,0,2
WEBSTER,4/4/2020,1,1,0,2
WEBSTER,4/5/2020,1,1,0,2
WEBSTER,4/6/2020,1,1,0,2
WEBSTER,4/7/2020,1,1,0,2
WEBSTER,4/8/2020,1,1,0,2
WEBSTER,4/9/2020,1,2,0,3
WEBSTER,4/10/2020,2,2,0,4
WEBSTER,4/11/2020,2,2,0,4
WEBSTER,4/12/2020,2,2,0,4
WEBSTER,4/13/2020,2,2,0,4
WEBSTER,4/14/2020,2,2,0,4
WEBSTER,4/15/2020,4,2,0,6
WEBSTER,4/16/2020,4,2,0,6
WEBSTER,4/17/2020,5,2,0,7
WEBSTER,4/18/2020,5,2,0,7
WEBSTER,4/19/2020,5,2,0,7
WEBSTER,4/20/2020,5,2,0,7
WEBSTER,4/21/2020,5,2,0,7
WEBSTER,4/22/2020,5,2,0,7
WEBSTER,4/23/2020,5,2,0,7
WEBSTER,4/24/2020,5,2,0,7
WEBSTER,4/25/2020,6,2,0,8
WEBSTER,4/26/2020,6,2,0,8
WEBSTER,4/27/2020,7,2,0,9
WEBSTER,4/28/2020,7,2,0,9
WEBSTER,4/29/2020,7,2,0,9
WEBSTER,4/30/2020,7,2,0,9
WEBSTER,5/1/2020,7,2,0,9
WEBSTER,5/2/2020,7,2,0,9
WEBSTER,5/3/2020,7,2,0,9
WEBSTER,5/4/2020,7,2,0,9
WEBSTER,5/5/2020,8,2,0,10
WEBSTER,5/6/2020,8,2,0,10
WEBSTER,5/7/2020,8,2,0,10
WEBSTER,5/8/2020,8,2,0,10
WEBSTER,5/9/2020,8,2,0,10
WEBSTER,5/10/2020,8,2,0,10
WEBSTER,5/11/2020,9,2,0,11
WEBSTER,5/12/2020,9,2,0,11
WEBSTER,5/13/2020,9,2,0,11
WEBSTER,5/14/2020,9,2,0,11
WEBSTER,5/15/2020,9,2,0,11
WEBSTER,5/16/2020,9,2,0,11
WEBSTER,5/17/2020,9,2,0,11
WEBSTER,5/18/2020,9,2,0,11
WEBSTER,5/19/2020,9,2,0,11
WEBSTER,5/20/2020,9,2,0,11
WEBSTER,5/21/2020,9,2,0,11
WEBSTER,5/22/2020,9,2,0,11
WEBSTER,5/23/2020,9,2,0,11
WEBSTER,5/24/2020,9,2,0,11
WEBSTER,5/25/2020,10,2,0,12
WEBSTER,5/26/2020,10,2,0,12
WEBSTER,5/27/2020,10,2,0,12
WEBSTER,5/28/2020,11,2,0,13
WEBSTER,5/29/2020,11,2,0,13
WEBSTER,5/30/2020,11,2,0,13
WEBSTER,5/31/2020,11,2,0,13
WEBSTER,6/1/2020,11,2,0,13
WEBSTER,6/2/2020,12,2,0,14
WEBSTER,6/3/2020,12,2,0,14
WEBSTER,6/4/2020,12,2,0,14
WEBSTER,6/5/2020,13,2,0,15
WEBSTER,6/6/2020,13,2,0,15
WEBSTER,6/7/2020,13,2,0,15
WEBSTER,6/8/2020,14,2,0,16
WEBSTER,6/9/2020,14,2,0,16
WEBSTER,6/10/2020,14,2,0,16
WEBSTER,6/11/2020,15,2,0,17
WEBSTER,6/12/2020,15,2,0,17
WEBSTER,6/13/2020,15,2,0,17
WEBSTER,6/14/2020,15,2,0,17
WEBSTER,6/15/2020,15,2,0,17
WEBSTER,6/16/2020,15,2,0,17
WEBSTER,6/17/2020,16,2,0,18
WEBSTER,6/18/2020,16,2,0,18
WEBSTER,6/19/2020,17,2,0,19
WEBSTER,6/20/2020,18,2,0,20
WEBSTER,6/21/2020,18,2,0,20
WEBSTER,6/22/2020,18,3,0,21
WEBSTER,6/23/2020,18,3,0,21
WEBSTER,6/24/2020,19,4,0,23
WEBSTER,6/25/2020,20,4,0,24
WEBSTER,6/26/2020,21,4,0,25
WEBSTER,6/27/2020,21,4,0,25
WEBSTER,6/28/2020,22,4,0,26
WEBSTER,6/29/2020,22,4,0,26
WEBSTER,6/30/2020,22,4,0,26
WEBSTER,7/1/2020,22,4,0,26
WEBSTER,7/2/2020,23,4,0,27
WEBSTER,7/3/2020,23,4,0,27
WEBSTER,7/4/2020,23,5,0,28
WEBSTER,7/5/2020,23,5,0,28
WEBSTER,7/6/2020,24,8,0,32
WEBSTER,7/7/2020,24,8,0,32
WEBSTER,7/8/2020,24,8,0,32
WEBSTER,7/9/2020,24,9,0,33
WEBSTER,7/10/2020,24,9,0,33
WEBSTER,7/11/2020,24,9,0,33
WEBSTER,7/12/2020,24,9,0,33
WEBSTER,7/13/2020,24,10,0,34
WEBSTER,7/14/2020,24,10,0,34
WEBSTER,7/15/2020,24,10,0,34
WEBSTER,7/16/2020,25,10,0,35
WEBSTER,7/17/2020,25,10,0,35
WEBSTER,7/18/2020,25,10,0,35
WEBSTER,7/19/2020,25,10,0,35
WEBSTER,7/20/2020,25,10,0,35
WEBSTER,7/21/2020,25,10,0,35
WEBSTER,7/22/2020,25,10,0,35
WEBSTER,7/23/2020,25,10,0,35
WEBSTER,7/24/2020,25,10,0,35
WEBSTER,7/25/2020,25,10,0,35
WEBSTER,7/26/2020,25,10,0,35
WEBSTER,7/27/2020,25,10,0,35
WEBSTER,7/28/2020,25,10,0,35
WEBSTER,7/29/2020,25,10,0,35
WEBSTER,7/30/2020,25,11,0,36
WEBSTER,7/31/2020,25,11,0,36
WEBSTER,8/1/2020,25,13,0,38
WEBSTER,8/2/2020,25,13,0,38
WEBSTER,8/3/2020,25,13,0,38
WEBSTER,8/4/2020,25,13,0,38
WEBSTER,8/5/2020,25,13,0,38
WEBSTER,8/6/2020,25,13,0,38
WEBSTER,8/7/2020,25,13,0,38
WEBSTER,8/8/2020,25,13,0,38
WEBSTER,8/9/2020,25,14,0,39
WEBSTER,8/10/2020,25,14,0,39
WEBSTER,8/11/2020,25,14,0,39
WEBSTER,8/12/2020,25,14,0,39
WEBSTER,8/13/2020,25,14,0,39
WEBSTER,8/14/2020,25,14,0,39
WEBSTER,8/15/2020,25,14,0,39
WEBSTER,8/16/2020,25,14,0,39
WEBSTER,8/17/2020,25,15,0,40
WEBSTER,8/18/2020,25,15,0,40
WEBSTER,8/19/2020,25,15,0,40
WEBSTER,8/20/2020,25,15,0,40
WEBSTER,8/21/2020,25,15,0,40
WEBSTER,8/22/2020,25,15,0,40
WEBSTER,8/23/2020,25,15,0,40
WEBSTER,8/24/2020,25,15,0,40
WEBSTER,8/25/2020,25,15,0,40
WEBSTER,8/26/2020,25,15,0,40
WEBSTER,8/27/2020,25,15,0,40
WEBSTER,8/28/2020,25,16,0,41
WEBSTER,8/29/2020,25,16,0,41
WEBSTER,8/30/2020,25,16,0,41
WEBSTER,8/31/2020,25,16,0,41
WEBSTER,9/1/2020,25,16,0,41
WEBSTER,9/2/2020,25,16,0,41
WEBSTER,9/3/2020,25,16,0,41
WEBSTER,9/4/2020,25,16,0,41
WEBSTER,9/5/2020,26,16,0,42
WEBSTER,9/6/2020,26,16,0,42
WEBSTER,9/7/2020,26,16,0,42
WEBSTER,9/8/2020,26,16,0,42
WEBSTER,9/9/2020,26,17,0,43
WEBSTER,9/10/2020,26,17,0,43
WEBSTER,9/11/2020,26,17,0,43
WEBSTER,9/12/2020,26,17,0,43
WEBSTER,9/13/2020,26,17,0,43
WEBSTER,9/14/2020,26,17,0,43
WEBSTER,9/15/2020,26,17,0,43
WEBSTER,9/16/2020,26,18,0,44
WEBSTER,9/17/2020,26,18,0,44
WEBSTER,9/18/2020,26,18,0,44
WEBSTER,9/19/2020,26,18,0,44
WEBSTER,9/20/2020,26,18,0,44
WEBSTER,9/21/2020,26,18,0,44
WEBSTER,9/22/2020,26,18,0,44
WEBSTER,9/23/2020,26,18,0,44
WEBSTER,9/24/2020,26,18,0,44
WEBSTER,9/25/2020,26,18,0,44
WEBSTER,9/26/2020,26,18,0,44
WEBSTER,9/27/2020,26,18,0,44
WEBSTER,9/28/2020,26,18,0,44
WEBSTER,9/29/2020,26,18,0,44
WEBSTER,9/30/2020,26,18,0,44
WEBSTER,10/1/2020,26,18,0,44
WEBSTER,10/2/2020,26,18,0,44
WEBSTER,10/3/2020,26,18,0,44
WEBSTER,10/4/2020,26,18,0,44
WEBSTER,10/5/2020,26,18,0,44
WEBSTER,10/6/2020,26,18,0,44
WEBSTER,10/7/2020,26,18,0,44
WEBSTER,10/8/2020,26,18,0,44
WEBSTER,10/9/2020,26,18,0,44
WEBSTER,10/10/2020,26,18,0,44
WEBSTER,10/11/2020,26,18,0,44
WEBSTER,10/12/2020,26,18,0,44
WEBSTER,10/13/2020,26,18,0,44
WEBSTER,10/14/2020,26,18,0,44
WEBSTER,10/15/2020,26,18,0,44
WEBSTER,10/16/2020,26,18,0,44
WEBSTER,10/17/2020,26,18,0,44
WEBSTER,10/18/2020,26,18,0,44
WEBSTER,10/19/2020,26,18,0,44
WEBSTER,10/20/2020,26,18,0,44
LINCOLN,1/1/2020,0,0,0,0
LINCOLN,1/2/2020,0,0,0,0
LINCOLN,1/3/2020,0,0,0,0
LINCOLN,1/4/2020,0,0,0,0
LINCOLN,1/5/2020,0,0,0,0
LINCOLN,1/6/2020,0,0,0,0
LINCOLN,1/7/2020,0,0,0,0
LINCOLN,1/8/2020,0,0,0,0
LINCOLN,1/9/2020,0,0,0,0
LINCOLN,1/10/2020,0,0,0,0
LINCOLN,1/11/2020,0,0,0,0
LINCOLN,1/12/2020,0,0,0,0
LINCOLN,1/13/2020,0,0,0,0
LINCOLN,1/14/2020,0,0,0,0
LINCOLN,1/15/2020,0,0,0,0
LINCOLN,1/16/2020,0,0,0,0
LINCOLN,1/17/2020,0,0,0,0
LINCOLN,1/18/2020,0,0,0,0
LINCOLN,1/19/2020,0,0,0,0
LINCOLN,1/20/2020,0,0,0,0
LINCOLN,1/21/2020,0,0,0,0
LINCOLN,1/22/2020,0,0,0,0
LINCOLN,1/23/2020,0,0,0,0
LINCOLN,1/24/2020,0,0,0,0
LINCOLN,1/25/2020,0,0,0,0
LINCOLN,1/26/2020,0,0,0,0
DOUGLAS,9/19/2020,1948,1571,60,3579
DOUGLAS,9/20/2020,1953,1575,60,3588
DOUGLAS,9/21/2020,1962,1582,60,3604
DOUGLAS,9/22/2020,1976,1588,60,3624
DOUGLAS,9/23/2020,1985,1592,60,3637
DOUGLAS,9/24/2020,1998,1598,60,3656
DOUGLAS,9/25/2020,2007,1604,60,3671
DOUGLAS,9/26/2020,2015,1609,60,3684
DOUGLAS,9/27/2020,2020,1613,60,3693
DOUGLAS,9/28/2020,2030,1622,60,3712
DOUGLAS,9/29/2020,2040,1627,60,3727
DOUGLAS,9/30/2020,2049,1637,60,3746
DOUGLAS,10/1/2020,2063,1648,60,3771
DOUGLAS,10/2/2020,2074,1650,60,3784
DOUGLAS,10/3/2020,2086,1654,60,3800
DOUGLAS,10/4/2020,2092,1663,60,3815
DOUGLAS,10/5/2020,2104,1674,60,3838
DOUGLAS,10/6/2020,2113,1682,60,3855
DOUGLAS,10/7/2020,2122,1688,60,3870
DOUGLAS,10/8/2020,2127,1692,60,3879
DOUGLAS,10/9/2020,2136,1697,60,3893
DOUGLAS,10/10/2020,2140,1699,60,3899
DOUGLAS,10/11/2020,2147,1700,60,3907
DOUGLAS,10/12/2020,2153,1709,60,3922
DOUGLAS,10/13/2020,2159,1712,60,3931
DOUGLAS,10/14/2020,2166,1716,60,3942
DOUGLAS,10/15/2020,2167,1720,60,3947
DOUGLAS,10/16/2020,2169,1722,60,3951
DOUGLAS,10/17/2020,2174,1725,60,3959
DOUGLAS,10/18/2020,2174,1725,60,3959
DOUGLAS,10/19/2020,2175,1725,60,3960
DOUGLAS,10/20/2020,2175,1725,60,3960
JACKSON,1/1/2020,1,0,1,2
JACKSON,1/2/2020,1,0,1,2
JACKSON,1/3/2020,1,0,1,2
JACKSON,1/4/2020,1,0,1,2
JACKSON,1/5/2020,1,0,1,2
JACKSON,1/6/2020,1,0,1,2
JACKSON,1/7/2020,1,0,1,2
JACKSON,1/8/2020,1,0,1,2
JACKSON,1/9/2020,1,0,1,2
JACKSON,1/10/2020,1,0,1,2
JACKSON,1/11/2020,1,0,1,2
JACKSON,1/12/2020,1,0,1,2
JACKSON,1/13/2020,1,0,1,2
JACKSON,1/14/2020,1,0,1,2
JACKSON,1/15/2020,1,0,1,2
JACKSON,1/16/2020,1,0,1,2
JACKSON,1/17/2020,1,0,1,2
JACKSON,1/18/2020,1,0,1,2
JACKSON,1/19/2020,1,0,1,2
JACKSON,1/20/2020,1,0,1,2
JACKSON,1/21/2020,1,0,1,2
JACKSON,1/22/2020,1,0,1,2
JACKSON,1/23/2020,1,0,1,2
JACKSON,1/24/2020,1,0,1,2
JACKSON,1/25/2020,1,0,1,2
JACKSON,1/26/2020,1,0,1,2
JACKSON,1/27/2020,1,0,1,2
JACKSON,1/28/2020,1,0,1,2
JACKSON,1/29/2020,1,0,1,2
JACKSON,1/30/2020,1,0,1,2
JACKSON,1/31/2020,1,0,1,2
JACKSON,2/1/2020,1,0,1,2
JACKSON,2/2/2020,1,0,1,2
JACKSON,2/3/2020,1,0,1,2
JACKSON,2/4/2020,1,0,1,2
JACKSON,2/5/2020,1,0,1,2
JACKSON,2/6/2020,1,0,1,2
JACKSON,2/7/2020,1,0,1,2
JACKSON,2/8/2020,1,0,1,2
JACKSON,2/9/2020,1,0,1,2
JACKSON,2/10/2020,1,0,1,2
JACKSON,2/11/2020,1,0,1,2
JACKSON,2/12/2020,1,0,1,2
JACKSON,2/13/2020,1,0,1,2
JACKSON,2/14/2020,1,0,1,2
JACKSON,2/15/2020,1,0,1,2
JACKSON,2/16/2020,1,0,1,2
JACKSON,2/17/2020,1,0,1,2
JACKSON,2/18/2020,1,0,1,2
JACKSON,2/19/2020,1,0,1,2
JACKSON,2/20/2020,1,0,1,2
JACKSON,2/21/2020,1,0,1,2
JACKSON,2/22/2020,1,0,1,2
JACKSON,2/23/2020,1,0,1,2
JACKSON,2/24/2020,1,0,1,2
JACKSON,2/25/2020,1,0,1,2
JACKSON,2/26/2020,1,0,1,2
JACKSON,2/27/2020,1,0,1,2
JACKSON,2/28/2020,1,0,1,2
JACKSON,2/29/2020,1,0,1,2
JACKSON,3/1/2020,1,0,1,2
JACKSON,3/2/2020,1,0,1,2
JACKSON,3/3/2020,1,0,1,2
JACKSON,3/4/2020,1,0,1,2
JACKSON,3/5/2020,1,0,1,2
JACKSON,3/6/2020,1,0,1,2
JACKSON,3/7/2020,1,0,1,2
JACKSON,3/8/2020,1,0,1,2
JACKSON,3/9/2020,1,0,1,2
JACKSON,3/10/2020,1,1,1,3
JACKSON,3/11/2020,2,2,1,5
JACKSON,3/12/2020,3,2,1,6
JACKSON,3/13/2020,3,2,1,6
JACKSON,3/14/2020,4,2,1,7
JACKSON,3/15/2020,6,2,1,9
JACKSON,3/16/2020,7,2,1,10
JACKSON,3/17/2020,8,2,1,11
JACKSON,3/18/2020,8,2,1,11
JACKSON,3/19/2020,9,2,1,12
JACKSON,3/20/2020,11,4,1,16
JACKSON,3/21/2020,11,4,1,16
JACKSON,3/22/2020,12,4,1,17
JACKSON,3/23/2020,14,4,1,19
JACKSON,3/24/2020,15,6,1,22
JACKSON,3/25/2020,17,6,1,24
JACKSON,3/26/2020,17,6,1,24
JACKSON,3/27/2020,18,7,1,26
JACKSON,3/28/2020,18,8,1,27
JACKSON,3/29/2020,20,10,1,31
JACKSON,3/30/2020,21,10,1,32
JACKSON,3/31/2020,21,11,1,33
JACKSON,4/1/2020,23,12,1,36
JACKSON,4/2/2020,24,12,1,37
JACKSON,4/3/2020,26,15,1,42
JACKSON,4/4/2020,26,17,1,44
JACKSON,4/5/2020,26,19,1,46
JACKSON,4/6/2020,30,20,1,51
JACKSON,4/7/2020,32,21,1,54
JACKSON,4/8/2020,34,21,1,56
JACKSON,4/9/2020,35,25,1,61
JACKSON,4/10/2020,38,25,1,64
JACKSON,4/11/2020,39,25,1,65
JACKSON,4/12/2020,39,25,1,65
JACKSON,4/13/2020,40,27,1,68
JACKSON,4/14/2020,41,30,1,72
JACKSON,4/15/2020,42,35,1,78
JACKSON,4/16/2020,43,37,1,81
JACKSON,4/17/2020,46,40,1,87
JACKSON,4/18/2020,46,40,1,87
JACKSON,4/19/2020,49,42,1,92
JACKSON,4/20/2020,58,44,1,103
JACKSON,4/21/2020,59,45,1,105
JACKSON,4/22/2020,61,45,1,107
JACKSON,4/23/2020,64,47,1,112
JACKSON,4/24/2020,65,48,1,114
JACKSON,4/25/2020,66,50,1,117
JACKSON,4/26/2020,66,51,1,118
JACKSON,4/27/2020,70,53,1,124
JACKSON,4/28/2020,72,56,1,129
JACKSON,4/29/2020,72,56,1,129
JACKSON,4/30/2020,74,57,1,132
JACKSON,5/1/2020,75,58,1,134
JACKSON,5/2/2020,80,58,1,139
JACKSON,5/3/2020,80,61,1,142
JACKSON,5/4/2020,81,61,1,143
JACKSON,5/5/2020,81,61,1,143
JACKSON,5/6/2020,82,61,1,144
JACKSON,5/7/2020,83,61,1,145
JACKSON,5/8/2020,83,61,1,145
JACKSON,5/9/2020,83,61,1,145
JACKSON,5/10/2020,83,61,1,145
JACKSON,5/11/2020,84,61,1,146
JACKSON,5/12/2020,86,62,1,149
JACKSON,5/13/2020,90,65,1,156
JACKSON,5/14/2020,90,67,1,158
JACKSON,5/15/2020,92,67,1,160
JACKSON,5/16/2020,93,67,1,161
JACKSON,5/17/2020,94,71,1,166
JACKSON,5/18/2020,94,73,1,168
JACKSON,5/19/2020,95,77,1,173
JACKSON,5/20/2020,96,77,1,174
JACKSON,5/21/2020,99,85,1,185
JACKSON,5/22/2020,102,90,1,193
JACKSON,5/23/2020,103,98,1,202
JACKSON,5/24/2020,104,99,1,204
JACKSON,5/25/2020,105,101,1,207
JACKSON,5/26/2020,107,107,1,215
JACKSON,5/27/2020,107,108,1,216
JACKSON,5/28/2020,110,109,1,220
JACKSON,5/29/2020,113,114,1,228
JACKSON,5/30/2020,114,119,1,234
JACKSON,5/31/2020,115,121,1,237
JACKSON,6/1/2020,119,124,1,244
JACKSON,6/2/2020,124,126,1,251
JACKSON,6/3/2020,125,129,1,255
JACKSON,6/4/2020,126,132,1,259
JACKSON,6/5/2020,131,135,1,267
JACKSON,6/6/2020,132,137,1,270
JACKSON,6/7/2020,132,139,1,272
JACKSON,6/8/2020,135,143,1,279
JACKSON,6/9/2020,138,151,1,290
JACKSON,6/10/2020,138,154,1,293
JACKSON,6/11/2020,139,155,1,295
JACKSON,6/12/2020,144,156,1,301
JACKSON,6/13/2020,145,162,1,308
JACKSON,6/14/2020,148,165,1,314
JACKSON,6/15/2020,153,165,1,319
JACKSON,6/16/2020,156,170,1,327
JACKSON,6/17/2020,159,172,2,333
JACKSON,6/18/2020,163,182,2,347
JACKSON,6/19/2020,170,191,2,363
JACKSON,6/20/2020,174,193,2,369
JACKSON,6/21/2020,176,195,2,373
JACKSON,6/22/2020,180,198,2,380
JACKSON,6/23/2020,186,200,2,388
JACKSON,6/24/2020,187,207,2,396
JACKSON,6/25/2020,197,213,4,414
JACKSON,6/26/2020,209,219,5,433
JACKSON,6/27/2020,215,224,5,444
JACKSON,6/28/2020,216,225,5,446
JACKSON,6/29/2020,225,235,5,465
JACKSON,6/30/2020,233,248,6,487
JACKSON,7/1/2020,247,254,7,508
JACKSON,7/2/2020,261,261,7,529
JACKSON,7/3/2020,273,267,7,547
JACKSON,7/4/2020,278,271,7,556
JACKSON,7/5/2020,281,276,7,564
JACKSON,7/6/2020,295,296,7,598
JACKSON,7/7/2020,318,315,7,640
JACKSON,7/8/2020,340,328,7,675
JACKSON,7/9/2020,360,335,8,703
JACKSON,7/10/2020,381,353,8,742
JACKSON,7/11/2020,392,362,8,762
JACKSON,7/12/2020,400,375,10,785
JACKSON,7/13/2020,417,390,10,817
JACKSON,7/14/2020,441,409,10,860
JACKSON,7/15/2020,457,421,10,888
JACKSON,7/16/2020,478,436,10,924
JACKSON,7/17/2020,491,444,10,945
JACKSON,7/18/2020,514,456,10,980
JACKSON,7/19/2020,523,463,10,996
JACKSON,7/20/2020,544,481,11,1036
JACKSON,7/21/2020,557,487,11,1055
JACKSON,7/22/2020,567,491,11,1069
JACKSON,7/23/2020,576,505,13,1094
JACKSON,7/24/2020,588,516,13,1117
JACKSON,7/25/2020,602,528,13,1143
JACKSON,7/26/2020,607,535,13,1155
JACKSON,7/27/2020,618,544,14,1176
JACKSON,7/28/2020,635,555,14,1204
JACKSON,7/29/2020,646,563,14,1223
JACKSON,7/30/2020,660,572,14,1246
JACKSON,7/31/2020,670,580,14,1264
JACKSON,8/1/2020,682,582,14,1278
JACKSON,8/2/2020,691,591,15,1297
JACKSON,8/3/2020,706,599,15,1320
JACKSON,8/4/2020,713,610,16,1339
JACKSON,8/5/2020,718,620,16,1354
JACKSON,8/6/2020,727,623,16,1366
JACKSON,8/7/2020,735,635,16,1386
JACKSON,8/8/2020,738,641,16,1395
JACKSON,8/9/2020,745,645,16,1406
JACKSON,8/10/2020,752,651,16,1419
JACKSON,8/11/2020,761,660,16,1437
JACKSON,8/12/2020,765,664,17,1446
JACKSON,8/13/2020,772,672,17,1461
JACKSON,8/14/2020,784,677,17,1478
JACKSON,8/15/2020,786,682,17,1485
JACKSON,8/16/2020,789,687,17,1493
JACKSON,8/17/2020,794,691,17,1502
JACKSON,8/18/2020,805,696,17,1518
JACKSON,8/19/2020,810,701,17,1528
JACKSON,8/20/2020,815,709,17,1541
JACKSON,8/21/2020,823,712,17,1552
JACKSON,8/22/2020,827,721,17,1565
JACKSON,8/23/2020,834,723,17,1574
JACKSON,8/24/2020,848,732,17,1597
JACKSON,8/25/2020,854,743,17,1614
JACKSON,8/26/2020,866,751,18,1635
JACKSON,8/27/2020,882,760,18,1660
JACKSON,8/28/2020,897,771,18,1686
JACKSON,8/29/2020,903,777,18,1698
JACKSON,8/30/2020,906,778,18,1702
JACKSON,8/31/2020,919,788,18,1725
JACKSON,9/1/2020,928,792,18,1738
JACKSON,9/2/2020,936,795,19,1750
JACKSON,9/3/2020,950,803,19,1772
JACKSON,9/4/2020,957,809,19,1785
JACKSON,9/5/2020,966,815,19,1800
JACKSON,9/6/2020,975,822,19,1816
JACKSON,9/7/2020,980,826,19,1825
JACKSON,9/8/2020,990,835,19,1844
JACKSON,9/9/2020,999,843,19,1861
JACKSON,9/10/2020,1009,850,19,1878
JACKSON,9/11/2020,1018,858,19,1895
JACKSON,9/12/2020,1028,863,19,1910
JACKSON,9/13/2020,1036,869,19,1924
JACKSON,9/14/2020,1043,874,19,1936
JACKSON,9/15/2020,1052,880,19,1951
JACKSON,9/16/2020,1058,887,19,1964
JACKSON,9/17/2020,1066,894,19,1979
JACKSON,9/18/2020,1074,899,19,1992
JACKSON,9/19/2020,1079,901,19,1999
JACKSON,9/20/2020,1086,907,19,2012
JACKSON,9/21/2020,1090,914,19,2023
JACKSON,9/22/2020,1096,921,19,2036
JACKSON,9/23/2020,1104,924,19,2047
JACKSON,9/24/2020,1108,928,19,2055
JACKSON,9/25/2020,1113,935,19,2067
JACKSON,9/26/2020,1115,937,19,2071
JACKSON,9/27/2020,1117,940,19,2076
JACKSON,9/28/2020,1122,946,19,2087
JACKSON,9/29/2020,1128,951,19,2098
JACKSON,9/30/2020,1133,951,19,2103
JACKSON,10/1/2020,1141,955,19,2115
JACKSON,10/2/2020,1143,957,19,2119
JACKSON,10/3/2020,1148,965,19,2132
JACKSON,10/4/2020,1156,969,19,2144
JACKSON,10/5/2020,1160,979,19,2158
JACKSON,10/6/2020,1166,986,19,2171
JACKSON,10/7/2020,1173,988,19,2180
JACKSON,10/8/2020,1173,989,19,2181
JACKSON,10/9/2020,1178,994,19,2191
JACKSON,10/10/2020,1189,1000,19,2208
JACKSON,10/11/2020,1194,1003,19,2216
JACKSON,10/12/2020,1209,1008,19,2236
JACKSON,10/13/2020,1213,1015,19,2247
JACKSON,10/14/2020,1217,1019,19,2255
JACKSON,10/15/2020,1218,1026,19,2263
JACKSON,10/16/2020,1223,1031,19,2273
JACKSON,10/17/2020,1228,1034,19,2281
JACKSON,10/18/2020,1228,1035,19,2282
JACKSON,10/19/2020,1228,1035,19,2282
JACKSON,10/20/2020,1228,1035,19,2282
TURNER,1/1/2020,0,0,0,0
TURNER,1/2/2020,0,0,0,0
TURNER,1/3/2020,0,0,0,0
TURNER,1/4/2020,0,0,0,0
TURNER,1/5/2020,0,0,0,0
TURNER,1/6/2020,0,0,0,0
TURNER,1/7/2020,0,0,0,0
TURNER,1/8/2020,0,0,0,0
TURNER,1/9/2020,0,0,0,0
TURNER,1/10/2020,0,0,0,0
TURNER,1/11/2020,0,0,0,0
TURNER,1/12/2020,0,0,0,0
TURNER,1/13/2020,0,0,0,0
TURNER,1/14/2020,0,0,0,0
TURNER,1/15/2020,0,0,0,0
TURNER,1/16/2020,0,0,0,0
TURNER,1/17/2020,0,0,0,0
TURNER,1/18/2020,0,0,0,0
TURNER,1/19/2020,0,0,0,0
TURNER,1/20/2020,0,0,0,0
TURNER,1/21/2020,0,0,0,0
TURNER,1/22/2020,0,0,0,0
TURNER,1/23/2020,0,0,0,0
TURNER,1/24/2020,0,0,0,0
TURNER,1/25/2020,0,0,0,0
TURNER,1/26/2020,0,0,0,0
TURNER,1/27/2020,0,0,0,0
TURNER,1/28/2020,0,0,0,0
TURNER,1/29/2020,0,0,0,0
TURNER,1/30/2020,0,0,0,0
TURNER,1/31/2020,0,0,0,0
TURNER,2/1/2020,0,0,0,0
TURNER,2/2/2020,0,0,0,0
TURNER,2/3/2020,0,0,0,0
TURNER,2/4/2020,0,0,0,0
TURNER,2/5/2020,0,0,0,0
TURNER,2/6/2020,0,0,0,0
TURNER,2/7/2020,0,0,0,0
TURNER,2/8/2020,0,0,0,0
TURNER,2/9/2020,0,0,0,0
TURNER,2/10/2020,0,0,0,0
TURNER,2/11/2020,0,0,0,0
TURNER,2/12/2020,0,0,0,0
TURNER,2/13/2020,0,0,0,0
TURNER,2/14/2020,0,0,0,0
TURNER,2/15/2020,0,0,0,0
TURNER,2/16/2020,0,0,0,0
TURNER,2/17/2020,0,0,0,0
TURNER,2/18/2020,0,0,0,0
TURNER,2/19/2020,0,0,0,0
TURNER,2/20/2020,0,0,0,0
TURNER,2/21/2020,0,0,0,0
TURNER,2/22/2020,0,0,0,0
TURNER,2/23/2020,0,0,0,0
TURNER,2/24/2020,0,0,0,0
TURNER,2/25/2020,0,0,0,0
TURNER,2/26/2020,0,0,0,0
TURNER,2/27/2020,0,0,0,0
TURNER,2/28/2020,0,0,0,0
TURNER,2/29/2020,0,0,0,0
TURNER,3/1/2020,0,0,0,0
TURNER,3/2/2020,0,0,0,0
TURNER,3/3/2020,0,0,0,0
TURNER,3/4/2020,0,1,0,1
TURNER,3/5/2020,0,1,0,1
TURNER,3/6/2020,0,1,0,1
TURNER,3/7/2020,0,1,0,1
TURNER,3/8/2020,0,1,0,1
TURNER,3/9/2020,0,1,0,1
TURNER,3/10/2020,1,1,0,2
TURNER,3/11/2020,1,1,0,2
TURNER,3/12/2020,1,1,0,2
TURNER,3/13/2020,1,1,0,2
TURNER,3/14/2020,1,1,0,2
UNION,5/12/2020,20,19,0,39
BURKE,8/26/2020,358,304,5,667
MURRAY,6/5/2020,72,62,0,134
MCINTOSH,2/20/2020,0,0,0,0
UNION,5/13/2020,20,19,0,39
BURKE,8/27/2020,362,304,5,671
MURRAY,6/6/2020,77,65,0,142
UNION,5/14/2020,20,19,0,39
BURKE,8/28/2020,364,305,5,674
MCINTOSH,2/21/2020,0,0,0,0
MURRAY,6/7/2020,79,68,0,147
UNION,5/15/2020,21,21,0,42
UNION,5/16/2020,21,21,0,42
UNION,5/17/2020,21,21,0,42
UNION,5/18/2020,21,21,1,43
UNION,5/19/2020,21,21,1,43
UNION,5/20/2020,21,21,1,43
UNION,5/21/2020,21,21,1,43
UNION,5/22/2020,21,21,1,43
UNION,5/23/2020,22,21,1,44
UNION,5/24/2020,23,21,1,45
UNION,5/25/2020,23,22,1,46
UNION,5/26/2020,23,22,1,46
UNION,5/27/2020,24,22,1,47
UNION,5/28/2020,24,22,1,47
UNION,5/29/2020,25,23,1,49
UNION,5/30/2020,25,23,1,49
UNION,5/31/2020,25,24,1,50
UNION,6/1/2020,25,25,1,51
UNION,6/2/2020,25,25,1,51
UNION,6/3/2020,26,25,1,52
UNION,6/4/2020,26,27,1,54
UNION,6/5/2020,27,27,1,55
UNION,6/6/2020,28,27,1,56
UNION,6/7/2020,28,27,1,56
UNION,6/8/2020,29,27,1,57
UNION,6/9/2020,30,27,1,58
UNION,6/10/2020,30,27,1,58
UNION,6/11/2020,31,27,1,59
UNION,6/12/2020,32,29,1,62
UNION,6/13/2020,32,29,1,62
UNION,6/14/2020,32,29,1,62
UNION,6/15/2020,33,29,1,63
UNION,6/16/2020,34,30,1,65
UNION,6/17/2020,34,31,1,66
UNION,6/18/2020,34,31,1,66
UNION,6/19/2020,35,33,1,69
UNION,6/20/2020,35,33,1,69
UNION,6/21/2020,36,33,1,70
UNION,6/22/2020,36,35,1,72
UNION,6/23/2020,37,35,1,73
UNION,6/24/2020,43,35,1,79
UNION,6/25/2020,44,35,1,80
UNION,6/26/2020,45,36,1,82
UNION,6/27/2020,46,37,1,84
UNION,6/28/2020,47,39,1,87
UNION,6/29/2020,49,43,1,93
UNION,6/30/2020,50,43,1,94
UNION,7/1/2020,52,45,1,98
UNION,7/2/2020,53,47,1,101
UNION,7/3/2020,54,48,1,103
UNION,7/4/2020,55,50,1,106
UNION,7/5/2020,55,51,1,107
UNION,7/6/2020,57,53,1,111
UNION,7/7/2020,58,56,1,115
UNION,7/8/2020,61,59,1,121
UNION,7/9/2020,65,68,2,135
UNION,7/10/2020,68,72,2,142
UNION,7/11/2020,71,73,2,146
UNION,7/12/2020,75,76,2,153
UNION,7/13/2020,82,77,2,161
UNION,7/14/2020,85,78,2,165
UNION,7/15/2020,86,79,2,167
UNION,7/16/2020,89,81,2,172
UNION,7/17/2020,92,85,2,179
UNION,7/18/2020,94,88,2,184
UNION,7/19/2020,94,90,2,186
UNION,7/20/2020,103,93,2,198
UNION,7/21/2020,109,95,2,206
UNION,7/22/2020,117,101,2,220
UNION,7/23/2020,123,104,2,229
UNION,7/24/2020,126,106,2,234
UNION,7/25/2020,126,110,2,238
UNION,7/26/2020,127,111,2,240
UNION,7/27/2020,131,116,2,249
UNION,7/28/2020,139,120,2,261
UNION,7/29/2020,145,121,2,268
UNION,7/30/2020,149,125,2,276
UNION,7/31/2020,159,127,2,288
UNION,8/1/2020,162,127,2,291
UNION,8/2/2020,165,130,2,297
UNION,8/3/2020,176,135,2,313
UNION,8/4/2020,179,140,2,321
UNION,8/5/2020,188,142,2,332
UNION,8/6/2020,203,145,2,350
UNION,8/7/2020,207,150,2,359
UNION,8/8/2020,210,153,2,365
UNION,8/9/2020,211,154,2,367
UNION,8/10/2020,222,161,2,385
UNION,8/11/2020,226,163,2,391
UNION,8/12/2020,244,165,2,411
UNION,8/13/2020,250,169,3,422
UNION,8/14/2020,255,173,3,431
UNION,8/15/2020,259,179,3,441
UNION,8/16/2020,261,185,3,449
UNION,8/17/2020,264,189,3,456
UNION,8/18/2020,269,191,3,463
UNION,8/19/2020,275,197,3,475
UNION,8/20/2020,281,205,3,489
UNION,8/21/2020,282,212,3,497
UNION,8/22/2020,290,218,3,511
UNION,8/23/2020,292,220,3,515
UNION,8/24/2020,294,227,3,524
UNION,8/25/2020,300,230,3,533
UNION,8/26/2020,303,233,3,539
UNION,8/27/2020,309,237,3,549
UNION,8/28/2020,314,239,3,556
UNION,8/29/2020,318,240,3,561
UNION,8/30/2020,320,242,3,565
UNION,8/31/2020,322,246,3,571
UNION,9/1/2020,324,248,3,575
UNION,9/2/2020,326,248,3,577
UNION,9/3/2020,333,251,3,587
UNION,9/4/2020,335,252,3,590
UNION,9/5/2020,338,253,3,594
UNION,9/6/2020,342,254,3,599
UNION,9/7/2020,349,256,3,608
UNION,9/8/2020,377,267,3,647
UNION,9/9/2020,383,269,4,656
UNION,9/10/2020,385,273,4,662
UNION,9/11/2020,387,275,4,666
UNION,9/12/2020,389,275,4,668
UNION,9/13/2020,394,276,5,675
UNION,9/14/2020,400,281,5,686
UNION,9/15/2020,401,282,5,688
UNION,9/16/2020,402,283,5,690
UNION,9/17/2020,407,284,5,696
UNION,9/18/2020,415,291,6,712
UNION,9/19/2020,415,295,6,716
UNION,9/20/2020,418,296,7,721
UNION,9/21/2020,429,301,7,737
UNION,9/22/2020,448,307,7,762
UNION,9/23/2020,451,307,7,765
UNION,9/24/2020,457,308,7,772
UNION,9/25/2020,466,311,7,784
UNION,9/26/2020,469,312,7,788
UNION,9/27/2020,471,313,7,791
UNION,9/28/2020,473,315,7,795
UNION,9/29/2020,481,316,7,804
UNION,9/30/2020,487,320,7,814
UNION,10/1/2020,490,321,7,818
UNION,10/2/2020,503,321,7,831
UNION,10/3/2020,506,324,7,837
UNION,10/4/2020,507,324,7,838
UNION,10/5/2020,510,324,7,841
UNION,10/6/2020,513,328,7,848
UNION,10/7/2020,513,328,7,848
UNION,10/8/2020,515,328,7,850
UNION,10/9/2020,515,328,7,850
UNION,10/10/2020,515,328,7,850
UNION,10/11/2020,516,329,7,852
UNION,10/12/2020,518,331,7,856
UNION,10/13/2020,518,331,7,856
UNION,10/14/2020,519,331,7,857
UNION,10/15/2020,521,332,7,860
UNION,10/16/2020,521,333,7,861
UNION,10/17/2020,521,334,7,862
UNION,10/18/2020,521,334,7,862
UNION,10/19/2020,521,334,7,862
UNION,10/20/2020,521,334,7,862
BURKE,1/1/2020,0,0,0,0
BURKE,1/2/2020,0,0,0,0
BURKE,1/3/2020,0,0,0,0
BURKE,1/4/2020,0,0,0,0
BURKE,1/5/2020,0,0,0,0
BURKE,1/6/2020,0,0,0,0
BURKE,1/7/2020,0,0,0,0
BURKE,1/8/2020,0,0,0,0
BURKE,1/9/2020,0,0,0,0
BURKE,1/10/2020,0,0,0,0
BURKE,1/11/2020,0,0,0,0
BURKE,1/12/2020,0,0,0,0
BURKE,1/13/2020,0,0,0,0
BURKE,1/14/2020,0,0,0,0
BURKE,1/15/2020,0,0,0,0
BURKE,1/16/2020,0,0,0,0
BURKE,1/17/2020,0,0,0,0
BURKE,1/18/2020,0,0,0,0
BURKE,1/19/2020,0,0,0,0
BURKE,1/20/2020,0,0,0,0
BURKE,1/21/2020,0,0,0,0
BURKE,1/22/2020,0,0,0,0
BURKE,1/23/2020,0,0,0,0
BURKE,1/24/2020,0,0,0,0
BURKE,1/25/2020,0,0,0,0
BURKE,1/26/2020,0,0,0,0
BURKE,1/27/2020,0,0,0,0
BURKE,1/28/2020,0,0,0,0
BURKE,1/29/2020,0,0,0,0
BURKE,1/30/2020,0,0,0,0
BURKE,1/31/2020,0,0,0,0
BURKE,2/1/2020,0,0,0,0
BURKE,2/2/2020,0,0,0,0
BURKE,2/3/2020,0,0,0,0
BURKE,2/4/2020,0,0,0,0
BURKE,2/5/2020,0,0,0,0
BURKE,2/6/2020,0,0,0,0
BURKE,2/7/2020,0,0,0,0
BURKE,2/8/2020,0,0,0,0
BURKE,2/9/2020,0,0,0,0
BURKE,2/10/2020,0,0,0,0
BURKE,2/11/2020,0,0,0,0
BURKE,2/12/2020,0,0,0,0
BURKE,2/13/2020,0,0,0,0
BURKE,2/14/2020,0,0,0,0
BURKE,2/15/2020,0,0,0,0
BURKE,2/16/2020,0,0,0,0
BURKE,2/17/2020,0,0,0,0
BURKE,2/18/2020,0,0,0,0
BURKE,2/19/2020,0,0,0,0
BURKE,2/20/2020,0,0,0,0
BURKE,2/21/2020,0,0,0,0
BURKE,2/22/2020,0,0,0,0
BURKE,2/23/2020,0,0,0,0
BURKE,2/24/2020,0,0,0,0
BURKE,2/25/2020,0,0,0,0
BURKE,2/26/2020,0,0,0,0
BURKE,2/27/2020,0,0,0,0
BURKE,2/28/2020,0,0,0,0
BURKE,2/29/2020,0,0,0,0
BURKE,3/1/2020,0,0,0,0
BURKE,3/2/2020,0,0,0,0
BURKE,3/3/2020,0,0,0,0
BURKE,3/4/2020,0,0,0,0
BURKE,3/5/2020,0,0,0,0
BURKE,3/6/2020,0,0,0,0
BURKE,3/7/2020,0,0,0,0
BURKE,3/8/2020,0,0,0,0
BURKE,3/9/2020,0,0,0,0
BURKE,3/10/2020,1,0,0,1
BURKE,3/11/2020,1,0,0,1
BURKE,3/12/2020,1,0,0,1
BURKE,3/13/2020,1,0,0,1
BURKE,3/14/2020,1,1,0,2
BURKE,3/15/2020,3,1,0,4
BURKE,3/16/2020,3,2,0,5
BURKE,3/17/2020,3,2,0,5
BURKE,3/18/2020,3,2,0,5
BURKE,3/19/2020,5,2,0,7
BURKE,3/20/2020,6,3,0,9
BURKE,3/21/2020,6,3,0,9
BURKE,3/22/2020,6,3,0,9
BURKE,3/23/2020,6,3,0,9
BURKE,3/24/2020,6,4,0,10
BURKE,3/25/2020,6,4,0,10
BURKE,3/26/2020,7,4,0,11
BURKE,3/27/2020,9,6,0,15
BURKE,3/28/2020,9,7,0,16
BURKE,3/29/2020,9,8,0,17
BURKE,3/30/2020,10,8,0,18
BURKE,3/31/2020,10,8,0,18
BURKE,4/1/2020,12,11,0,23
BURKE,4/2/2020,13,11,0,24
BURKE,4/3/2020,15,12,0,27
BURKE,4/4/2020,16,12,0,28
BURKE,4/5/2020,16,13,0,29
BURKE,4/6/2020,17,15,0,32
BURKE,4/7/2020,19,16,0,35
BURKE,4/8/2020,20,16,0,36
BURKE,4/9/2020,21,19,0,40
BURKE,4/10/2020,25,22,0,47
BURKE,4/11/2020,25,22,0,47
BURKE,4/12/2020,25,23,0,48
BURKE,4/13/2020,28,25,0,53
BURKE,4/14/2020,33,26,0,59
BURKE,4/15/2020,34,26,0,60
BURKE,4/16/2020,36,30,0,66
BURKE,4/17/2020,38,31,0,69
BURKE,4/18/2020,42,32,0,74
BURKE,4/19/2020,42,33,0,75
BURKE,4/20/2020,47,33,0,80
BURKE,4/21/2020,47,33,0,80
BURKE,4/22/2020,48,35,0,83
BURKE,4/23/2020,49,38,1,88
BURKE,4/24/2020,50,40,1,91
BURKE,4/25/2020,50,43,1,94
BURKE,4/26/2020,50,44,1,95
BURKE,4/27/2020,50,46,1,97
BURKE,4/28/2020,52,46,1,99
BURKE,4/29/2020,53,46,1,100
BURKE,4/30/2020,54,46,1,101
BURKE,5/1/2020,56,47,1,104
BURKE,5/2/2020,58,48,1,107
BURKE,5/3/2020,58,48,1,107
BURKE,5/4/2020,58,50,1,109
BURKE,5/5/2020,59,50,1,110
BURKE,5/6/2020,60,53,1,114
BURKE,5/7/2020,62,53,1,116
BURKE,5/8/2020,64,55,1,120
BURKE,5/9/2020,64,55,1,120
BURKE,5/10/2020,64,55,1,120
BURKE,5/11/2020,64,55,1,120
BURKE,5/12/2020,64,55,1,120
BURKE,5/13/2020,65,56,1,122
BURKE,5/14/2020,66,57,1,124
BURKE,5/15/2020,66,57,1,124
BURKE,5/16/2020,67,57,1,125
BURKE,5/17/2020,67,57,1,125
BURKE,5/18/2020,67,58,1,126
BURKE,5/19/2020,67,59,1,127
BURKE,5/20/2020,67,59,1,127
BURKE,5/21/2020,67,59,1,127
BURKE,5/22/2020,67,59,1,127
BURKE,5/23/2020,67,59,1,127
BURKE,5/24/2020,67,59,1,127
BURKE,5/25/2020,67,59,1,127
BURKE,5/26/2020,67,59,1,127
BURKE,5/27/2020,67,59,1,127
BURKE,5/28/2020,67,59,1,127
BURKE,5/29/2020,67,59,1,127
BURKE,5/30/2020,67,59,1,127
BURKE,5/31/2020,67,59,1,127
BURKE,6/1/2020,68,60,1,129
BURKE,6/2/2020,68,60,1,129
BURKE,6/3/2020,69,60,1,130
BURKE,6/4/2020,69,60,1,130
BURKE,6/5/2020,69,60,1,130
BURKE,6/6/2020,69,60,1,130
BURKE,6/7/2020,69,60,1,130
BURKE,6/8/2020,69,60,1,130
BURKE,6/9/2020,69,61,1,131
BURKE,6/10/2020,69,61,1,131
BURKE,6/11/2020,71,61,1,133
BURKE,6/12/2020,71,61,1,133
BURKE,6/13/2020,71,61,1,133
BURKE,6/14/2020,71,63,1,135
BURKE,6/15/2020,72,64,1,137
BURKE,6/16/2020,72,66,1,139
BURKE,6/17/2020,72,66,1,139
BURKE,6/18/2020,74,67,1,142
BURKE,6/19/2020,75,69,1,145
BURKE,6/20/2020,76,69,1,146
BURKE,6/21/2020,76,69,1,146
BURKE,6/22/2020,77,70,1,148
BURKE,6/23/2020,77,70,1,148
BURKE,6/24/2020,82,70,1,153
BURKE,6/25/2020,84,74,1,159
BURKE,6/26/2020,87,76,1,164
BURKE,6/27/2020,87,78,1,166
BURKE,6/28/2020,88,79,1,168
BURKE,6/29/2020,94,79,1,174
BURKE,6/30/2020,97,81,1,179
BURKE,7/1/2020,103,82,1,186
BURKE,7/2/2020,107,83,1,191
BURKE,7/3/2020,112,86,1,199
BURKE,7/4/2020,112,88,1,201
BURKE,7/5/2020,115,90,1,206
BURKE,7/6/2020,125,93,1,219
BURKE,7/7/2020,128,95,1,224
BURKE,7/8/2020,128,99,1,228
BURKE,7/9/2020,131,103,1,235
BURKE,7/10/2020,134,107,1,242
BURKE,7/11/2020,141,109,1,251
BURKE,7/12/2020,145,109,1,255
BURKE,7/13/2020,158,117,1,276
BURKE,7/14/2020,164,121,2,287
BURKE,7/15/2020,177,123,2,302
BURKE,7/16/2020,184,123,2,309
BURKE,7/17/2020,194,129,2,325
BURKE,7/18/2020,199,133,2,334
BURKE,7/19/2020,206,136,2,344
BURKE,7/20/2020,214,140,4,358
BURKE,7/21/2020,221,147,4,372
BURKE,7/22/2020,235,153,4,392
BURKE,7/23/2020,237,158,4,399
BURKE,7/24/2020,242,162,4,408
BURKE,7/25/2020,245,164,4,413
BURKE,7/26/2020,246,167,4,417
BURKE,7/27/2020,260,177,4,441
BURKE,7/28/2020,263,181,4,448
BURKE,7/29/2020,264,183,4,451
BURKE,7/30/2020,268,189,4,461
BURKE,7/31/2020,272,195,4,471
BURKE,8/1/2020,275,197,4,476
BURKE,8/2/2020,278,199,4,481
BURKE,8/3/2020,286,204,4,494
BURKE,8/4/2020,292,209,5,506
BURKE,8/5/2020,297,214,5,516
BURKE,8/6/2020,301,217,5,523
BURKE,8/7/2020,303,220,5,528
BURKE,8/8/2020,311,224,5,540
BURKE,8/9/2020,313,225,5,543
BURKE,8/10/2020,317,231,5,553
BURKE,8/11/2020,319,248,5,572
BURKE,8/12/2020,323,255,5,583
BURKE,8/13/2020,326,259,5,590
BURKE,8/14/2020,330,272,5,607
BURKE,8/15/2020,331,273,5,609
BURKE,8/16/2020,331,277,5,613
BURKE,8/17/2020,335,282,5,622
BURKE,8/18/2020,343,290,5,638
BURKE,8/19/2020,346,292,5,643
BURKE,8/20/2020,347,295,5,647
BURKE,8/21/2020,348,296,5,649
BURKE,8/22/2020,350,296,5,651
BURKE,8/23/2020,352,297,5,654
BURKE,8/24/2020,353,299,5,657
BURKE,8/25/2020,355,302,5,662
BURKE,8/29/2020,364,306,5,675
MURRAY,6/8/2020,83,69,0,152
MURRAY,6/9/2020,83,72,0,155
MCINTOSH,2/22/2020,0,0,0,0
BURKE,8/30/2020,365,312,5,682
MCINTOSH,2/23/2020,0,1,0,1
MURRAY,6/10/2020,85,72,0,157
MCINTOSH,2/24/2020,0,1,0,1
BURKE,8/31/2020,373,312,5,690
MURRAY,6/11/2020,87,74,0,161
MCINTOSH,2/25/2020,0,1,0,1
BURKE,9/1/2020,378,316,5,699
MURRAY,6/12/2020,89,74,0,163
MCINTOSH,2/26/2020,0,1,0,1
BURKE,9/2/2020,382,317,5,704
MURRAY,6/13/2020,93,75,0,168
MCINTOSH,2/27/2020,0,1,0,1
BURKE,9/3/2020,383,319,5,707
MURRAY,6/14/2020,95,76,0,171
MCINTOSH,2/28/2020,0,1,0,1
BURKE,9/4/2020,385,322,5,712
MURRAY,6/15/2020,96,79,0,175
MURRAY,6/16/2020,100,84,0,184
MURRAY,6/17/2020,101,85,0,186
MURRAY,6/18/2020,105,86,0,191
MURRAY,6/19/2020,106,88,0,194
MURRAY,6/20/2020,110,89,0,199
MURRAY,6/21/2020,112,93,0,205
MURRAY,6/22/2020,116,96,0,212
MURRAY,6/23/2020,117,101,0,218
MURRAY,6/24/2020,127,106,0,233
MURRAY,6/25/2020,130,111,0,241
MURRAY,6/26/2020,132,113,0,245
MURRAY,6/27/2020,135,116,0,251
MURRAY,6/28/2020,139,120,0,259
MURRAY,6/29/2020,142,124,0,266
MURRAY,6/30/2020,147,129,0,276
MURRAY,7/1/2020,158,133,0,291
MURRAY,7/2/2020,164,138,0,302
MURRAY,7/3/2020,167,143,0,310
MURRAY,7/4/2020,171,146,0,317
MURRAY,7/5/2020,176,152,0,328
MURRAY,7/6/2020,186,157,0,343
MURRAY,7/7/2020,191,160,0,351
MURRAY,7/8/2020,197,171,0,368
MURRAY,7/9/2020,202,180,0,382
MURRAY,7/10/2020,207,184,0,391
MURRAY,7/11/2020,214,191,0,405
MURRAY,7/12/2020,224,195,0,419
MURRAY,7/13/2020,231,199,0,430
MURRAY,7/14/2020,233,210,0,443
MURRAY,7/15/2020,242,218,0,460
MURRAY,7/16/2020,249,225,0,474
MURRAY,7/17/2020,260,229,0,489
MURRAY,7/18/2020,263,231,0,494
MURRAY,7/19/2020,265,233,0,498
MURRAY,7/20/2020,269,238,0,507
MURRAY,7/21/2020,281,242,0,523
MURRAY,7/22/2020,286,249,1,536
MURRAY,7/23/2020,293,253,1,547
MURRAY,7/24/2020,297,258,2,557
MURRAY,7/25/2020,299,261,2,562
MURRAY,7/26/2020,306,262,2,570
MURRAY,7/27/2020,311,262,2,575
MURRAY,7/28/2020,318,268,2,588
MURRAY,7/29/2020,322,271,2,595
MURRAY,7/30/2020,325,273,2,600
MURRAY,7/31/2020,327,273,2,602
MURRAY,8/1/2020,330,277,2,609
MURRAY,8/2/2020,332,278,2,612
MURRAY,8/3/2020,339,281,2,622
MURRAY,8/4/2020,342,287,2,631
MURRAY,8/5/2020,344,290,2,636
MURRAY,8/6/2020,347,290,2,639
MURRAY,8/7/2020,352,292,2,646
MURRAY,8/8/2020,354,294,2,650
MURRAY,8/9/2020,356,294,2,652
MURRAY,8/10/2020,358,298,2,658
MURRAY,8/11/2020,358,300,2,660
MURRAY,8/12/2020,361,303,2,666
MURRAY,8/13/2020,367,308,2,677
MURRAY,8/14/2020,371,309,2,682
MURRAY,8/15/2020,372,311,2,685
MURRAY,8/16/2020,374,314,2,690
MURRAY,8/17/2020,375,314,2,691
MURRAY,8/18/2020,378,316,2,696
MURRAY,8/19/2020,379,319,2,700
MURRAY,8/20/2020,379,323,2,704
MURRAY,8/21/2020,379,325,2,706
MURRAY,8/22/2020,379,327,2,708
MURRAY,8/23/2020,380,329,2,711
MURRAY,8/24/2020,381,332,2,715
MURRAY,8/25/2020,385,335,2,722
MURRAY,8/26/2020,387,339,2,728
MURRAY,8/27/2020,388,339,2,729
MURRAY,8/28/2020,389,343,2,734
MURRAY,8/29/2020,390,343,2,735
MURRAY,8/30/2020,390,345,2,737
MURRAY,8/31/2020,390,347,3,740
MURRAY,9/1/2020,393,347,3,743
MURRAY,9/2/2020,394,350,3,747
MURRAY,9/3/2020,399,351,3,753
MURRAY,9/4/2020,399,353,3,755
MURRAY,9/5/2020,399,355,3,757
MURRAY,9/6/2020,402,356,3,761
MURRAY,9/7/2020,403,356,3,762
MURRAY,9/8/2020,405,357,3,765
MURRAY,9/9/2020,408,360,3,771
MURRAY,9/10/2020,415,364,3,782
MURRAY,9/11/2020,417,365,3,785
MURRAY,9/12/2020,420,367,3,790
MURRAY,9/13/2020,420,368,3,791
MURRAY,9/14/2020,424,370,3,797
MURRAY,9/15/2020,427,372,3,802
MURRAY,9/16/2020,431,373,3,807
MURRAY,9/17/2020,431,374,4,809
MURRAY,9/18/2020,436,377,4,817
MURRAY,9/19/2020,439,379,4,822
MURRAY,9/20/2020,440,380,4,824
MURRAY,9/21/2020,443,382,4,829
MURRAY,9/22/2020,446,383,4,833
MURRAY,9/23/2020,449,391,4,844
MURRAY,9/24/2020,451,391,4,846
MURRAY,9/25/2020,451,393,4,848
MURRAY,9/26/2020,455,394,4,853
MURRAY,9/27/2020,456,395,4,855
MURRAY,9/28/2020,458,396,4,858
MURRAY,9/29/2020,464,398,4,866
MURRAY,9/30/2020,464,398,4,866
MURRAY,10/1/2020,467,400,4,871
MURRAY,10/2/2020,471,402,4,877
MURRAY,10/3/2020,473,404,4,881
MURRAY,10/4/2020,476,404,4,884
MURRAY,10/5/2020,480,409,4,893
MURRAY,10/6/2020,481,412,4,897
MURRAY,10/7/2020,486,413,4,903
MURRAY,10/8/2020,490,415,4,909
MURRAY,10/9/2020,493,416,4,913
MURRAY,10/10/2020,496,420,4,920
MURRAY,10/11/2020,499,421,4,924
MURRAY,10/12/2020,502,426,4,932
MURRAY,10/13/2020,507,435,4,946
MURRAY,10/14/2020,508,440,4,952
MURRAY,10/15/2020,511,445,4,960
MURRAY,10/16/2020,513,448,4,965
MURRAY,10/17/2020,513,448,4,965
MURRAY,10/18/2020,514,448,4,966
MURRAY,10/19/2020,514,448,4,966
MURRAY,10/20/2020,514,448,4,966
DOUGLAS,1/1/2020,0,0,0,0
DOUGLAS,1/2/2020,0,0,0,0
DOUGLAS,1/3/2020,0,0,0,0
DOUGLAS,1/4/2020,0,0,0,0
DOUGLAS,1/5/2020,0,0,0,0
DOUGLAS,1/6/2020,0,0,0,0
DOUGLAS,1/7/2020,0,0,0,0
DOUGLAS,1/8/2020,0,0,0,0
DOUGLAS,1/9/2020,0,0,0,0
DOUGLAS,1/10/2020,0,0,0,0
DOUGLAS,1/11/2020,0,0,0,0
DOUGLAS,1/12/2020,0,0,0,0
DOUGLAS,1/13/2020,0,0,0,0
DOUGLAS,1/14/2020,0,0,0,0
DOUGLAS,1/15/2020,0,1,0,1
DOUGLAS,1/16/2020,0,1,0,1
DOUGLAS,1/17/2020,0,1,0,1
DOUGLAS,1/18/2020,0,1,0,1
DOUGLAS,1/19/2020,0,1,0,1
DOUGLAS,1/20/2020,0,1,0,1
DOUGLAS,1/21/2020,0,1,0,1
DOUGLAS,1/22/2020,0,1,0,1
DOUGLAS,1/23/2020,0,1,0,1
DOUGLAS,1/24/2020,0,1,0,1
DOUGLAS,1/25/2020,0,1,0,1
DOUGLAS,1/26/2020,0,1,0,1
DOUGLAS,1/27/2020,0,1,0,1
DOUGLAS,1/28/2020,0,1,0,1
DOUGLAS,1/29/2020,0,1,0,1
DOUGLAS,1/30/2020,0,1,0,1
DOUGLAS,1/31/2020,0,1,0,1
DOUGLAS,2/1/2020,0,1,0,1
DOUGLAS,2/2/2020,0,1,0,1
DOUGLAS,2/3/2020,0,1,0,1
DOUGLAS,2/4/2020,0,1,0,1
DOUGLAS,2/5/2020,0,1,0,1
DOUGLAS,2/6/2020,0,1,0,1
DOUGLAS,2/7/2020,0,1,0,1
DOUGLAS,2/8/2020,0,1,0,1
DOUGLAS,2/9/2020,0,1,0,1
DOUGLAS,2/10/2020,0,1,0,1
DOUGLAS,2/11/2020,0,1,0,1
DOUGLAS,2/12/2020,0,1,0,1
DOUGLAS,2/13/2020,0,1,0,1
DOUGLAS,2/14/2020,0,1,0,1
DOUGLAS,2/15/2020,0,1,0,1
DOUGLAS,2/16/2020,0,1,0,1
DOUGLAS,2/17/2020,0,1,0,1
DOUGLAS,2/18/2020,0,1,0,1
DOUGLAS,2/19/2020,0,1,0,1
DOUGLAS,2/20/2020,0,1,0,1
DOUGLAS,2/21/2020,0,1,0,1
DOUGLAS,2/22/2020,0,1,0,1
DOUGLAS,2/23/2020,0,1,0,1
DOUGLAS,2/24/2020,0,1,0,1
DOUGLAS,2/25/2020,0,2,0,2
DOUGLAS,2/26/2020,0,2,0,2
DOUGLAS,2/27/2020,0,2,0,2
DOUGLAS,2/28/2020,0,2,0,2
DOUGLAS,2/29/2020,0,2,0,2
DOUGLAS,3/1/2020,0,2,0,2
DOUGLAS,3/2/2020,0,2,0,2
DOUGLAS,3/3/2020,0,2,0,2
DOUGLAS,3/4/2020,1,2,0,3
DOUGLAS,3/5/2020,2,3,0,5
DOUGLAS,3/6/2020,2,3,0,5
DOUGLAS,3/7/2020,2,5,0,7
DOUGLAS,3/8/2020,2,6,0,8
DOUGLAS,3/9/2020,3,9,0,12
DOUGLAS,3/10/2020,4,11,0,15
DOUGLAS,3/11/2020,5,12,0,17
DOUGLAS,3/12/2020,7,12,0,19
DOUGLAS,3/13/2020,8,15,0,23
DOUGLAS,3/14/2020,9,16,0,25
DOUGLAS,3/15/2020,15,21,0,36
DOUGLAS,3/16/2020,21,26,0,47
DOUGLAS,3/17/2020,24,28,0,52
DOUGLAS,3/18/2020,26,29,0,55
DOUGLAS,3/19/2020,31,34,0,65
DOUGLAS,3/20/2020,34,40,0,74
DOUGLAS,3/21/2020,37,41,0,78
DOUGLAS,3/22/2020,41,45,0,86
DOUGLAS,3/23/2020,43,52,0,95
DOUGLAS,3/24/2020,47,52,0,99
DOUGLAS,3/25/2020,53,57,0,110
DOUGLAS,3/26/2020,58,63,0,121
DOUGLAS,3/27/2020,64,65,0,129
DOUGLAS,3/28/2020,67,67,0,134
DOUGLAS,3/29/2020,69,68,0,137
DOUGLAS,3/30/2020,72,68,0,140
DOUGLAS,3/31/2020,81,71,0,152
DOUGLAS,4/1/2020,87,73,0,160
DOUGLAS,4/2/2020,90,78,0,168
DOUGLAS,4/3/2020,94,82,0,176
DOUGLAS,4/4/2020,100,82,0,182
DOUGLAS,4/5/2020,102,86,0,188
DOUGLAS,4/6/2020,110,90,0,200
DOUGLAS,4/7/2020,114,92,0,206
DOUGLAS,4/8/2020,119,96,0,215
DOUGLAS,4/9/2020,121,97,0,218
DOUGLAS,4/10/2020,128,99,0,227
DOUGLAS,4/11/2020,132,104,0,236
DOUGLAS,4/12/2020,132,108,0,240
DOUGLAS,4/13/2020,137,109,0,246
DOUGLAS,4/14/2020,141,111,0,252
DOUGLAS,4/15/2020,145,114,0,259
DOUGLAS,4/16/2020,152,123,0,275
DOUGLAS,4/17/2020,159,126,0,285
DOUGLAS,4/18/2020,164,126,0,290
DOUGLAS,4/19/2020,167,128,0,295
DOUGLAS,4/20/2020,173,134,0,307
DOUGLAS,4/21/2020,175,141,0,316
DOUGLAS,4/22/2020,181,144,0,325
DOUGLAS,4/23/2020,184,147,0,331
DOUGLAS,4/24/2020,190,155,0,345
DOUGLAS,4/25/2020,197,158,1,356
DOUGLAS,4/26/2020,198,158,1,357
DOUGLAS,4/27/2020,203,158,1,362
DOUGLAS,4/28/2020,206,159,1,366
DOUGLAS,4/29/2020,209,163,1,373
DOUGLAS,4/30/2020,215,167,1,383
DOUGLAS,5/1/2020,220,170,1,391
DOUGLAS,5/2/2020,223,173,1,397
DOUGLAS,5/3/2020,223,173,1,397
DOUGLAS,5/4/2020,244,185,1,430
DOUGLAS,5/5/2020,245,185,1,431
DOUGLAS,5/6/2020,250,185,1,436
DOUGLAS,5/7/2020,251,187,1,439
DOUGLAS,5/8/2020,252,190,1,443
DOUGLAS,5/9/2020,256,192,1,449
DOUGLAS,5/10/2020,259,196,1,456
DOUGLAS,5/11/2020,261,199,1,461
DOUGLAS,5/12/2020,262,200,1,463
DOUGLAS,5/13/2020,270,202,1,473
DOUGLAS,5/14/2020,273,203,2,478
DOUGLAS,5/15/2020,275,209,2,486
DOUGLAS,5/16/2020,280,212,2,494
DOUGLAS,5/17/2020,283,212,2,497
DOUGLAS,5/18/2020,289,218,2,509
DOUGLAS,5/19/2020,292,219,2,513
DOUGLAS,5/20/2020,294,221,3,518
DOUGLAS,5/21/2020,297,222,4,523
DOUGLAS,5/22/2020,300,226,4,530
DOUGLAS,5/23/2020,304,229,4,537
DOUGLAS,5/24/2020,305,232,4,541
DOUGLAS,5/25/2020,308,236,4,548
DOUGLAS,5/26/2020,311,240,4,555
DOUGLAS,5/27/2020,315,242,4,561
DOUGLAS,5/28/2020,321,246,4,571
DOUGLAS,5/29/2020,329,254,4,587
DOUGLAS,5/30/2020,333,255,4,592
DOUGLAS,5/31/2020,334,258,4,596
DOUGLAS,6/1/2020,342,264,4,610
DOUGLAS,6/2/2020,346,268,4,618
DOUGLAS,6/3/2020,354,273,4,631
DOUGLAS,6/4/2020,360,277,5,642
DOUGLAS,6/5/2020,364,283,5,652
DOUGLAS,6/6/2020,370,285,5,660
DOUGLAS,6/7/2020,373,287,5,665
DOUGLAS,6/8/2020,382,291,6,679
DOUGLAS,6/9/2020,388,301,6,695
DOUGLAS,6/10/2020,398,306,6,710
DOUGLAS,6/11/2020,404,310,6,720
DOUGLAS,6/12/2020,419,317,6,742
DOUGLAS,6/13/2020,425,324,6,755
DOUGLAS,6/14/2020,429,329,6,764
DOUGLAS,6/15/2020,447,335,6,788
DOUGLAS,6/16/2020,455,345,7,807
DOUGLAS,6/17/2020,467,353,7,827
DOUGLAS,6/18/2020,478,359,7,844
DOUGLAS,6/19/2020,492,367,7,866
DOUGLAS,6/20/2020,501,381,7,889
DOUGLAS,6/21/2020,514,388,7,909
DOUGLAS,6/22/2020,542,403,7,952
DOUGLAS,6/23/2020,556,421,8,985
DOUGLAS,6/24/2020,579,438,8,1025
DOUGLAS,6/25/2020,597,463,8,1068
DOUGLAS,6/26/2020,631,481,9,1121
DOUGLAS,6/27/2020,660,504,10,1174
DOUGLAS,6/28/2020,680,525,11,1216
DOUGLAS,6/29/2020,711,546,11,1268
DOUGLAS,6/30/2020,749,563,11,1323
DOUGLAS,7/1/2020,788,583,11,1382
DOUGLAS,7/2/2020,822,603,12,1437
DOUGLAS,7/3/2020,854,619,13,1486
DOUGLAS,7/4/2020,872,629,13,1514
DOUGLAS,7/5/2020,891,651,13,1555
DOUGLAS,7/6/2020,924,682,16,1622
DOUGLAS,7/7/2020,978,716,18,1712
DOUGLAS,7/8/2020,999,741,19,1759
DOUGLAS,7/9/2020,1033,771,20,1824
DOUGLAS,7/10/2020,1065,808,20,1893
DOUGLAS,7/11/2020,1088,827,21,1936
DOUGLAS,7/12/2020,1107,838,21,1966
DOUGLAS,7/13/2020,1137,870,22,2029
DOUGLAS,7/14/2020,1162,897,23,2082
DOUGLAS,7/15/2020,1190,921,27,2138
DOUGLAS,7/16/2020,1215,939,29,2183
DOUGLAS,7/17/2020,1232,971,29,2232
DOUGLAS,7/18/2020,1247,987,30,2264
DOUGLAS,7/19/2020,1263,1004,34,2301
DOUGLAS,7/20/2020,1285,1024,35,2344
DOUGLAS,7/21/2020,1300,1042,36,2378
DOUGLAS,7/22/2020,1320,1068,36,2424
DOUGLAS,7/23/2020,1335,1080,37,2452
DOUGLAS,7/24/2020,1357,1100,38,2495
DOUGLAS,7/25/2020,1375,1109,38,2522
DOUGLAS,7/26/2020,1387,1119,38,2544
DOUGLAS,7/27/2020,1407,1139,39,2585
DOUGLAS,7/28/2020,1427,1150,40,2617
DOUGLAS,7/29/2020,1443,1164,44,2651
DOUGLAS,7/30/2020,1455,1177,45,2677
DOUGLAS,7/31/2020,1474,1187,45,2706
DOUGLAS,8/1/2020,1494,1196,49,2739
DOUGLAS,8/2/2020,1508,1207,52,2767
DOUGLAS,8/3/2020,1519,1219,53,2791
DOUGLAS,8/4/2020,1545,1237,54,2836
DOUGLAS,8/5/2020,1565,1258,56,2879
DOUGLAS,8/6/2020,1581,1271,57,2909
DOUGLAS,8/7/2020,1593,1284,58,2935
DOUGLAS,8/8/2020,1601,1296,59,2956
DOUGLAS,8/9/2020,1612,1306,59,2977
DOUGLAS,8/10/2020,1629,1315,59,3003
DOUGLAS,8/11/2020,1639,1327,60,3026
DOUGLAS,8/12/2020,1649,1341,60,3050
DOUGLAS,8/13/2020,1655,1357,60,3072
DOUGLAS,8/14/2020,1665,1360,60,3085
DOUGLAS,8/15/2020,1673,1371,60,3104
DOUGLAS,8/16/2020,1675,1376,60,3111
DOUGLAS,8/17/2020,1681,1383,60,3124
DOUGLAS,8/18/2020,1689,1391,60,3140
DOUGLAS,8/19/2020,1699,1394,60,3153
DOUGLAS,8/20/2020,1707,1398,60,3165
DOUGLAS,8/21/2020,1716,1404,60,3180
DOUGLAS,8/22/2020,1723,1406,60,3189
DOUGLAS,8/23/2020,1728,1408,60,3196
DOUGLAS,8/24/2020,1740,1415,60,3215
DOUGLAS,8/25/2020,1749,1419,60,3228
DOUGLAS,8/26/2020,1756,1423,60,3239
DOUGLAS,8/27/2020,1765,1427,60,3252
DOUGLAS,8/28/2020,1770,1436,60,3266
DOUGLAS,8/29/2020,1778,1438,60,3276
DOUGLAS,8/30/2020,1783,1445,60,3288
DOUGLAS,8/31/2020,1790,1454,60,3304
DOUGLAS,9/1/2020,1805,1459,60,3324
DOUGLAS,9/2/2020,1817,1463,60,3340
DOUGLAS,9/3/2020,1824,1467,60,3351
DOUGLAS,9/4/2020,1830,1475,60,3365
DOUGLAS,9/5/2020,1835,1483,60,3378
DOUGLAS,9/6/2020,1841,1490,60,3391
DOUGLAS,9/7/2020,1845,1496,60,3401
DOUGLAS,9/8/2020,1854,1508,60,3422
DOUGLAS,9/9/2020,1862,1512,60,3434
DOUGLAS,9/10/2020,1878,1521,60,3459
DOUGLAS,9/11/2020,1887,1524,60,3471
DOUGLAS,9/12/2020,1893,1527,60,3480
DOUGLAS,9/13/2020,1898,1529,60,3487
DOUGLAS,9/14/2020,1909,1537,60,3506
DOUGLAS,9/15/2020,1916,1544,60,3520
DOUGLAS,9/16/2020,1926,1558,60,3544
DOUGLAS,9/17/2020,1933,1560,60,3553
DOUGLAS,9/18/2020,1946,1566,60,3572
MCINTOSH,2/29/2020,0,1,0,1
MCINTOSH,3/1/2020,0,1,0,1
MCINTOSH,3/2/2020,0,1,0,1
BURKE,9/5/2020,388,323,5,716
MCINTOSH,3/3/2020,0,1,0,1
BURKE,9/6/2020,392,324,5,721
MCINTOSH,3/4/2020,0,1,0,1
BURKE,9/7/2020,395,326,5,726
MCINTOSH,3/5/2020,0,1,0,1
BURKE,9/8/2020,397,331,5,733
MCINTOSH,3/6/2020,0,1,0,1
MCINTOSH,3/7/2020,0,1,0,1
MCINTOSH,3/8/2020,0,1,0,1
MCINTOSH,3/9/2020,0,1,0,1
MCINTOSH,3/10/2020,0,1,0,1
MCINTOSH,3/11/2020,0,1,0,1
MCINTOSH,3/12/2020,0,1,0,1
MCINTOSH,3/13/2020,0,1,0,1
MCINTOSH,3/14/2020,0,1,0,1
MCINTOSH,3/15/2020,0,1,0,1
MCINTOSH,3/16/2020,0,1,0,1
MCINTOSH,3/17/2020,1,1,0,2
MCINTOSH,3/18/2020,1,1,0,2
MCINTOSH,3/19/2020,1,1,0,2
MCINTOSH,3/20/2020,1,1,0,2
MCINTOSH,3/21/2020,2,1,0,3
MCINTOSH,3/22/2020,2,1,0,3
MCINTOSH,3/23/2020,2,1,0,3
MCINTOSH,3/24/2020,2,1,0,3
MCINTOSH,3/25/2020,2,1,0,3
MCINTOSH,3/26/2020,2,1,0,3
MCINTOSH,3/27/2020,2,1,0,3
MCINTOSH,3/28/2020,2,1,0,3
MCINTOSH,3/29/2020,2,2,0,4
MCINTOSH,3/30/2020,2,2,0,4
MCINTOSH,3/31/2020,2,2,0,4
MCINTOSH,4/1/2020,2,2,0,4
MCINTOSH,4/2/2020,2,2,0,4
MCINTOSH,4/3/2020,3,2,0,5
MCINTOSH,4/4/2020,3,2,0,5
MCINTOSH,4/5/2020,3,2,0,5
MCINTOSH,4/6/2020,3,2,0,5
MCINTOSH,4/7/2020,3,2,0,5
MCINTOSH,4/8/2020,3,2,0,5
MCINTOSH,4/9/2020,3,2,0,5
MCINTOSH,4/10/2020,3,3,0,6
MCINTOSH,4/11/2020,3,3,0,6
MCINTOSH,4/12/2020,3,3,0,6
MCINTOSH,4/13/2020,3,3,0,6
MCINTOSH,4/14/2020,3,3,0,6
MCINTOSH,4/15/2020,3,3,0,6
MCINTOSH,4/16/2020,3,3,0,6
MCINTOSH,4/17/2020,3,3,0,6
MCINTOSH,4/18/2020,3,3,0,6
MCINTOSH,4/19/2020,3,3,0,6
MCINTOSH,4/20/2020,3,4,0,7
MCINTOSH,4/21/2020,3,4,0,7
MCINTOSH,4/22/2020,3,4,0,7
MCINTOSH,4/23/2020,3,4,0,7
MCINTOSH,4/24/2020,3,4,0,7
MCINTOSH,4/25/2020,3,4,0,7
MCINTOSH,4/26/2020,3,4,0,7
MCINTOSH,4/27/2020,3,4,0,7
MCINTOSH,4/28/2020,3,4,0,7
MCINTOSH,4/29/2020,3,4,0,7
MCINTOSH,4/30/2020,3,4,0,7
MCINTOSH,5/1/2020,4,4,0,8
MCINTOSH,5/2/2020,4,4,0,8
MCINTOSH,5/3/2020,4,4,0,8
MCINTOSH,5/4/2020,5,4,0,9
MCINTOSH,5/5/2020,7,6,0,13
MCINTOSH,5/6/2020,7,6,0,13
MCINTOSH,5/7/2020,7,6,0,13
MCINTOSH,5/8/2020,7,6,0,13
MCINTOSH,5/9/2020,7,6,0,13
MCINTOSH,5/10/2020,7,6,0,13
MCINTOSH,5/11/2020,7,6,0,13
MCINTOSH,5/12/2020,8,6,0,14
MCINTOSH,5/13/2020,9,6,0,15
MCINTOSH,5/14/2020,9,6,0,15
MCINTOSH,5/15/2020,9,6,0,15
MCINTOSH,5/16/2020,9,6,0,15
MCINTOSH,5/17/2020,9,6,0,15
MCINTOSH,5/18/2020,9,6,0,15
MCINTOSH,5/19/2020,9,6,0,15
MCINTOSH,5/20/2020,9,6,0,15
MCINTOSH,5/21/2020,9,6,0,15
MCINTOSH,5/22/2020,9,6,0,15
MCINTOSH,5/23/2020,9,6,0,15
MCINTOSH,5/24/2020,9,6,0,15
MCINTOSH,5/25/2020,9,6,0,15
MCINTOSH,5/26/2020,10,8,0,18
MCINTOSH,5/27/2020,10,8,0,18
MCINTOSH,5/28/2020,10,8,0,18
MCINTOSH,5/29/2020,10,8,0,18
MCINTOSH,5/30/2020,10,8,0,18
MCINTOSH,5/31/2020,10,8,0,18
MCINTOSH,6/1/2020,10,8,0,18
MCINTOSH,6/2/2020,11,8,0,19
MCINTOSH,6/3/2020,11,8,0,19
MCINTOSH,6/4/2020,11,8,0,19
MCINTOSH,6/5/2020,11,8,0,19
MCINTOSH,6/6/2020,12,8,0,20
MCINTOSH,6/7/2020,12,8,0,20
MCINTOSH,6/8/2020,13,8,0,21
MCINTOSH,6/9/2020,13,8,0,21
MCINTOSH,6/10/2020,13,9,0,22
MCINTOSH,6/11/2020,15,9,0,24
MCINTOSH,6/12/2020,15,9,0,24
MCINTOSH,6/13/2020,17,9,0,26
MCINTOSH,6/14/2020,17,9,0,26
MCINTOSH,6/15/2020,17,9,0,26
MCINTOSH,6/16/2020,17,11,0,28
MCINTOSH,6/17/2020,19,13,0,32
MCINTOSH,6/18/2020,21,13,0,34
MCINTOSH,6/19/2020,21,13,0,34
MCINTOSH,6/20/2020,21,13,0,34
MCINTOSH,6/21/2020,22,14,0,36
MCINTOSH,6/22/2020,22,14,0,36
MCINTOSH,6/23/2020,23,15,0,38
MCINTOSH,6/24/2020,25,16,0,41
MCINTOSH,6/25/2020,29,19,0,48
MCINTOSH,6/26/2020,31,20,1,52
MCINTOSH,6/27/2020,31,20,1,52
MCINTOSH,6/28/2020,31,21,1,53
MCINTOSH,6/29/2020,32,22,1,55
MCINTOSH,6/30/2020,35,31,1,67
MCINTOSH,7/1/2020,39,32,1,72
MCINTOSH,7/2/2020,41,34,1,76
MCINTOSH,7/3/2020,44,36,1,81
MCINTOSH,7/4/2020,44,36,1,81
MCINTOSH,7/5/2020,44,37,1,82
MCINTOSH,7/6/2020,45,40,1,86
MCINTOSH,7/7/2020,47,44,1,92
MCINTOSH,7/8/2020,49,46,1,96
MCINTOSH,7/9/2020,51,46,1,98
MCINTOSH,7/10/2020,52,47,1,100
MCINTOSH,7/11/2020,52,47,1,100
MCINTOSH,7/12/2020,54,48,1,103
MCINTOSH,7/13/2020,58,52,1,111
MCINTOSH,7/14/2020,59,55,1,115
MCINTOSH,7/15/2020,62,57,1,120
MCINTOSH,7/16/2020,65,57,1,123
MCINTOSH,7/17/2020,66,59,1,126
MCINTOSH,7/18/2020,67,60,1,128
MCINTOSH,7/19/2020,67,60,1,128
MCINTOSH,7/20/2020,69,62,1,132
MCINTOSH,7/21/2020,73,64,1,138
MCINTOSH,7/22/2020,78,65,1,144
MCINTOSH,7/23/2020,79,65,1,145
MCINTOSH,7/24/2020,82,67,1,150
MCINTOSH,7/25/2020,83,69,1,153
MCINTOSH,7/26/2020,83,70,1,154
MCINTOSH,7/27/2020,85,71,1,157
MCINTOSH,7/28/2020,86,72,1,159
MCINTOSH,7/29/2020,88,72,1,161
MCINTOSH,7/30/2020,90,72,1,163
MCINTOSH,7/31/2020,96,75,1,172
MCINTOSH,8/1/2020,96,78,1,175
MCINTOSH,8/2/2020,99,80,1,180
MCINTOSH,8/3/2020,100,81,1,182
MCINTOSH,8/4/2020,104,81,1,186
MCINTOSH,8/5/2020,106,84,1,191
MCINTOSH,8/6/2020,108,85,1,194
MCINTOSH,8/7/2020,112,87,1,200
MCINTOSH,8/8/2020,112,90,1,203
MCINTOSH,8/9/2020,115,92,1,208
MCINTOSH,8/10/2020,116,94,1,211
MCINTOSH,8/11/2020,120,95,1,216
MCINTOSH,8/12/2020,122,96,2,220
MCINTOSH,8/13/2020,124,97,2,223
MCINTOSH,8/14/2020,124,99,2,225
MCINTOSH,8/15/2020,126,99,2,227
MCINTOSH,8/16/2020,126,100,2,228
MCINTOSH,8/17/2020,127,103,2,232
MCINTOSH,8/18/2020,132,104,2,238
MCINTOSH,8/19/2020,133,106,2,241
MCINTOSH,8/20/2020,133,108,2,243
MCINTOSH,8/21/2020,134,108,2,244
MCINTOSH,8/22/2020,136,108,2,246
MCINTOSH,8/23/2020,137,108,2,247
MCINTOSH,8/24/2020,139,110,2,251
MCINTOSH,8/25/2020,141,111,2,254
MCINTOSH,8/26/2020,141,112,2,255
MCINTOSH,8/27/2020,142,115,2,259
MCINTOSH,8/28/2020,143,117,2,262
MCINTOSH,8/29/2020,145,117,2,264
MCINTOSH,8/30/2020,145,118,2,265
MCINTOSH,8/31/2020,145,118,2,265
MCINTOSH,9/1/2020,145,119,2,266
MCINTOSH,9/2/2020,146,119,2,267
MCINTOSH,9/3/2020,146,119,2,267
MCINTOSH,9/4/2020,146,119,2,267
MCINTOSH,9/5/2020,150,120,2,272
MCINTOSH,9/6/2020,151,120,2,273
MCINTOSH,9/7/2020,152,121,2,275
MCINTOSH,9/8/2020,153,122,2,277
MCINTOSH,9/9/2020,153,122,2,277
MCINTOSH,9/10/2020,154,123,2,279
MCINTOSH,9/11/2020,154,125,2,281
MCINTOSH,9/12/2020,154,125,2,281
MCINTOSH,9/13/2020,154,126,2,282
MCINTOSH,9/14/2020,156,126,2,284
MCINTOSH,9/15/2020,156,126,2,284
MCINTOSH,9/16/2020,156,126,2,284
MCINTOSH,9/17/2020,157,126,2,285
MCINTOSH,9/18/2020,159,127,2,288
MCINTOSH,9/19/2020,160,127,2,289
MCINTOSH,9/20/2020,160,128,2,290
MCINTOSH,9/21/2020,161,129,2,292
MCINTOSH,9/22/2020,162,129,2,293
MCINTOSH,9/23/2020,162,129,2,293
MCINTOSH,9/24/2020,162,130,2,294
MCINTOSH,9/25/2020,162,130,2,294
MCINTOSH,9/26/2020,162,130,2,294
MCINTOSH,9/27/2020,162,130,2,294
MCINTOSH,9/28/2020,162,131,2,295
MCINTOSH,9/29/2020,162,132,2,296
MCINTOSH,9/30/2020,162,132,2,296
MCINTOSH,10/1/2020,163,132,2,297
MCINTOSH,10/2/2020,164,132,2,298
MCINTOSH,10/3/2020,164,132,2,298
MCINTOSH,10/4/2020,164,132,2,298
MCINTOSH,10/5/2020,164,132,2,298
MCINTOSH,10/6/2020,165,133,2,300
MCINTOSH,10/7/2020,165,133,2,300
MCINTOSH,10/8/2020,165,134,2,301
MCINTOSH,10/9/2020,165,134,2,301
MCINTOSH,10/10/2020,165,134,2,301
MCINTOSH,10/11/2020,165,134,2,301
MCINTOSH,10/12/2020,165,135,2,302
MCINTOSH,10/13/2020,165,135,2,302
MCINTOSH,10/14/2020,165,135,2,302
MCINTOSH,10/15/2020,165,135,2,302
MCINTOSH,10/16/2020,165,135,2,302
MCINTOSH,10/17/2020,165,135,2,302
MCINTOSH,10/18/2020,165,135,2,302
MCINTOSH,10/19/2020,165,135,2,302
MCINTOSH,10/20/2020,165,135,2,302
MURRAY,1/1/2020,0,0,0,0
MURRAY,1/2/2020,0,0,0,0
MURRAY,1/3/2020,0,0,0,0
MURRAY,1/4/2020,0,0,0,0
MURRAY,1/5/2020,0,0,0,0
MURRAY,1/6/2020,0,0,0,0
MURRAY,1/7/2020,0,0,0,0
MURRAY,1/8/2020,0,0,0,0
MURRAY,1/9/2020,0,0,0,0
MURRAY,1/10/2020,0,0,0,0
MURRAY,1/11/2020,0,0,0,0
MURRAY,1/12/2020,0,0,0,0
MURRAY,1/13/2020,0,0,0,0
MURRAY,1/14/2020,0,0,0,0
MURRAY,1/15/2020,0,0,0,0
MURRAY,1/16/2020,0,0,0,0
MURRAY,1/17/2020,0,0,0,0
MURRAY,1/18/2020,0,0,0,0
MURRAY,1/19/2020,0,0,0,0
MURRAY,1/20/2020,0,0,0,0
MURRAY,1/21/2020,0,0,0,0
MURRAY,1/22/2020,0,0,0,0
MURRAY,1/23/2020,0,0,0,0
MURRAY,1/24/2020,0,0,0,0
MURRAY,1/25/2020,0,0,0,0
MURRAY,1/26/2020,0,0,0,0
MURRAY,1/27/2020,0,0,0,0
MURRAY,1/28/2020,0,0,0,0
MURRAY,1/29/2020,0,0,0,0
MURRAY,1/30/2020,0,0,0,0
MURRAY,1/31/2020,0,0,0,0
MURRAY,2/1/2020,0,0,0,0
MURRAY,2/2/2020,0,0,0,0
MURRAY,2/3/2020,0,0,0,0
MURRAY,2/4/2020,0,0,0,0
MURRAY,2/5/2020,0,0,0,0
MURRAY,2/6/2020,0,0,0,0
MURRAY,2/7/2020,0,0,0,0
MURRAY,2/8/2020,0,0,0,0
MURRAY,2/9/2020,0,0,0,0
MURRAY,2/10/2020,0,0,0,0
MURRAY,2/11/2020,0,0,0,0
MURRAY,2/12/2020,0,0,0,0
MURRAY,2/13/2020,0,0,0,0
MURRAY,2/14/2020,0,0,0,0
MURRAY,2/15/2020,0,0,0,0
MURRAY,2/16/2020,0,0,0,0
MURRAY,2/17/2020,0,1,0,1
MURRAY,2/18/2020,0,1,0,1
MURRAY,2/19/2020,0,1,0,1
MURRAY,2/20/2020,0,1,0,1
MURRAY,2/21/2020,0,1,0,1
MURRAY,2/22/2020,0,1,0,1
MURRAY,2/23/2020,0,1,0,1
MURRAY,2/24/2020,0,1,0,1
MURRAY,2/25/2020,0,1,0,1
MURRAY,2/26/2020,0,1,0,1
MURRAY,2/27/2020,0,1,0,1
MURRAY,2/28/2020,0,1,0,1
MURRAY,2/29/2020,0,1,0,1
MURRAY,3/1/2020,0,1,0,1
MURRAY,3/2/2020,0,1,0,1
MURRAY,3/3/2020,0,1,0,1
MURRAY,3/4/2020,0,1,0,1
MURRAY,3/5/2020,0,1,0,1
MURRAY,3/6/2020,0,1,0,1
MURRAY,3/7/2020,0,1,0,1
MURRAY,3/8/2020,0,1,0,1
MURRAY,3/9/2020,0,1,0,1
MURRAY,3/10/2020,0,1,0,1
MURRAY,3/11/2020,1,1,0,2
MURRAY,3/12/2020,1,2,0,3
MURRAY,3/13/2020,1,2,0,3
MURRAY,3/14/2020,1,2,0,3
MURRAY,3/15/2020,1,3,0,4
MURRAY,3/16/2020,1,3,0,4
MURRAY,3/17/2020,1,3,0,4
MURRAY,3/18/2020,1,4,0,5
MURRAY,3/19/2020,3,5,0,8
MURRAY,3/20/2020,4,6,0,10
MURRAY,3/21/2020,4,6,0,10
MURRAY,3/22/2020,4,6,0,10
MURRAY,3/23/2020,5,6,0,11
MURRAY,3/24/2020,5,6,0,11
MURRAY,3/25/2020,5,7,0,12
MURRAY,3/26/2020,6,7,0,13
MURRAY,3/27/2020,6,8,0,14
MURRAY,3/28/2020,6,8,0,14
MURRAY,3/29/2020,6,8,0,14
MURRAY,3/30/2020,6,8,0,14
MURRAY,3/31/2020,7,8,0,15
MURRAY,4/1/2020,8,8,0,16
MURRAY,4/2/2020,8,9,0,17
MURRAY,4/3/2020,9,9,0,18
MURRAY,4/4/2020,10,9,0,19
MURRAY,4/5/2020,10,9,0,19
MURRAY,4/6/2020,10,9,0,19
MURRAY,4/7/2020,10,9,0,19
MURRAY,4/8/2020,11,9,0,20
MURRAY,4/9/2020,11,9,0,20
MURRAY,4/10/2020,12,9,0,21
MURRAY,4/11/2020,13,10,0,23
MURRAY,4/12/2020,15,10,0,25
MURRAY,4/13/2020,17,12,0,29
MURRAY,4/14/2020,18,13,0,31
MURRAY,4/15/2020,18,13,0,31
MURRAY,4/16/2020,19,13,0,32
MURRAY,4/17/2020,19,13,0,32
MURRAY,4/18/2020,19,13,0,32
MURRAY,4/19/2020,20,13,0,33
MURRAY,4/20/2020,21,14,0,35
MURRAY,4/21/2020,22,14,0,36
MURRAY,4/22/2020,22,14,0,36
MURRAY,4/23/2020,22,15,0,37
MURRAY,4/24/2020,25,16,0,41
MURRAY,4/25/2020,26,17,0,43
MURRAY,4/26/2020,27,18,0,45
MURRAY,4/27/2020,27,19,0,46
MURRAY,4/28/2020,28,19,0,47
MURRAY,4/29/2020,28,20,0,48
MURRAY,4/30/2020,29,21,0,50
MURRAY,5/1/2020,30,23,0,53
MURRAY,5/2/2020,30,25,0,55
MURRAY,5/3/2020,31,25,0,56
MURRAY,5/4/2020,32,25,0,57
MURRAY,5/5/2020,32,26,0,58
MURRAY,5/6/2020,33,29,0,62
MURRAY,5/7/2020,35,30,0,65
MURRAY,5/8/2020,35,31,0,66
MURRAY,5/9/2020,36,31,0,67
MURRAY,5/10/2020,36,31,0,67
MURRAY,5/11/2020,37,32,0,69
MURRAY,5/12/2020,39,34,0,73
MURRAY,5/13/2020,41,36,0,77
MURRAY,5/14/2020,42,37,0,79
MURRAY,5/15/2020,43,37,0,80
MURRAY,5/16/2020,43,38,0,81
MURRAY,5/17/2020,46,38,0,84
MURRAY,5/18/2020,47,38,0,85
MURRAY,5/19/2020,48,40,0,88
MURRAY,5/20/2020,48,41,0,89
MURRAY,5/21/2020,48,44,0,92
MURRAY,5/22/2020,50,44,0,94
MURRAY,5/23/2020,50,45,0,95
MURRAY,5/24/2020,50,45,0,95
MURRAY,5/25/2020,51,46,0,97
MURRAY,5/26/2020,54,47,0,101
MURRAY,5/27/2020,55,48,0,103
MURRAY,5/28/2020,57,50,0,107
MURRAY,5/29/2020,58,50,0,108
MURRAY,5/30/2020,61,51,0,112
MURRAY,5/31/2020,61,53,0,114
MURRAY,6/1/2020,65,54,0,119
MURRAY,6/2/2020,65,56,0,121
MURRAY,6/3/2020,66,58,0,124
MURRAY,6/4/2020,68,59,0,127
BURKE,9/9/2020,403,331,5,739
BURKE,9/10/2020,409,334,5,748
BURKE,9/11/2020,412,335,5,752
BURKE,9/12/2020,412,335,5,752
BURKE,9/13/2020,414,341,5,760
BURKE,9/14/2020,418,343,5,766
BURKE,9/15/2020,419,349,5,773
BURKE,9/16/2020,422,351,5,778
BURKE,9/17/2020,425,352,5,782
BURKE,9/18/2020,427,354,5,786
BURKE,9/19/2020,428,355,5,788
BURKE,9/20/2020,431,356,5,792
BURKE,9/21/2020,434,358,5,797
BURKE,9/22/2020,436,359,6,801
BURKE,9/23/2020,440,362,6,808
BURKE,9/24/2020,444,365,6,815
BURKE,9/25/2020,444,368,6,818
BURKE,9/26/2020,444,370,6,820
BURKE,9/27/2020,446,370,6,822
BURKE,9/28/2020,449,373,6,828
BURKE,9/29/2020,452,378,6,836
BURKE,9/30/2020,457,382,6,845
BURKE,10/1/2020,458,385,6,849
BURKE,10/2/2020,460,385,6,851
BURKE,10/3/2020,462,385,6,853
BURKE,10/4/2020,462,387,6,855
BURKE,10/5/2020,463,388,6,857
BURKE,10/6/2020,464,388,6,858
BURKE,10/7/2020,465,388,6,859
BURKE,10/8/2020,467,389,6,862
BURKE,10/9/2020,467,389,6,862
BURKE,10/10/2020,467,390,6,863
BURKE,10/11/2020,467,390,6,863
BURKE,10/12/2020,468,390,6,864
BURKE,10/13/2020,470,391,6,867
BURKE,10/14/2020,470,392,6,868
BURKE,10/15/2020,470,392,6,868
BURKE,10/16/2020,471,392,6,869
BURKE,10/17/2020,473,392,6,871
BURKE,10/18/2020,473,392,6,871
BURKE,10/19/2020,473,392,6,871
BURKE,10/20/2020,473,392,6,871
BRYAN,1/1/2020,0,0,0,0
BRYAN,1/2/2020,0,0,0,0
BRYAN,1/3/2020,0,0,0,0
BRYAN,1/4/2020,0,0,0,0
BRYAN,1/5/2020,0,0,0,0
BRYAN,1/6/2020,0,0,0,0
BRYAN,1/7/2020,0,0,0,0
BRYAN,1/8/2020,0,0,0,0
BRYAN,1/9/2020,0,0,0,0
BRYAN,1/10/2020,0,0,0,0
BRYAN,1/11/2020,0,0,0,0
BRYAN,1/12/2020,0,0,0,0
BRYAN,1/13/2020,0,0,0,0
BRYAN,1/14/2020,0,0,0,0
BRYAN,1/15/2020,0,0,0,0
BRYAN,1/16/2020,0,0,0,0
BRYAN,1/17/2020,0,0,0,0
BRYAN,1/18/2020,0,0,0,0
BRYAN,1/19/2020,0,0,0,0
BRYAN,1/20/2020,0,0,0,0
BRYAN,1/21/2020,0,0,0,0
BRYAN,1/22/2020,0,0,0,0
BRYAN,1/23/2020,0,0,0,0
BRYAN,1/24/2020,0,0,0,0
BRYAN,1/25/2020,0,0,0,0
BRYAN,1/26/2020,0,0,0,0
BRYAN,1/27/2020,0,0,0,0
BRYAN,1/28/2020,0,0,0,0
BRYAN,1/29/2020,0,0,0,0
BRYAN,1/30/2020,0,0,0,0
BRYAN,1/31/2020,0,0,0,0
BRYAN,2/1/2020,0,0,0,0
BRYAN,2/2/2020,0,0,0,0
BRYAN,2/3/2020,0,0,0,0
BRYAN,2/4/2020,0,0,0,0
BRYAN,2/5/2020,0,0,0,0
BRYAN,2/6/2020,0,0,0,0
BRYAN,2/7/2020,0,0,0,0
BRYAN,2/8/2020,0,0,0,0
BRYAN,2/9/2020,0,0,0,0
BRYAN,2/10/2020,0,0,0,0
BRYAN,2/11/2020,0,0,0,0
BRYAN,2/12/2020,0,0,0,0
BRYAN,2/13/2020,0,0,0,0
BRYAN,2/14/2020,0,0,0,0
BRYAN,2/15/2020,0,0,0,0
BRYAN,2/16/2020,0,0,0,0
BRYAN,2/17/2020,0,0,0,0
BRYAN,2/18/2020,0,0,0,0
BRYAN,2/19/2020,0,0,0,0
BRYAN,2/20/2020,0,0,0,0
BRYAN,2/21/2020,0,0,0,0
BRYAN,2/22/2020,0,0,0,0
BRYAN,2/23/2020,0,0,0,0
BRYAN,2/24/2020,0,0,0,0
BRYAN,2/25/2020,0,0,0,0
BRYAN,2/26/2020,0,0,0,0
BRYAN,2/27/2020,0,0,0,0
BRYAN,2/28/2020,0,0,0,0
BRYAN,2/29/2020,0,0,0,0
BRYAN,3/1/2020,0,0,0,0
BRYAN,3/2/2020,0,1,0,1
BRYAN,3/3/2020,0,1,0,1
BRYAN,3/4/2020,0,1,0,1
BRYAN,3/5/2020,0,1,0,1
BRYAN,3/6/2020,0,1,0,1
BRYAN,3/7/2020,0,1,0,1
BRYAN,3/8/2020,0,1,0,1
BRYAN,3/9/2020,0,1,0,1
BRYAN,3/10/2020,0,1,0,1
BRYAN,3/11/2020,0,1,0,1
BRYAN,3/12/2020,0,1,0,1
BRYAN,3/13/2020,0,1,0,1
BRYAN,3/14/2020,0,1,0,1
BRYAN,3/15/2020,1,2,0,3
BRYAN,3/16/2020,1,2,0,3
BRYAN,3/17/2020,1,4,0,5
BRYAN,3/18/2020,1,4,0,5
BRYAN,3/19/2020,3,5,0,8
BRYAN,3/20/2020,5,7,0,12
BRYAN,3/21/2020,5,8,0,13
BRYAN,3/22/2020,5,9,0,14
BRYAN,3/23/2020,6,10,0,16
BRYAN,3/24/2020,6,10,0,16
BRYAN,3/25/2020,6,12,0,18
BRYAN,3/26/2020,6,12,0,18
BRYAN,3/27/2020,7,12,0,19
BRYAN,3/28/2020,8,12,0,20
BRYAN,3/29/2020,9,13,0,22
BRYAN,3/30/2020,10,14,0,24
BRYAN,3/31/2020,11,14,0,25
BRYAN,4/1/2020,11,15,0,26
BRYAN,4/2/2020,11,17,0,28
BRYAN,4/3/2020,13,17,0,30
BRYAN,4/4/2020,13,17,0,30
BRYAN,4/5/2020,13,18,0,31
BRYAN,4/6/2020,13,18,0,31
BRYAN,4/7/2020,13,19,0,32
BRYAN,4/8/2020,13,19,0,32
BRYAN,4/9/2020,13,19,0,32
BRYAN,4/10/2020,14,19,0,33
BRYAN,4/11/2020,15,19,0,34
BRYAN,4/12/2020,16,19,0,35
BRYAN,4/13/2020,16,20,0,36
BRYAN,4/14/2020,16,20,0,36
BRYAN,4/15/2020,16,20,0,36
BRYAN,4/16/2020,17,20,0,37
BRYAN,4/17/2020,17,20,0,37
BRYAN,4/18/2020,18,20,0,38
BRYAN,4/19/2020,19,20,0,39
BRYAN,4/20/2020,29,22,0,51
BRYAN,4/21/2020,29,22,0,51
BRYAN,4/22/2020,29,22,0,51
BRYAN,4/23/2020,29,23,0,52
BRYAN,4/24/2020,31,26,0,57
BRYAN,4/25/2020,31,26,0,57
BRYAN,4/26/2020,31,26,0,57
BRYAN,4/27/2020,31,26,0,57
BRYAN,4/28/2020,34,26,0,60
BRYAN,4/29/2020,34,26,0,60
BRYAN,4/30/2020,34,27,0,61
BRYAN,5/1/2020,34,27,0,61
BRYAN,5/2/2020,34,27,0,61
BRYAN,5/3/2020,34,27,0,61
BRYAN,5/4/2020,34,27,0,61
BRYAN,5/5/2020,35,27,0,62
BRYAN,5/6/2020,35,27,0,62
BRYAN,5/7/2020,35,27,0,62
BRYAN,5/8/2020,35,27,0,62
BRYAN,5/9/2020,35,27,0,62
BRYAN,5/10/2020,37,27,0,64
BRYAN,5/11/2020,39,28,0,67
BRYAN,5/12/2020,39,29,0,68
BRYAN,5/13/2020,39,29,0,68
BRYAN,5/14/2020,39,29,0,68
BRYAN,5/15/2020,39,29,0,68
BRYAN,5/16/2020,39,30,0,69
BRYAN,5/17/2020,39,30,0,69
BRYAN,5/18/2020,40,31,0,71
BRYAN,5/19/2020,40,31,0,71
BRYAN,5/20/2020,41,32,0,73
BRYAN,5/21/2020,41,32,0,73
BRYAN,5/22/2020,42,32,0,74
BRYAN,5/23/2020,43,32,0,75
BRYAN,5/24/2020,44,32,0,76
BRYAN,5/25/2020,44,33,0,77
BRYAN,5/26/2020,45,34,0,79
BRYAN,5/27/2020,45,34,0,79
BRYAN,5/28/2020,45,34,0,79
BRYAN,5/29/2020,45,34,0,79
BRYAN,5/30/2020,46,34,0,80
BRYAN,5/31/2020,46,34,0,80
BRYAN,6/1/2020,46,34,0,80
BRYAN,6/2/2020,48,35,0,83
BRYAN,6/3/2020,48,36,0,84
BRYAN,6/4/2020,49,36,0,85
BRYAN,6/5/2020,49,36,0,85
BRYAN,6/6/2020,49,36,0,85
BRYAN,6/7/2020,51,36,0,87
BRYAN,6/8/2020,53,37,0,90
BRYAN,6/9/2020,53,37,0,90
BRYAN,6/10/2020,55,41,0,96
BRYAN,6/11/2020,55,42,0,97
BRYAN,6/12/2020,57,42,0,99
BRYAN,6/13/2020,57,44,0,101
BRYAN,6/14/2020,57,44,0,101
BRYAN,6/15/2020,59,45,0,104
BRYAN,6/16/2020,61,46,0,107
BRYAN,6/17/2020,61,47,0,108
BRYAN,6/18/2020,65,52,0,117
BRYAN,6/19/2020,68,57,0,125
BRYAN,6/20/2020,69,60,0,129
BRYAN,6/21/2020,71,61,0,132
BRYAN,6/22/2020,74,62,0,136
BRYAN,6/23/2020,83,65,0,148
BRYAN,6/24/2020,87,67,0,154
BRYAN,6/25/2020,91,69,0,160
BRYAN,6/26/2020,97,75,0,172
BRYAN,6/27/2020,101,77,0,178
BRYAN,6/28/2020,105,81,2,188
BRYAN,6/29/2020,119,87,2,208
BRYAN,6/30/2020,129,93,3,225
BRYAN,7/1/2020,147,102,3,252
BRYAN,7/2/2020,159,113,4,276
BRYAN,7/3/2020,165,116,6,287
BRYAN,7/4/2020,171,120,6,297
BRYAN,7/5/2020,176,128,6,310
BRYAN,7/6/2020,188,137,6,331
BRYAN,7/7/2020,197,147,6,350
BRYAN,7/8/2020,208,152,6,366
BRYAN,7/9/2020,214,159,6,379
BRYAN,7/10/2020,225,169,6,400
BRYAN,7/11/2020,232,175,6,413
BRYAN,7/12/2020,236,179,6,421
BRYAN,7/13/2020,250,191,6,447
BRYAN,7/14/2020,261,197,6,464
BRYAN,7/15/2020,273,207,7,487
BRYAN,7/16/2020,281,214,7,502
BRYAN,7/17/2020,291,219,7,517
BRYAN,7/18/2020,296,225,7,528
BRYAN,7/19/2020,301,227,7,535
BRYAN,7/20/2020,310,239,8,557
BRYAN,7/21/2020,316,245,8,569
BRYAN,7/22/2020,325,254,9,588
BRYAN,7/23/2020,332,258,9,599
BRYAN,7/24/2020,342,263,9,614
BRYAN,7/25/2020,352,267,9,628
BRYAN,7/26/2020,357,269,9,635
BRYAN,7/27/2020,366,275,9,650
BRYAN,7/28/2020,375,284,9,668
BRYAN,7/29/2020,379,287,9,675
BRYAN,7/30/2020,383,290,9,682
BRYAN,7/31/2020,388,293,9,690
BRYAN,8/1/2020,391,296,9,696
BRYAN,8/2/2020,394,302,10,706
BRYAN,8/3/2020,403,307,10,720
BRYAN,8/4/2020,406,311,10,727
BRYAN,8/5/2020,407,317,10,734
BRYAN,8/6/2020,412,322,10,744
BRYAN,8/7/2020,420,326,10,756
BRYAN,8/8/2020,422,327,10,759
BRYAN,8/9/2020,427,328,10,765
BRYAN,8/10/2020,441,343,11,795
BRYAN,8/11/2020,450,349,14,813
BRYAN,8/12/2020,461,360,14,835
BRYAN,8/13/2020,469,364,14,847
BRYAN,8/14/2020,474,372,14,860
BRYAN,8/15/2020,481,374,14,869
BRYAN,8/16/2020,483,377,14,874
BRYAN,8/17/2020,487,383,14,884
BRYAN,8/18/2020,491,391,14,896
BRYAN,8/19/2020,495,394,14,903
BRYAN,8/20/2020,499,399,14,912
BRYAN,8/21/2020,503,403,14,920
BRYAN,8/22/2020,506,408,14,928
BRYAN,8/23/2020,510,412,14,936
BRYAN,8/24/2020,510,418,14,942
BRYAN,8/25/2020,513,425,15,953
BRYAN,8/26/2020,518,429,15,962
BRYAN,8/27/2020,523,432,15,970
BRYAN,8/28/2020,527,436,15,978
BRYAN,8/29/2020,531,439,15,985
BRYAN,8/30/2020,533,439,15,987
BRYAN,8/31/2020,536,444,16,996
BRYAN,9/1/2020,540,451,16,1007
BRYAN,9/2/2020,545,457,16,1018
BRYAN,9/3/2020,551,463,16,1030
BRYAN,9/4/2020,561,466,16,1043
BRYAN,9/5/2020,567,467,16,1050
BRYAN,9/6/2020,572,467,17,1056
BRYAN,9/7/2020,575,470,17,1062
BRYAN,9/8/2020,580,472,17,1069
BRYAN,9/9/2020,584,476,17,1077
BRYAN,9/10/2020,590,476,18,1084
BRYAN,9/11/2020,593,482,19,1094
BRYAN,9/12/2020,594,486,19,1099
BRYAN,9/13/2020,596,489,19,1104
BRYAN,9/14/2020,600,496,19,1115
BRYAN,9/15/2020,603,504,19,1126
BRYAN,9/16/2020,607,505,19,1131
BRYAN,9/17/2020,609,509,19,1137
BRYAN,9/18/2020,610,511,19,1140
BRYAN,9/19/2020,611,513,19,1143
BRYAN,9/20/2020,612,518,19,1149
BRYAN,9/21/2020,614,520,19,1153
BRYAN,9/22/2020,614,523,19,1156
BRYAN,9/23/2020,615,523,19,1157
BRYAN,9/24/2020,616,528,19,1163
BRYAN,9/25/2020,619,530,19,1168
BRYAN,9/26/2020,620,532,19,1171
BRYAN,9/27/2020,622,532,19,1173
BRYAN,9/28/2020,628,532,19,1179
BRYAN,9/29/2020,631,534,19,1184
BRYAN,9/30/2020,634,537,19,1190
BRYAN,10/1/2020,636,540,19,1195
BRYAN,10/2/2020,638,543,19,1200
BRYAN,10/3/2020,641,549,19,1209
BRYAN,10/4/2020,645,552,19,1216
BRYAN,10/5/2020,648,554,19,1221
BRYAN,10/6/2020,651,557,19,1227
BRYAN,10/7/2020,652,561,19,1232
BRYAN,10/8/2020,655,566,19,1240
BRYAN,10/9/2020,658,569,19,1246
BRYAN,10/10/2020,660,569,19,1248
BRYAN,10/11/2020,662,570,20,1252
BRYAN,10/12/2020,664,571,20,1255
BRYAN,10/13/2020,666,573,20,1259
BRYAN,10/14/2020,669,573,20,1262
BRYAN,10/15/2020,672,574,20,1266
BRYAN,10/16/2020,674,575,20,1269
BRYAN,10/17/2020,677,576,20,1273
BRYAN,10/18/2020,677,576,20,1273
BRYAN,10/19/2020,677,576,20,1273
BRYAN,10/20/2020,677,576,20,1273
MCINTOSH,1/1/2020,0,0,0,0
MCINTOSH,1/2/2020,0,0,0,0
MCINTOSH,1/3/2020,0,0,0,0
MCINTOSH,1/4/2020,0,0,0,0
MCINTOSH,1/5/2020,0,0,0,0
MCINTOSH,1/6/2020,0,0,0,0
MCINTOSH,1/7/2020,0,0,0,0
MCINTOSH,1/8/2020,0,0,0,0
MCINTOSH,1/9/2020,0,0,0,0
MCINTOSH,1/10/2020,0,0,0,0
MCINTOSH,1/11/2020,0,0,0,0
MCINTOSH,1/12/2020,0,0,0,0
MCINTOSH,1/13/2020,0,0,0,0
MCINTOSH,1/14/2020,0,0,0,0
MCINTOSH,1/15/2020,0,0,0,0
MCINTOSH,1/16/2020,0,0,0,0
MCINTOSH,1/17/2020,0,0,0,0
MCINTOSH,1/18/2020,0,0,0,0
MCINTOSH,1/19/2020,0,0,0,0
MCINTOSH,1/20/2020,0,0,0,0
MCINTOSH,1/21/2020,0,0,0,0
MCINTOSH,1/22/2020,0,0,0,0
MCINTOSH,1/23/2020,0,0,0,0
MCINTOSH,1/24/2020,0,0,0,0
MCINTOSH,1/25/2020,0,0,0,0
MCINTOSH,1/26/2020,0,0,0,0
MCINTOSH,1/27/2020,0,0,0,0
MCINTOSH,1/28/2020,0,0,0,0
MCINTOSH,1/29/2020,0,0,0,0
MCINTOSH,1/30/2020,0,0,0,0
MCINTOSH,1/31/2020,0,0,0,0
MCINTOSH,2/1/2020,0,0,0,0
MCINTOSH,2/2/2020,0,0,0,0
MCINTOSH,2/3/2020,0,0,0,0
MCINTOSH,2/4/2020,0,0,0,0
MCINTOSH,2/5/2020,0,0,0,0
MCINTOSH,2/6/2020,0,0,0,0
MCINTOSH,2/7/2020,0,0,0,0
MCINTOSH,2/8/2020,0,0,0,0
MCINTOSH,2/9/2020,0,0,0,0
MCINTOSH,2/10/2020,0,0,0,0
MCINTOSH,2/11/2020,0,0,0,0
MCINTOSH,2/12/2020,0,0,0,0
MCINTOSH,2/13/2020,0,0,0,0
MCINTOSH,2/14/2020,0,0,0,0
MCINTOSH,2/15/2020,0,0,0,0
MCINTOSH,2/16/2020,0,0,0,0
MCINTOSH,2/17/2020,0,0,0,0
MCINTOSH,2/18/2020,0,0,0,0
MCINTOSH,2/19/2020,0,0,0,0
TURNER,3/15/2020,1,1,0,2
CLAY,7/23/2020,50,28,0,78
TURNER,3/16/2020,1,1,0,2
CLAY,7/24/2020,51,29,0,80
TURNER,3/17/2020,1,2,0,3
CLAY,7/25/2020,52,30,0,82
TURNER,3/18/2020,1,2,0,3
CLAY,7/26/2020,52,30,0,82
TURNER,3/19/2020,1,2,0,3
PUTNAM,6/29/2020,108,86,2,196
BROOKS,10/13/2020,296,230,13,539
CLAY,7/27/2020,53,31,0,84
CLAY,7/28/2020,53,31,0,84
CLAY,7/29/2020,55,32,1,88
CLAY,7/30/2020,57,33,2,92
CLAY,7/31/2020,58,34,2,94
CLAY,8/1/2020,59,34,2,95
CLAY,8/2/2020,59,34,3,96
CLAY,8/3/2020,60,34,3,97
CLAY,8/4/2020,60,34,3,97
CLAY,8/5/2020,60,34,3,97
CLAY,8/6/2020,60,34,3,97
CLAY,8/7/2020,60,36,3,99
CLAY,8/8/2020,60,36,3,99
CLAY,8/9/2020,61,37,3,101
CLAY,8/10/2020,62,37,3,102
CLAY,8/11/2020,64,37,3,104
CLAY,8/12/2020,65,39,3,107
CLAY,8/13/2020,65,40,3,108
CLAY,8/14/2020,65,40,3,108
CLAY,8/15/2020,66,40,3,109
CLAY,8/16/2020,66,40,3,109
CLAY,8/17/2020,66,40,3,109
CLAY,8/18/2020,66,40,3,109
CLAY,8/19/2020,66,40,3,109
CLAY,8/20/2020,66,40,3,109
CLAY,8/21/2020,66,41,3,110
CLAY,8/22/2020,66,41,3,110
CLAY,8/23/2020,66,41,3,110
CLAY,8/24/2020,68,41,3,112
CLAY,8/25/2020,68,42,3,113
CLAY,8/26/2020,68,42,3,113
CLAY,8/27/2020,68,43,3,114
CLAY,8/28/2020,68,43,3,114
CLAY,8/29/2020,68,43,3,114
CLAY,8/30/2020,68,43,3,114
CLAY,8/31/2020,68,43,3,114
CLAY,9/1/2020,68,43,3,114
CLAY,9/2/2020,68,43,3,114
CLAY,9/3/2020,69,43,3,115
CLAY,9/4/2020,71,43,3,117
CLAY,9/5/2020,71,43,3,117
CLAY,9/6/2020,71,43,3,117
CLAY,9/7/2020,71,43,3,117
CLAY,9/8/2020,71,44,3,118
CLAY,9/9/2020,71,44,3,118
CLAY,9/10/2020,71,44,3,118
CLAY,9/11/2020,71,45,3,119
CLAY,9/12/2020,71,45,3,119
CLAY,9/13/2020,71,45,3,119
CLAY,9/14/2020,71,46,3,120
CLAY,9/15/2020,71,46,3,120
CLAY,9/16/2020,71,46,3,120
CLAY,9/17/2020,71,46,3,120
CLAY,9/18/2020,71,46,3,120
CLAY,9/19/2020,71,46,3,120
CLAY,9/20/2020,71,46,3,120
CLAY,9/21/2020,71,46,3,120
CLAY,9/22/2020,71,46,3,120
CLAY,9/23/2020,71,46,3,120
CLAY,9/24/2020,71,46,3,120
CLAY,9/25/2020,72,46,3,121
CLAY,9/26/2020,72,46,3,121
CLAY,9/27/2020,72,46,3,121
CLAY,9/28/2020,72,46,3,121
CLAY,9/29/2020,72,46,3,121
CLAY,9/30/2020,72,46,3,121
CLAY,10/1/2020,72,46,3,121
CLAY,10/2/2020,73,46,3,122
CLAY,10/3/2020,73,46,3,122
CLAY,10/4/2020,73,46,3,122
CLAY,10/5/2020,73,46,3,122
CLAY,10/6/2020,73,46,3,122
CLAY,10/7/2020,73,46,3,122
CLAY,10/8/2020,73,46,3,122
CLAY,10/9/2020,73,46,3,122
CLAY,10/10/2020,73,46,3,122
CLAY,10/11/2020,73,46,3,122
CLAY,10/12/2020,73,46,3,122
CLAY,10/13/2020,73,46,3,122
CLAY,10/14/2020,73,46,3,122
CLAY,10/15/2020,73,46,3,122
CLAY,10/16/2020,73,46,3,122
CLAY,10/17/2020,73,46,3,122
CLAY,10/18/2020,73,46,3,122
CLAY,10/19/2020,73,46,3,122
CLAY,10/20/2020,73,46,3,122
DAWSON,1/1/2020,0,0,0,0
DAWSON,1/2/2020,0,0,0,0
DAWSON,1/3/2020,0,0,0,0
DAWSON,1/4/2020,0,0,0,0
DAWSON,1/5/2020,0,0,0,0
DAWSON,1/6/2020,0,0,0,0
DAWSON,1/7/2020,0,0,0,0
DAWSON,1/8/2020,0,0,0,0
DAWSON,1/9/2020,0,0,0,0
DAWSON,1/10/2020,0,0,0,0
DAWSON,1/11/2020,0,0,0,0
DAWSON,1/12/2020,0,0,0,0
DAWSON,1/13/2020,0,0,0,0
DAWSON,1/14/2020,0,0,0,0
DAWSON,1/15/2020,0,0,0,0
DAWSON,1/16/2020,0,0,0,0
DAWSON,1/17/2020,0,0,0,0
DAWSON,1/18/2020,0,0,0,0
DAWSON,1/19/2020,0,0,0,0
DAWSON,1/20/2020,0,0,0,0
DAWSON,1/21/2020,0,0,0,0
DAWSON,1/22/2020,0,0,0,0
DAWSON,1/23/2020,0,0,0,0
DAWSON,1/24/2020,0,0,0,0
DAWSON,1/25/2020,0,0,0,0
DAWSON,1/26/2020,0,0,0,0
DAWSON,1/27/2020,0,0,0,0
DAWSON,1/28/2020,0,0,0,0
DAWSON,1/29/2020,0,0,0,0
DAWSON,1/30/2020,0,0,0,0
DAWSON,1/31/2020,0,0,0,0
DAWSON,2/1/2020,0,0,0,0
DAWSON,2/2/2020,0,0,0,0
DAWSON,2/3/2020,0,0,0,0
DAWSON,2/4/2020,0,0,0,0
DAWSON,2/5/2020,0,0,0,0
DAWSON,2/6/2020,0,0,0,0
DAWSON,2/7/2020,0,0,0,0
DAWSON,2/8/2020,0,0,0,0
DAWSON,2/9/2020,0,0,0,0
DAWSON,2/10/2020,0,0,0,0
DAWSON,2/11/2020,0,0,0,0
DAWSON,2/12/2020,0,0,0,0
DAWSON,2/13/2020,0,0,0,0
DAWSON,2/14/2020,0,0,0,0
DAWSON,2/15/2020,0,0,0,0
DAWSON,2/16/2020,0,0,0,0
DAWSON,2/17/2020,0,0,0,0
DAWSON,2/18/2020,0,0,0,0
DAWSON,2/19/2020,0,0,0,0
DAWSON,2/20/2020,0,0,0,0
DAWSON,2/21/2020,0,0,0,0
DAWSON,2/22/2020,0,0,0,0
DAWSON,2/23/2020,0,0,0,0
DAWSON,2/24/2020,0,0,0,0
DAWSON,2/25/2020,0,0,0,0
DAWSON,2/26/2020,0,0,0,0
DAWSON,2/27/2020,0,0,0,0
DAWSON,2/28/2020,0,0,0,0
DAWSON,2/29/2020,0,0,0,0
DAWSON,3/1/2020,0,0,0,0
DAWSON,3/2/2020,0,0,0,0
DAWSON,3/3/2020,1,0,0,1
DAWSON,3/4/2020,1,0,0,1
DAWSON,3/5/2020,1,0,0,1
DAWSON,3/6/2020,1,0,0,1
DAWSON,3/7/2020,1,0,0,1
DAWSON,3/8/2020,1,0,0,1
DAWSON,3/9/2020,1,0,0,1
DAWSON,3/10/2020,1,0,0,1
DAWSON,3/11/2020,1,0,0,1
DAWSON,3/12/2020,1,0,0,1
DAWSON,3/13/2020,1,0,0,1
DAWSON,3/14/2020,1,0,0,1
DAWSON,3/15/2020,1,0,0,1
DAWSON,3/16/2020,2,0,0,2
DAWSON,3/17/2020,2,1,0,3
DAWSON,3/18/2020,2,3,0,5
DAWSON,3/19/2020,2,3,0,5
DAWSON,3/20/2020,4,3,0,7
DAWSON,3/21/2020,5,3,0,8
DAWSON,3/22/2020,5,4,0,9
DAWSON,3/23/2020,7,7,0,14
DAWSON,3/24/2020,8,8,0,16
DAWSON,3/25/2020,8,8,0,16
DAWSON,3/26/2020,8,9,0,17
DAWSON,3/27/2020,8,9,0,17
DAWSON,3/28/2020,8,9,0,17
DAWSON,3/29/2020,8,9,0,17
DAWSON,3/30/2020,10,9,0,19
DAWSON,3/31/2020,11,10,0,21
DAWSON,4/1/2020,11,10,0,21
DAWSON,4/2/2020,11,10,0,21
DAWSON,4/3/2020,12,11,0,23
DAWSON,4/4/2020,12,12,0,24
DAWSON,4/5/2020,15,13,0,28
DAWSON,4/6/2020,18,15,0,33
DAWSON,4/7/2020,18,15,0,33
DAWSON,4/8/2020,21,15,0,36
DAWSON,4/9/2020,21,15,0,36
DAWSON,4/10/2020,24,16,0,40
DAWSON,4/11/2020,26,17,0,43
DAWSON,4/12/2020,26,17,0,43
DAWSON,4/13/2020,29,21,0,50
DAWSON,4/14/2020,30,22,0,52
DAWSON,4/15/2020,32,22,0,54
DAWSON,4/16/2020,34,22,0,56
DAWSON,4/17/2020,34,22,0,56
DAWSON,4/18/2020,35,22,0,57
DAWSON,4/19/2020,35,22,0,57
DAWSON,4/20/2020,35,22,0,57
DAWSON,4/21/2020,35,23,0,58
DAWSON,4/22/2020,36,23,0,59
DAWSON,4/23/2020,37,23,0,60
DAWSON,4/24/2020,38,24,0,62
DAWSON,4/25/2020,41,25,0,66
DAWSON,4/26/2020,41,25,0,66
DAWSON,4/27/2020,41,25,0,66
DAWSON,4/28/2020,41,27,0,68
DAWSON,4/29/2020,41,28,0,69
DAWSON,4/30/2020,41,28,0,69
DAWSON,5/1/2020,43,30,0,73
DAWSON,5/2/2020,43,31,0,74
DAWSON,5/3/2020,44,31,0,75
DAWSON,5/4/2020,44,32,0,76
DAWSON,5/5/2020,46,33,0,79
DAWSON,5/6/2020,48,33,0,81
DAWSON,5/7/2020,49,33,0,82
DAWSON,5/8/2020,50,34,0,84
DAWSON,5/9/2020,50,34,0,84
DAWSON,5/10/2020,51,35,0,86
DAWSON,5/11/2020,52,37,0,89
DAWSON,5/12/2020,53,37,0,90
DAWSON,5/13/2020,54,37,0,91
DAWSON,5/14/2020,54,37,0,91
DAWSON,5/15/2020,57,38,0,95
DAWSON,5/16/2020,58,38,0,96
DAWSON,5/17/2020,58,39,0,97
DAWSON,5/18/2020,59,42,0,101
DAWSON,5/19/2020,60,42,0,102
DAWSON,5/20/2020,62,44,0,106
DAWSON,5/21/2020,62,44,0,106
DAWSON,5/22/2020,63,45,0,108
DAWSON,5/23/2020,63,45,0,108
DAWSON,5/24/2020,63,45,0,108
DAWSON,5/25/2020,64,45,0,109
DAWSON,5/26/2020,64,45,0,109
DAWSON,5/27/2020,64,45,0,109
DAWSON,5/28/2020,65,45,0,110
DAWSON,5/29/2020,65,45,0,110
DAWSON,5/30/2020,65,46,0,111
DAWSON,5/31/2020,65,46,0,111
DAWSON,6/1/2020,65,47,0,112
DAWSON,6/2/2020,65,49,0,114
DAWSON,6/3/2020,65,50,0,115
DAWSON,6/4/2020,66,50,0,116
DAWSON,6/5/2020,66,50,0,116
DAWSON,6/6/2020,67,51,0,118
DAWSON,6/7/2020,67,51,0,118
DAWSON,6/8/2020,67,52,0,119
DAWSON,6/9/2020,67,52,0,119
DAWSON,6/10/2020,68,53,0,121
DAWSON,6/11/2020,68,54,0,122
DAWSON,6/12/2020,68,54,0,122
DAWSON,6/13/2020,69,54,0,123
DAWSON,6/14/2020,69,54,0,123
DAWSON,6/15/2020,72,54,0,126
DAWSON,6/16/2020,72,54,0,126
DAWSON,6/17/2020,73,54,0,127
DAWSON,6/18/2020,73,57,0,130
DAWSON,6/19/2020,75,58,0,133
DAWSON,6/20/2020,76,58,0,134
DAWSON,6/21/2020,76,58,0,134
DAWSON,6/22/2020,81,59,0,140
DAWSON,6/23/2020,85,59,0,144
DAWSON,6/24/2020,87,61,0,148
DAWSON,6/25/2020,88,62,1,151
DAWSON,6/26/2020,90,62,1,153
DAWSON,6/27/2020,90,64,1,155
DAWSON,6/28/2020,90,67,1,158
DAWSON,6/29/2020,93,68,1,162
DAWSON,6/30/2020,94,69,1,164
DAWSON,7/1/2020,97,70,1,168
DAWSON,7/2/2020,99,76,1,176
DAWSON,7/3/2020,101,81,1,183
DAWSON,7/4/2020,101,81,1,183
DAWSON,7/5/2020,101,84,1,186
DAWSON,7/6/2020,107,92,1,200
DAWSON,7/7/2020,111,98,1,210
DAWSON,7/8/2020,120,106,1,227
DAWSON,7/9/2020,124,118,2,244
DAWSON,7/10/2020,138,125,2,265
DAWSON,7/11/2020,146,129,3,278
DAWSON,7/12/2020,153,138,3,294
DAWSON,7/13/2020,166,144,4,314
DAWSON,7/14/2020,174,150,4,328
DAWSON,7/15/2020,181,157,5,343
DAWSON,7/16/2020,184,164,5,353
DAWSON,7/17/2020,187,175,5,367
DAWSON,7/18/2020,197,181,5,383
DAWSON,7/19/2020,206,187,5,398
DAWSON,7/20/2020,216,199,5,420
DAWSON,7/21/2020,232,210,5,447
DAWSON,7/22/2020,236,215,5,456
DAWSON,7/23/2020,245,226,6,477
DAWSON,7/24/2020,248,229,6,483
DAWSON,7/25/2020,252,230,6,488
DAWSON,7/26/2020,254,235,6,495
DAWSON,7/27/2020,259,241,6,506
DAWSON,7/28/2020,266,250,6,522
DAWSON,7/29/2020,271,258,7,536
DAWSON,7/30/2020,274,264,7,545
DAWSON,7/31/2020,279,268,7,554
DAWSON,8/1/2020,285,273,7,565
DAWSON,8/2/2020,289,279,7,575
DAWSON,8/3/2020,292,286,7,585
DAWSON,8/4/2020,299,290,7,596
DAWSON,8/5/2020,306,293,7,606
DAWSON,8/6/2020,310,297,8,615
DAWSON,8/7/2020,313,300,8,621
DAWSON,8/8/2020,316,304,8,628
DAWSON,8/9/2020,321,311,9,641
DAWSON,8/10/2020,327,314,9,650
DAWSON,8/11/2020,332,314,9,655
DAWSON,8/12/2020,337,320,9,666
DAWSON,8/13/2020,341,324,9,674
DAWSON,8/14/2020,349,329,9,687
DAWSON,8/15/2020,350,333,9,692
DAWSON,8/16/2020,351,337,9,697
DAWSON,8/17/2020,355,338,9,702
DAWSON,8/18/2020,358,339,9,706
DAWSON,8/19/2020,360,341,9,710
DAWSON,8/20/2020,362,344,9,715
DAWSON,8/21/2020,365,350,9,724
DAWSON,8/22/2020,367,352,9,728
DAWSON,8/23/2020,371,354,9,734
DAWSON,8/24/2020,373,356,9,738
DAWSON,8/25/2020,376,360,9,745
DAWSON,8/26/2020,380,362,9,751
DAWSON,8/27/2020,380,364,9,753
DAWSON,8/28/2020,381,367,10,758
DAWSON,8/29/2020,383,370,10,763
DAWSON,8/30/2020,386,371,10,767
DAWSON,8/31/2020,387,374,10,771
DAWSON,9/1/2020,391,376,10,777
DAWSON,9/2/2020,394,377,10,781
DAWSON,9/3/2020,396,378,10,784
DAWSON,9/4/2020,396,380,10,786
DAWSON,9/5/2020,399,380,10,789
DAWSON,9/6/2020,399,380,10,789
DAWSON,9/7/2020,402,383,10,795
DAWSON,9/8/2020,403,384,10,797
DAWSON,9/9/2020,403,384,10,797
DAWSON,9/10/2020,406,385,10,801
DAWSON,9/11/2020,408,389,10,807
DAWSON,9/12/2020,411,392,10,813
DAWSON,9/13/2020,412,394,10,816
DAWSON,9/14/2020,412,394,10,816
DAWSON,9/15/2020,412,397,10,819
DAWSON,9/16/2020,415,398,10,823
DAWSON,9/17/2020,415,398,10,823
DAWSON,9/18/2020,415,399,10,824
DAWSON,9/19/2020,415,402,10,827
DAWSON,9/20/2020,415,403,10,828
DAWSON,9/21/2020,417,404,10,831
DAWSON,9/22/2020,419,405,10,834
DAWSON,9/23/2020,422,405,10,837
DAWSON,9/24/2020,423,407,10,840
DAWSON,9/25/2020,424,409,10,843
DAWSON,9/26/2020,426,411,10,847
DAWSON,9/27/2020,426,412,10,848
DAWSON,9/28/2020,426,413,10,849
DAWSON,9/29/2020,426,415,10,851
DAWSON,9/30/2020,428,415,10,853
DAWSON,10/1/2020,429,415,10,854
DAWSON,10/2/2020,430,417,10,857
DAWSON,10/3/2020,430,419,10,859
DAWSON,10/4/2020,430,420,10,860
DAWSON,10/5/2020,431,421,10,862
DAWSON,10/6/2020,432,424,11,867
DAWSON,10/7/2020,434,424,11,869
DAWSON,10/8/2020,435,425,11,871
DAWSON,10/9/2020,437,427,11,875
DAWSON,10/10/2020,438,427,11,876
DAWSON,10/11/2020,438,428,11,877
DAWSON,10/12/2020,440,431,11,882
DAWSON,10/13/2020,443,431,11,885
DAWSON,10/14/2020,444,434,11,889
DAWSON,10/15/2020,445,437,11,893
DAWSON,10/16/2020,445,437,11,893
DAWSON,10/17/2020,445,437,11,893
DAWSON,10/18/2020,445,437,11,893
DAWSON,10/19/2020,445,437,11,893
DAWSON,10/20/2020,445,437,11,893
FANNIN,1/1/2020,0,0,0,0
FANNIN,1/2/2020,0,0,0,0
FANNIN,1/3/2020,0,0,0,0
FANNIN,1/4/2020,0,0,0,0
FANNIN,1/5/2020,0,0,0,0
FANNIN,1/6/2020,0,0,0,0
FANNIN,1/7/2020,0,0,0,0
FANNIN,1/8/2020,0,0,0,0
FANNIN,1/9/2020,0,0,0,0
FANNIN,1/10/2020,0,0,0,0
FANNIN,1/11/2020,0,0,0,0
FANNIN,1/12/2020,0,0,0,0
FANNIN,1/13/2020,0,0,0,0
FANNIN,1/14/2020,0,0,0,0
FANNIN,1/15/2020,0,0,0,0
FANNIN,1/16/2020,0,0,0,0
CHEROKEE,4/8/2020,149,123,0,272
TURNER,3/20/2020,1,2,0,3
TURNER,3/21/2020,1,2,0,3
TURNER,3/22/2020,1,2,0,3
PUTNAM,6/30/2020,110,88,2,200
BROOKS,10/14/2020,298,232,13,543
TURNER,3/23/2020,1,2,0,3
TURNER,3/24/2020,1,2,0,3
TURNER,3/25/2020,2,2,0,4
TURNER,3/26/2020,2,2,0,4
TURNER,3/27/2020,2,2,0,4
TURNER,3/28/2020,4,2,0,6
TURNER,3/29/2020,6,2,0,8
TURNER,3/30/2020,12,4,0,16
TURNER,3/31/2020,12,4,0,16
TURNER,4/1/2020,12,5,0,17
TURNER,4/2/2020,12,5,0,17
TURNER,4/3/2020,14,8,0,22
TURNER,4/4/2020,16,9,0,25
TURNER,4/5/2020,16,9,0,25
TURNER,4/6/2020,19,12,0,31
TURNER,4/7/2020,21,12,0,33
TURNER,4/8/2020,24,14,0,38
TURNER,4/9/2020,27,20,0,47
TURNER,4/10/2020,28,20,0,48
CHEROKEE,4/9/2020,154,126,0,280
TURNER,4/11/2020,28,21,0,49
TURNER,4/12/2020,28,21,0,49
TURNER,4/13/2020,30,21,0,51
TURNER,4/14/2020,31,21,0,52
TURNER,4/15/2020,36,24,0,60
TURNER,4/16/2020,36,24,0,60
TURNER,4/17/2020,36,24,0,60
TURNER,4/18/2020,36,24,0,60
TURNER,4/19/2020,37,25,0,62
TURNER,4/20/2020,38,27,0,65
TURNER,4/21/2020,39,27,0,66
TURNER,4/22/2020,41,27,0,68
TURNER,4/23/2020,41,27,0,68
TURNER,4/24/2020,41,28,0,69
TURNER,4/25/2020,42,29,0,71
TURNER,4/26/2020,42,29,0,71
TURNER,4/27/2020,42,29,0,71
TURNER,4/28/2020,42,29,0,71
TURNER,4/29/2020,42,30,0,72
TURNER,4/30/2020,42,30,0,72
TURNER,5/1/2020,43,30,0,73
TURNER,5/2/2020,43,30,0,73
TURNER,5/3/2020,43,31,0,74
TURNER,5/4/2020,43,31,0,74
TURNER,5/5/2020,43,31,0,74
TURNER,5/6/2020,46,33,0,79
TURNER,5/7/2020,48,33,0,81
TURNER,5/8/2020,48,34,0,82
TURNER,5/9/2020,49,34,0,83
TURNER,5/10/2020,49,34,0,83
TURNER,5/11/2020,51,35,0,86
TURNER,5/12/2020,52,35,0,87
TURNER,5/13/2020,54,35,0,89
TURNER,5/14/2020,56,36,0,92
TURNER,5/15/2020,60,36,0,96
TURNER,5/16/2020,61,36,0,97
TURNER,5/17/2020,61,36,0,97
TURNER,5/18/2020,62,40,0,102
TURNER,5/19/2020,64,40,0,104
TURNER,5/20/2020,64,44,0,108
TURNER,5/21/2020,67,44,0,111
TURNER,5/22/2020,69,44,0,113
TURNER,5/23/2020,69,45,0,114
TURNER,5/24/2020,69,45,0,114
TURNER,5/25/2020,69,47,0,116
TURNER,5/26/2020,72,50,0,122
TURNER,5/27/2020,73,50,0,123
TURNER,5/28/2020,75,51,0,126
TURNER,5/29/2020,76,53,0,129
TURNER,5/30/2020,78,55,0,133
TURNER,5/31/2020,78,55,0,133
TURNER,6/1/2020,83,56,0,139
TURNER,6/2/2020,84,56,0,140
TURNER,6/3/2020,85,57,0,142
TURNER,6/4/2020,86,59,0,145
TURNER,6/5/2020,86,60,0,146
TURNER,6/6/2020,86,60,0,146
TURNER,6/7/2020,87,60,0,147
TURNER,6/8/2020,89,61,0,150
TURNER,6/9/2020,93,62,0,155
TURNER,6/10/2020,93,62,0,155
TURNER,6/11/2020,94,62,0,156
TURNER,6/12/2020,94,62,0,156
TURNER,6/13/2020,95,62,0,157
TURNER,6/14/2020,97,62,2,161
TURNER,6/15/2020,99,64,2,165
TURNER,6/16/2020,100,64,2,166
TURNER,6/17/2020,103,65,2,170
TURNER,6/18/2020,104,65,2,171
TURNER,6/19/2020,106,65,2,173
TURNER,6/20/2020,107,65,2,174
TURNER,6/21/2020,108,66,2,176
TURNER,6/22/2020,108,66,2,176
TURNER,6/23/2020,109,68,2,179
TURNER,6/24/2020,111,68,2,181
TURNER,6/25/2020,112,68,2,182
TURNER,6/26/2020,113,68,2,183
TURNER,6/27/2020,114,68,2,184
TURNER,6/28/2020,114,68,2,184
TURNER,6/29/2020,114,68,2,184
TURNER,6/30/2020,114,68,2,184
TURNER,7/1/2020,115,68,2,185
TURNER,7/2/2020,116,68,2,186
TURNER,7/3/2020,116,68,2,186
TURNER,7/4/2020,118,68,2,188
TURNER,7/5/2020,119,69,2,190
TURNER,7/6/2020,120,70,2,192
TURNER,7/7/2020,120,70,2,192
TURNER,7/8/2020,120,71,2,193
TURNER,7/9/2020,120,71,2,193
TURNER,7/10/2020,120,71,2,193
TURNER,7/11/2020,120,72,2,194
TURNER,7/12/2020,120,72,2,194
TURNER,7/13/2020,121,74,2,197
TURNER,7/14/2020,123,74,2,199
TURNER,7/15/2020,125,76,2,203
TURNER,7/16/2020,125,76,2,203
TURNER,7/17/2020,125,76,2,203
TURNER,7/18/2020,125,76,2,203
TURNER,7/19/2020,125,76,2,203
TURNER,7/20/2020,127,77,2,206
TURNER,7/21/2020,127,80,5,212
TURNER,7/22/2020,129,80,6,215
TURNER,7/23/2020,129,81,6,216
TURNER,7/24/2020,130,81,6,217
TURNER,7/25/2020,130,81,6,217
TURNER,7/26/2020,132,81,6,219
TURNER,7/27/2020,134,81,6,221
TURNER,7/28/2020,137,85,8,230
TURNER,7/29/2020,138,87,8,233
TURNER,7/30/2020,140,89,8,237
TURNER,7/31/2020,145,89,8,242
TURNER,8/1/2020,146,89,8,243
TURNER,8/2/2020,147,89,8,244
TURNER,8/3/2020,148,89,8,245
TURNER,8/4/2020,149,89,9,247
TURNER,8/5/2020,151,91,10,252
TURNER,8/6/2020,151,92,10,253
TURNER,8/7/2020,151,92,10,253
TURNER,8/8/2020,152,92,10,254
TURNER,8/9/2020,153,92,10,255
TURNER,8/10/2020,156,93,10,259
TURNER,8/11/2020,157,94,10,261
TURNER,8/12/2020,160,96,10,266
TURNER,8/13/2020,161,96,10,267
TURNER,8/14/2020,163,96,10,269
TURNER,8/15/2020,163,96,10,269
TURNER,8/16/2020,164,97,10,271
TURNER,8/17/2020,164,98,10,272
TURNER,8/18/2020,164,99,10,273
TURNER,8/19/2020,166,100,10,276
TURNER,8/20/2020,167,100,10,277
TURNER,8/21/2020,168,100,10,278
TURNER,8/22/2020,168,100,10,278
TURNER,8/23/2020,169,100,10,279
TURNER,8/24/2020,169,100,10,279
TURNER,8/25/2020,169,100,10,279
TURNER,8/26/2020,169,100,10,279
TURNER,8/27/2020,169,100,10,279
TURNER,8/28/2020,170,100,10,280
TURNER,8/29/2020,170,100,10,280
TURNER,8/30/2020,170,100,10,280
TURNER,8/31/2020,172,101,10,283
TURNER,9/1/2020,172,102,10,284
TURNER,9/2/2020,172,102,10,284
TURNER,9/3/2020,173,103,10,286
TURNER,9/4/2020,173,103,10,286
TURNER,9/5/2020,175,103,10,288
TURNER,9/6/2020,175,103,10,288
TURNER,9/7/2020,176,103,10,289
TURNER,9/8/2020,176,104,10,290
TURNER,9/9/2020,176,104,10,290
TURNER,9/10/2020,176,104,11,291
TURNER,9/11/2020,176,104,11,291
TURNER,9/12/2020,176,104,11,291
TURNER,9/13/2020,178,104,11,293
TURNER,9/14/2020,179,104,11,294
TURNER,9/15/2020,179,104,11,294
TURNER,9/16/2020,179,104,11,294
TURNER,9/17/2020,180,104,11,295
TURNER,9/18/2020,180,104,11,295
TURNER,9/19/2020,183,104,11,298
TURNER,9/20/2020,183,104,11,298
TURNER,9/21/2020,183,104,11,298
TURNER,9/22/2020,184,107,11,302
TURNER,9/23/2020,185,108,11,304
TURNER,9/24/2020,188,110,11,309
TURNER,9/25/2020,188,110,11,309
TURNER,9/26/2020,189,111,11,311
TURNER,9/27/2020,189,112,11,312
TURNER,9/28/2020,190,113,11,314
TURNER,9/29/2020,190,113,11,314
TURNER,9/30/2020,193,114,11,318
TURNER,10/1/2020,194,114,11,319
TURNER,10/2/2020,195,115,11,321
TURNER,10/3/2020,196,115,11,322
TURNER,10/4/2020,197,116,11,324
TURNER,10/5/2020,198,116,11,325
TURNER,10/6/2020,200,116,11,327
TURNER,10/7/2020,200,116,11,327
TURNER,10/8/2020,200,117,11,328
TURNER,10/9/2020,200,117,11,328
TURNER,10/10/2020,200,117,11,328
TURNER,10/11/2020,200,117,11,328
TURNER,10/12/2020,200,118,11,329
TURNER,10/13/2020,201,118,11,330
TURNER,10/14/2020,201,118,11,330
TURNER,10/15/2020,201,118,11,330
TURNER,10/16/2020,201,119,11,331
TURNER,10/17/2020,201,119,11,331
TURNER,10/18/2020,201,119,11,331
TURNER,10/19/2020,201,119,11,331
TURNER,10/20/2020,201,119,11,331
PUTNAM,1/1/2020,0,0,0,0
PUTNAM,1/2/2020,0,0,0,0
PUTNAM,1/3/2020,0,0,0,0
PUTNAM,1/4/2020,0,0,0,0
PUTNAM,1/5/2020,0,0,0,0
PUTNAM,1/6/2020,0,0,0,0
PUTNAM,1/7/2020,0,0,0,0
PUTNAM,1/8/2020,0,0,0,0
PUTNAM,1/9/2020,0,0,0,0
PUTNAM,1/10/2020,0,0,0,0
PUTNAM,1/11/2020,0,0,0,0
PUTNAM,1/12/2020,0,0,0,0
PUTNAM,1/13/2020,0,0,0,0
PUTNAM,1/14/2020,0,0,0,0
PUTNAM,1/15/2020,0,0,0,0
PUTNAM,1/16/2020,0,0,0,0
PUTNAM,1/17/2020,0,0,0,0
PUTNAM,1/18/2020,0,0,0,0
PUTNAM,1/19/2020,0,0,0,0
PUTNAM,1/20/2020,0,0,0,0
PUTNAM,1/21/2020,0,0,0,0
PUTNAM,1/22/2020,0,0,0,0
PUTNAM,1/23/2020,0,0,0,0
PUTNAM,1/24/2020,0,0,0,0
PUTNAM,1/25/2020,0,0,0,0
PUTNAM,1/26/2020,0,0,0,0
PUTNAM,1/27/2020,0,0,0,0
PUTNAM,1/28/2020,0,0,0,0
PUTNAM,1/29/2020,0,0,0,0
PUTNAM,1/30/2020,0,0,0,0
PUTNAM,1/31/2020,0,0,0,0
PUTNAM,2/1/2020,0,0,0,0
PUTNAM,2/2/2020,0,0,0,0
PUTNAM,2/3/2020,0,0,0,0
PUTNAM,2/4/2020,0,0,0,0
PUTNAM,2/5/2020,0,0,0,0
PUTNAM,2/6/2020,0,0,0,0
PUTNAM,2/7/2020,0,0,0,0
PUTNAM,2/8/2020,0,0,0,0
PUTNAM,2/9/2020,0,0,0,0
PUTNAM,2/10/2020,0,0,0,0
PUTNAM,2/11/2020,0,0,0,0
PUTNAM,2/12/2020,0,0,0,0
PUTNAM,2/13/2020,0,0,0,0
PUTNAM,2/14/2020,0,0,0,0
PUTNAM,2/15/2020,0,0,0,0
PUTNAM,2/16/2020,0,0,0,0
PUTNAM,2/17/2020,0,0,0,0
PUTNAM,2/18/2020,0,0,0,0
PUTNAM,2/19/2020,0,0,0,0
PUTNAM,2/20/2020,0,0,0,0
PUTNAM,2/21/2020,0,0,0,0
PUTNAM,2/22/2020,0,0,0,0
PUTNAM,2/23/2020,0,0,0,0
PUTNAM,2/24/2020,0,0,0,0
PUTNAM,2/25/2020,0,0,0,0
PUTNAM,2/26/2020,0,0,0,0
PUTNAM,2/27/2020,0,0,0,0
PUTNAM,2/28/2020,0,0,0,0
PUTNAM,2/29/2020,0,0,0,0
PUTNAM,3/1/2020,0,0,0,0
PUTNAM,3/2/2020,0,0,0,0
PUTNAM,3/3/2020,0,0,0,0
PUTNAM,3/4/2020,0,0,0,0
PUTNAM,3/5/2020,0,0,0,0
PUTNAM,3/6/2020,0,0,0,0
PUTNAM,3/7/2020,0,0,0,0
PUTNAM,3/8/2020,0,0,0,0
PUTNAM,3/9/2020,0,0,0,0
PUTNAM,3/10/2020,0,0,0,0
PUTNAM,3/11/2020,0,0,0,0
PUTNAM,3/12/2020,2,0,0,2
PUTNAM,3/13/2020,2,0,0,2
PUTNAM,3/14/2020,2,0,0,2
PUTNAM,3/15/2020,2,0,0,2
PUTNAM,3/16/2020,2,0,0,2
PUTNAM,3/17/2020,2,0,0,2
PUTNAM,3/18/2020,2,0,0,2
PUTNAM,3/19/2020,2,0,0,2
PUTNAM,3/20/2020,2,0,0,2
PUTNAM,3/21/2020,2,0,0,2
PUTNAM,3/22/2020,2,0,0,2
PUTNAM,3/23/2020,2,1,0,3
PUTNAM,3/24/2020,2,1,0,3
PUTNAM,3/25/2020,2,1,0,3
PUTNAM,3/26/2020,2,1,0,3
PUTNAM,3/27/2020,2,1,0,3
PUTNAM,3/28/2020,3,1,0,4
PUTNAM,3/29/2020,3,1,0,4
PUTNAM,3/30/2020,3,1,0,4
PUTNAM,3/31/2020,3,1,0,4
PUTNAM,4/1/2020,5,1,0,6
PUTNAM,4/2/2020,5,2,0,7
PUTNAM,4/3/2020,5,3,1,9
PUTNAM,4/4/2020,5,3,1,9
PUTNAM,4/5/2020,5,3,1,9
PUTNAM,4/6/2020,6,3,1,10
PUTNAM,4/7/2020,6,3,1,10
PUTNAM,4/8/2020,6,3,1,10
PUTNAM,4/9/2020,6,6,1,13
PUTNAM,4/10/2020,6,7,1,14
PUTNAM,4/11/2020,7,10,1,18
PUTNAM,4/12/2020,7,10,1,18
PUTNAM,4/13/2020,8,11,1,20
PUTNAM,4/14/2020,8,13,1,22
PUTNAM,4/15/2020,8,14,1,23
PUTNAM,4/16/2020,9,14,1,24
PUTNAM,4/17/2020,10,15,1,26
PUTNAM,4/18/2020,12,15,2,29
PUTNAM,4/19/2020,14,16,2,32
PUTNAM,4/20/2020,14,17,2,33
PUTNAM,4/21/2020,15,17,2,34
PUTNAM,4/22/2020,16,19,2,37
PUTNAM,4/23/2020,17,19,2,38
PUTNAM,4/24/2020,19,20,2,41
PUTNAM,4/25/2020,19,20,2,41
PUTNAM,4/26/2020,21,20,2,43
PUTNAM,4/27/2020,23,21,2,46
PUTNAM,4/28/2020,25,21,2,48
PUTNAM,4/29/2020,27,23,2,52
PUTNAM,4/30/2020,29,23,2,54
PUTNAM,5/1/2020,29,23,2,54
PUTNAM,5/2/2020,30,23,2,55
PUTNAM,5/3/2020,30,24,2,56
PUTNAM,5/4/2020,31,25,2,58
PUTNAM,5/5/2020,31,26,2,59
PUTNAM,5/6/2020,32,26,2,60
PUTNAM,5/7/2020,33,27,2,62
PUTNAM,5/8/2020,34,27,2,63
PUTNAM,5/9/2020,34,27,2,63
PUTNAM,5/10/2020,34,27,2,63
PUTNAM,5/11/2020,35,27,2,64
PUTNAM,5/12/2020,37,28,2,67
PUTNAM,5/13/2020,37,28,2,67
PUTNAM,5/14/2020,44,35,2,81
PUTNAM,5/15/2020,44,36,2,82
PUTNAM,5/16/2020,44,39,2,85
PUTNAM,5/17/2020,44,39,2,85
PUTNAM,5/18/2020,45,39,2,86
PUTNAM,5/19/2020,46,39,2,87
PUTNAM,5/20/2020,47,41,2,90
PUTNAM,5/21/2020,48,41,2,91
PUTNAM,5/22/2020,49,41,2,92
PUTNAM,5/23/2020,49,41,2,92
PUTNAM,5/24/2020,49,41,2,92
PUTNAM,5/25/2020,49,41,2,92
PUTNAM,5/26/2020,49,41,2,92
PUTNAM,5/27/2020,49,41,2,92
PUTNAM,5/28/2020,50,41,2,93
PUTNAM,5/29/2020,53,43,2,98
PUTNAM,5/30/2020,53,43,2,98
PUTNAM,5/31/2020,54,43,2,99
PUTNAM,6/1/2020,56,43,2,101
PUTNAM,6/2/2020,57,45,2,104
PUTNAM,6/3/2020,58,45,2,105
PUTNAM,6/4/2020,59,46,2,107
PUTNAM,6/5/2020,59,46,2,107
PUTNAM,6/6/2020,59,46,2,107
PUTNAM,6/7/2020,59,46,2,107
PUTNAM,6/8/2020,60,47,2,109
PUTNAM,6/9/2020,60,47,2,109
PUTNAM,6/10/2020,60,49,2,111
PUTNAM,6/11/2020,60,50,2,112
PUTNAM,6/12/2020,60,51,2,113
PUTNAM,6/13/2020,60,51,2,113
PUTNAM,6/14/2020,61,51,2,114
PUTNAM,6/15/2020,62,52,2,116
PUTNAM,6/16/2020,65,53,2,120
PUTNAM,6/17/2020,69,54,2,125
PUTNAM,6/18/2020,70,56,2,128
PUTNAM,6/19/2020,74,59,2,135
PUTNAM,6/20/2020,74,62,2,138
PUTNAM,6/21/2020,77,65,2,144
PUTNAM,6/22/2020,82,67,2,151
PUTNAM,6/23/2020,89,72,2,163
PUTNAM,6/24/2020,92,73,2,167
PUTNAM,6/25/2020,97,80,2,179
PUTNAM,6/26/2020,100,82,2,184
PUTNAM,6/27/2020,103,83,2,188
PUTNAM,6/28/2020,104,85,2,191
PUTNAM,7/1/2020,113,92,2,207
BROOKS,10/15/2020,298,233,13,544
CHEROKEE,4/10/2020,158,133,0,291
CHEROKEE,4/11/2020,162,138,0,300
CHEROKEE,4/12/2020,171,141,0,312
CHEROKEE,4/13/2020,192,154,0,346
CHEROKEE,4/14/2020,202,160,0,362
CHEROKEE,4/15/2020,212,168,0,380
CHEROKEE,4/16/2020,220,185,0,405
CHEROKEE,4/17/2020,227,193,0,420
CHEROKEE,4/18/2020,230,201,0,431
CHEROKEE,4/19/2020,233,202,0,435
CHEROKEE,4/20/2020,249,211,0,460
CHEROKEE,4/21/2020,257,218,1,476
CHEROKEE,4/22/2020,265,226,1,492
CHEROKEE,4/23/2020,269,237,1,507
CHEROKEE,4/24/2020,279,248,1,528
CHEROKEE,4/25/2020,283,263,1,547
CHEROKEE,4/26/2020,288,269,1,558
CHEROKEE,4/27/2020,310,281,1,592
CHEROKEE,4/28/2020,316,287,1,604
CHEROKEE,4/29/2020,321,296,1,618
CHEROKEE,4/30/2020,326,299,1,626
CHEROKEE,5/1/2020,334,305,1,640
CHEROKEE,5/2/2020,338,309,1,648
CHEROKEE,5/3/2020,343,316,1,660
CHEROKEE,5/4/2020,356,326,1,683
CHEROKEE,5/5/2020,363,332,1,696
BROOKS,10/16/2020,298,233,13,544
PUTNAM,7/2/2020,117,94,3,214
CHEROKEE,5/6/2020,369,336,1,706
CHEROKEE,5/7/2020,373,345,1,719
CHEROKEE,5/8/2020,381,353,1,735
CHEROKEE,5/9/2020,398,356,1,755
CHEROKEE,5/10/2020,409,363,1,773
CHEROKEE,5/11/2020,416,375,1,792
CHEROKEE,5/12/2020,425,381,1,807
CHEROKEE,5/13/2020,433,384,1,818
CHEROKEE,5/14/2020,438,394,1,833
CHEROKEE,5/15/2020,450,403,1,854
CHEROKEE,5/16/2020,456,408,2,866
CHEROKEE,5/17/2020,461,416,2,879
CHEROKEE,5/18/2020,468,428,2,898
CHEROKEE,5/19/2020,473,434,2,909
CHEROKEE,5/20/2020,486,439,2,927
CHEROKEE,5/21/2020,489,444,2,935
CHEROKEE,5/22/2020,492,445,2,939
CHEROKEE,5/23/2020,495,452,2,949
CHEROKEE,5/24/2020,496,455,2,953
CHEROKEE,5/25/2020,505,460,2,967
CHEROKEE,5/26/2020,510,461,2,973
CHEROKEE,5/27/2020,514,462,2,978
CHEROKEE,5/28/2020,522,466,2,990
CHEROKEE,5/29/2020,525,468,3,996
CHEROKEE,5/30/2020,529,472,3,1004
CHEROKEE,5/31/2020,533,478,3,1014
CHEROKEE,6/1/2020,542,482,3,1027
CHEROKEE,6/2/2020,547,486,3,1036
CHEROKEE,6/3/2020,552,492,3,1047
CHEROKEE,6/4/2020,561,498,3,1062
CHEROKEE,6/5/2020,567,504,3,1074
CHEROKEE,6/6/2020,574,508,3,1085
CHEROKEE,6/7/2020,581,512,3,1096
CHEROKEE,6/8/2020,589,518,3,1110
CHEROKEE,6/9/2020,596,524,3,1123
CHEROKEE,6/10/2020,597,529,3,1129
CHEROKEE,6/11/2020,598,538,3,1139
CHEROKEE,6/12/2020,605,541,4,1150
CHEROKEE,6/13/2020,609,544,4,1157
CHEROKEE,6/14/2020,617,547,4,1168
CHEROKEE,6/15/2020,621,557,5,1183
CHEROKEE,6/16/2020,628,568,5,1201
CHEROKEE,6/17/2020,643,576,5,1224
CHEROKEE,6/18/2020,651,587,5,1243
CHEROKEE,6/19/2020,662,601,5,1268
CHEROKEE,6/20/2020,668,615,5,1288
CHEROKEE,6/21/2020,676,621,5,1302
CHEROKEE,6/22/2020,702,641,5,1348
CHEROKEE,6/23/2020,725,656,5,1386
CHEROKEE,6/24/2020,748,674,7,1429
CHEROKEE,6/25/2020,768,694,8,1470
CHEROKEE,6/26/2020,791,717,10,1518
CHEROKEE,6/27/2020,814,728,11,1553
CHEROKEE,6/28/2020,833,741,11,1585
CHEROKEE,6/29/2020,858,765,12,1635
CHEROKEE,6/30/2020,882,791,13,1686
CHEROKEE,7/1/2020,914,830,14,1758
CHEROKEE,7/2/2020,948,855,15,1818
CHEROKEE,7/3/2020,975,873,18,1866
CHEROKEE,7/4/2020,1001,897,18,1916
CHEROKEE,7/5/2020,1027,920,20,1967
CHEROKEE,7/6/2020,1070,954,25,2049
CHEROKEE,7/7/2020,1110,988,27,2125
CHEROKEE,7/8/2020,1149,1015,29,2193
CHEROKEE,7/9/2020,1195,1054,31,2280
CHEROKEE,7/10/2020,1231,1086,33,2350
CHEROKEE,7/11/2020,1259,1105,34,2398
CHEROKEE,7/12/2020,1275,1123,35,2433
CHEROKEE,7/13/2020,1316,1158,37,2511
CHEROKEE,7/14/2020,1354,1197,41,2592
CHEROKEE,7/15/2020,1394,1237,46,2677
CHEROKEE,7/16/2020,1422,1272,52,2746
CHEROKEE,7/17/2020,1456,1304,57,2817
CHEROKEE,7/18/2020,1471,1330,57,2858
CHEROKEE,7/19/2020,1491,1349,63,2903
CHEROKEE,7/20/2020,1529,1384,66,2979
CHEROKEE,7/21/2020,1560,1412,67,3039
CHEROKEE,7/22/2020,1586,1431,68,3085
CHEROKEE,7/23/2020,1621,1451,69,3141
CHEROKEE,7/24/2020,1639,1473,69,3181
CHEROKEE,7/25/2020,1651,1491,69,3211
CHEROKEE,7/26/2020,1677,1511,69,3257
CHEROKEE,7/27/2020,1710,1549,70,3329
CHEROKEE,7/28/2020,1735,1581,70,3386
CHEROKEE,7/29/2020,1765,1608,70,3443
CHEROKEE,7/30/2020,1800,1642,70,3512
CHEROKEE,7/31/2020,1843,1673,70,3586
CHEROKEE,8/1/2020,1861,1695,70,3626
CHEROKEE,8/2/2020,1886,1716,70,3672
CHEROKEE,8/3/2020,1923,1762,71,3756
CHEROKEE,8/4/2020,1958,1796,71,3825
CHEROKEE,8/5/2020,2011,1837,73,3921
CHEROKEE,8/6/2020,2051,1868,73,3992
CHEROKEE,8/7/2020,2103,1897,73,4073
CHEROKEE,8/8/2020,2127,1925,73,4125
CHEROKEE,8/9/2020,2152,1943,74,4169
CHEROKEE,8/10/2020,2191,1979,74,4244
CHEROKEE,8/11/2020,2234,2025,77,4336
CHEROKEE,8/12/2020,2264,2054,77,4395
CHEROKEE,8/13/2020,2295,2082,78,4455
CHEROKEE,8/14/2020,2330,2108,78,4516
CHEROKEE,8/15/2020,2355,2123,79,4557
CHEROKEE,8/16/2020,2378,2136,80,4594
CHEROKEE,8/17/2020,2422,2163,80,4665
CHEROKEE,8/18/2020,2451,2191,80,4722
CHEROKEE,8/19/2020,2480,2218,80,4778
CHEROKEE,8/20/2020,2506,2243,81,4830
CHEROKEE,8/21/2020,2534,2275,82,4891
CHEROKEE,8/22/2020,2558,2290,82,4930
CHEROKEE,8/23/2020,2581,2310,82,4973
CHEROKEE,8/24/2020,2624,2352,82,5058
CHEROKEE,8/25/2020,2653,2373,83,5109
CHEROKEE,8/26/2020,2681,2395,83,5159
CHEROKEE,8/27/2020,2710,2419,84,5213
CHEROKEE,8/28/2020,2732,2441,84,5257
CHEROKEE,8/29/2020,2750,2461,84,5295
CHEROKEE,8/30/2020,2773,2477,84,5334
CHEROKEE,8/31/2020,2797,2505,84,5386
CHEROKEE,9/1/2020,2825,2525,84,5434
CHEROKEE,9/2/2020,2852,2544,84,5480
CHEROKEE,9/3/2020,2872,2562,84,5518
CHEROKEE,9/4/2020,2897,2586,84,5567
CHEROKEE,9/5/2020,2913,2594,84,5591
CHEROKEE,9/6/2020,2930,2602,85,5617
CHEROKEE,9/7/2020,2949,2616,85,5650
CHEROKEE,9/8/2020,2984,2637,85,5706
CHEROKEE,9/9/2020,3007,2661,85,5753
CHEROKEE,9/10/2020,3029,2687,86,5802
CHEROKEE,9/11/2020,3044,2708,86,5838
CHEROKEE,9/12/2020,3062,2718,86,5866
CHEROKEE,9/13/2020,3070,2728,86,5884
CHEROKEE,9/14/2020,3086,2741,86,5913
CHEROKEE,9/15/2020,3101,2754,86,5941
CHEROKEE,9/16/2020,3117,2773,86,5976
CHEROKEE,9/17/2020,3128,2782,87,5997
CHEROKEE,9/18/2020,3139,2795,87,6021
CHEROKEE,9/19/2020,3148,2806,87,6041
CHEROKEE,9/20/2020,3162,2813,87,6062
CHEROKEE,9/21/2020,3183,2829,88,6100
CHEROKEE,9/22/2020,3207,2844,89,6140
CHEROKEE,9/23/2020,3221,2862,90,6173
CHEROKEE,9/24/2020,3230,2875,90,6195
CHEROKEE,9/25/2020,3241,2882,90,6213
CHEROKEE,9/26/2020,3257,2897,90,6244
CHEROKEE,9/27/2020,3266,2900,90,6256
CHEROKEE,9/28/2020,3286,2917,90,6293
CHEROKEE,9/29/2020,3301,2934,90,6325
CHEROKEE,9/30/2020,3321,2946,90,6357
CHEROKEE,10/1/2020,3337,2954,90,6381
CHEROKEE,10/2/2020,3348,2967,90,6405
CHEROKEE,10/3/2020,3358,2975,90,6423
CHEROKEE,10/4/2020,3369,2984,90,6443
CHEROKEE,10/5/2020,3390,3006,90,6486
CHEROKEE,10/6/2020,3408,3021,90,6519
CHEROKEE,10/7/2020,3424,3044,90,6558
CHEROKEE,10/8/2020,3438,3057,90,6585
CHEROKEE,10/9/2020,3451,3079,90,6620
CHEROKEE,10/10/2020,3461,3092,91,6644
CHEROKEE,10/11/2020,3466,3104,91,6661
CHEROKEE,10/12/2020,3477,3116,91,6684
CHEROKEE,10/13/2020,3491,3131,91,6713
CHEROKEE,10/14/2020,3505,3137,92,6734
CHEROKEE,10/15/2020,3519,3145,92,6756
CHEROKEE,10/16/2020,3526,3151,92,6769
CHEROKEE,10/17/2020,3528,3153,92,6773
CHEROKEE,10/18/2020,3532,3153,92,6777
CHEROKEE,10/19/2020,3533,3153,92,6778
CHEROKEE,10/20/2020,3533,3153,92,6778
CLAY,1/1/2020,0,0,0,0
CLAY,1/2/2020,0,0,0,0
CLAY,1/3/2020,0,0,0,0
CLAY,1/4/2020,0,0,0,0
CLAY,1/5/2020,0,0,0,0
CLAY,1/6/2020,0,0,0,0
CLAY,1/7/2020,0,0,0,0
CLAY,1/8/2020,0,0,0,0
CLAY,1/9/2020,0,0,0,0
CLAY,1/10/2020,0,0,0,0
CLAY,1/11/2020,0,0,0,0
CLAY,1/12/2020,0,0,0,0
CLAY,1/13/2020,0,0,0,0
CLAY,1/14/2020,0,0,0,0
CLAY,1/15/2020,0,0,0,0
CLAY,1/16/2020,0,0,0,0
CLAY,1/17/2020,0,0,0,0
CLAY,1/18/2020,0,0,0,0
CLAY,1/19/2020,0,0,0,0
CLAY,1/20/2020,0,0,0,0
CLAY,1/21/2020,0,0,0,0
CLAY,1/22/2020,0,0,0,0
CLAY,1/23/2020,0,0,0,0
CLAY,1/24/2020,0,0,0,0
CLAY,1/25/2020,0,0,0,0
CLAY,1/26/2020,0,0,0,0
CLAY,1/27/2020,0,0,0,0
CLAY,1/28/2020,0,0,0,0
CLAY,1/29/2020,0,0,0,0
CLAY,1/30/2020,0,0,0,0
CLAY,1/31/2020,0,0,0,0
CLAY,2/1/2020,0,0,0,0
CLAY,2/2/2020,0,0,0,0
CLAY,2/3/2020,0,0,0,0
CLAY,2/4/2020,0,0,0,0
CLAY,2/5/2020,0,0,0,0
CLAY,2/6/2020,0,0,0,0
CLAY,2/7/2020,0,0,0,0
CLAY,2/8/2020,0,0,0,0
CLAY,2/9/2020,0,0,0,0
CLAY,2/10/2020,0,0,0,0
CLAY,2/11/2020,0,0,0,0
CLAY,2/12/2020,0,0,0,0
CLAY,2/13/2020,0,0,0,0
CLAY,2/14/2020,0,0,0,0
CLAY,2/15/2020,0,0,0,0
CLAY,2/16/2020,0,0,0,0
CLAY,2/17/2020,0,0,0,0
CLAY,2/18/2020,0,0,0,0
CLAY,2/19/2020,0,0,0,0
CLAY,2/20/2020,0,0,0,0
CLAY,2/21/2020,0,0,0,0
CLAY,2/22/2020,0,0,0,0
CLAY,2/23/2020,0,0,0,0
CLAY,2/24/2020,0,0,0,0
CLAY,2/25/2020,0,0,0,0
CLAY,2/26/2020,0,0,0,0
CLAY,2/27/2020,0,0,0,0
CLAY,2/28/2020,0,0,0,0
CLAY,2/29/2020,0,0,0,0
CLAY,3/1/2020,0,0,0,0
CLAY,3/2/2020,0,0,0,0
CLAY,3/3/2020,0,0,0,0
CLAY,3/4/2020,0,0,0,0
CLAY,3/5/2020,0,0,0,0
CLAY,3/6/2020,0,0,0,0
CLAY,3/7/2020,0,0,0,0
CLAY,3/8/2020,0,0,0,0
CLAY,3/9/2020,0,0,0,0
CLAY,3/10/2020,0,0,0,0
CLAY,3/11/2020,1,0,0,1
CLAY,3/12/2020,1,0,0,1
CLAY,3/13/2020,1,0,0,1
CLAY,3/14/2020,1,0,0,1
CLAY,3/15/2020,1,0,0,1
CLAY,3/16/2020,1,0,0,1
CLAY,3/17/2020,1,0,0,1
CLAY,3/18/2020,1,0,0,1
CLAY,3/19/2020,2,0,0,2
CLAY,3/20/2020,3,0,0,3
CLAY,3/21/2020,3,0,0,3
CLAY,3/22/2020,3,0,0,3
CLAY,3/23/2020,6,0,0,6
CLAY,3/24/2020,6,0,0,6
CLAY,3/25/2020,8,0,0,8
CLAY,3/26/2020,8,0,0,8
CLAY,3/27/2020,8,1,0,9
CLAY,3/28/2020,8,1,0,9
CLAY,3/29/2020,9,3,0,12
CLAY,3/30/2020,10,4,0,14
CLAY,3/31/2020,10,5,0,15
CLAY,4/1/2020,10,6,0,16
CLAY,4/2/2020,11,6,0,17
CLAY,4/3/2020,12,6,0,18
CLAY,4/4/2020,12,6,0,18
CLAY,4/5/2020,12,6,0,18
CLAY,4/6/2020,13,6,0,19
CLAY,4/7/2020,13,6,0,19
CLAY,4/8/2020,13,6,0,19
CLAY,4/9/2020,13,6,0,19
CLAY,4/10/2020,14,7,0,21
CLAY,4/11/2020,15,7,0,22
CLAY,4/12/2020,15,8,0,23
CLAY,4/13/2020,15,8,0,23
CLAY,4/14/2020,15,8,0,23
CLAY,4/15/2020,15,8,0,23
CLAY,4/16/2020,15,8,0,23
CLAY,4/17/2020,15,8,0,23
CLAY,4/18/2020,15,8,0,23
CLAY,4/19/2020,15,8,0,23
CLAY,4/20/2020,16,8,0,24
CLAY,4/21/2020,16,8,0,24
CLAY,4/22/2020,16,8,0,24
CLAY,4/23/2020,16,8,0,24
CLAY,4/24/2020,16,8,0,24
CLAY,4/25/2020,16,8,0,24
CLAY,4/26/2020,16,8,0,24
CLAY,4/27/2020,16,9,0,25
CLAY,4/28/2020,16,9,0,25
CLAY,4/29/2020,16,9,0,25
CLAY,4/30/2020,16,9,0,25
CLAY,5/1/2020,17,9,0,26
CLAY,5/2/2020,17,9,0,26
CLAY,5/3/2020,17,9,0,26
CLAY,5/4/2020,17,9,0,26
CLAY,5/5/2020,18,10,0,28
CLAY,5/6/2020,18,10,0,28
CLAY,5/7/2020,19,10,0,29
CLAY,5/8/2020,19,10,0,29
CLAY,5/9/2020,19,10,0,29
CLAY,5/10/2020,21,11,0,32
CLAY,5/11/2020,21,11,0,32
CLAY,5/12/2020,21,11,0,32
CLAY,5/13/2020,21,11,0,32
CLAY,5/14/2020,21,12,0,33
CLAY,5/15/2020,23,13,0,36
CLAY,5/16/2020,23,13,0,36
CLAY,5/17/2020,24,13,0,37
CLAY,5/18/2020,24,13,0,37
CLAY,5/19/2020,24,13,0,37
CLAY,5/20/2020,25,14,0,39
CLAY,5/21/2020,25,14,0,39
CLAY,5/22/2020,25,15,0,40
CLAY,5/23/2020,25,15,0,40
CLAY,5/24/2020,25,17,0,42
CLAY,5/25/2020,25,17,0,42
CLAY,5/26/2020,25,18,0,43
CLAY,5/27/2020,25,18,0,43
CLAY,5/28/2020,25,18,0,43
CLAY,5/29/2020,26,18,0,44
CLAY,5/30/2020,28,18,0,46
CLAY,5/31/2020,29,18,0,47
CLAY,6/1/2020,29,18,0,47
CLAY,6/2/2020,30,19,0,49
CLAY,6/3/2020,33,19,0,52
CLAY,6/4/2020,33,19,0,52
CLAY,6/5/2020,33,19,0,52
CLAY,6/6/2020,33,19,0,52
CLAY,6/7/2020,33,19,0,52
CLAY,6/8/2020,33,21,0,54
CLAY,6/9/2020,33,21,0,54
CLAY,6/10/2020,34,21,0,55
CLAY,6/11/2020,35,22,0,57
CLAY,6/12/2020,35,22,0,57
CLAY,6/13/2020,35,22,0,57
CLAY,6/14/2020,35,22,0,57
CLAY,6/15/2020,35,22,0,57
CLAY,6/16/2020,35,22,0,57
CLAY,6/17/2020,35,22,0,57
CLAY,6/18/2020,35,22,0,57
CLAY,6/19/2020,35,22,0,57
CLAY,6/20/2020,35,22,0,57
CLAY,6/21/2020,36,22,0,58
CLAY,6/22/2020,37,22,0,59
CLAY,6/23/2020,37,22,0,59
CLAY,6/24/2020,37,22,0,59
CLAY,6/25/2020,37,22,0,59
CLAY,6/26/2020,37,22,0,59
CLAY,6/27/2020,37,22,0,59
CLAY,6/28/2020,37,22,0,59
CLAY,6/29/2020,37,23,0,60
CLAY,6/30/2020,37,23,0,60
CLAY,7/1/2020,38,23,0,61
CLAY,7/2/2020,38,23,0,61
CLAY,7/3/2020,38,23,0,61
CLAY,7/4/2020,39,23,0,62
CLAY,7/5/2020,39,23,0,62
CLAY,7/6/2020,41,24,0,65
CLAY,7/7/2020,41,24,0,65
CLAY,7/8/2020,42,24,0,66
CLAY,7/9/2020,42,24,0,66
CLAY,7/10/2020,42,24,0,66
CLAY,7/11/2020,42,24,0,66
CLAY,7/12/2020,43,24,0,67
CLAY,7/13/2020,43,25,0,68
CLAY,7/14/2020,43,27,0,70
CLAY,7/15/2020,43,27,0,70
CLAY,7/16/2020,45,27,0,72
CLAY,7/17/2020,45,27,0,72
CLAY,7/18/2020,45,27,0,72
CLAY,7/19/2020,46,27,0,73
CLAY,7/20/2020,46,28,0,74
CLAY,7/21/2020,49,28,0,77
CLAY,7/22/2020,50,28,0,78
PUTNAM,7/3/2020,120,98,3,221
PUTNAM,7/4/2020,124,99,3,226
BROOKS,10/17/2020,299,234,13,546
PUTNAM,7/5/2020,124,101,3,228
PUTNAM,7/6/2020,131,107,3,241
BROOKS,10/18/2020,299,234,13,546
PUTNAM,7/7/2020,137,112,3,252
BROOKS,10/19/2020,299,234,13,546
PUTNAM,7/8/2020,137,119,3,259
BROOKS,10/20/2020,299,234,13,546
CALHOUN,1/1/2020,0,0,0,0
CALHOUN,1/2/2020,0,0,0,0
CALHOUN,1/3/2020,0,0,0,0
CALHOUN,1/4/2020,0,0,0,0
CALHOUN,1/5/2020,0,0,0,0
CALHOUN,1/6/2020,0,0,0,0
CALHOUN,1/7/2020,0,0,0,0
CALHOUN,1/8/2020,0,0,0,0
CALHOUN,1/9/2020,0,0,0,0
CALHOUN,1/10/2020,0,0,0,0
CALHOUN,1/11/2020,0,0,0,0
CALHOUN,1/12/2020,0,0,0,0
CALHOUN,1/13/2020,0,0,0,0
CALHOUN,1/14/2020,0,0,0,0
CALHOUN,1/15/2020,0,0,0,0
CALHOUN,1/16/2020,0,0,0,0
CALHOUN,1/17/2020,0,0,0,0
CALHOUN,1/18/2020,0,0,0,0
CALHOUN,1/19/2020,0,0,0,0
CALHOUN,1/20/2020,0,0,0,0
CALHOUN,1/21/2020,0,0,0,0
CALHOUN,1/22/2020,0,0,0,0
CALHOUN,1/23/2020,0,0,0,0
CALHOUN,1/24/2020,0,0,0,0
CALHOUN,1/25/2020,0,0,0,0
CALHOUN,1/26/2020,0,0,0,0
CALHOUN,1/27/2020,0,0,0,0
CALHOUN,1/28/2020,0,0,0,0
CALHOUN,1/29/2020,0,0,0,0
CALHOUN,1/30/2020,0,0,0,0
CALHOUN,1/31/2020,0,0,0,0
CALHOUN,2/1/2020,0,0,0,0
CALHOUN,2/2/2020,0,0,0,0
CALHOUN,2/3/2020,0,0,0,0
CALHOUN,2/4/2020,0,0,0,0
CALHOUN,2/5/2020,0,0,0,0
CALHOUN,2/6/2020,0,1,0,1
CALHOUN,2/7/2020,0,1,0,1
CALHOUN,2/8/2020,0,1,0,1
CALHOUN,2/9/2020,0,1,0,1
CALHOUN,2/10/2020,0,1,0,1
CALHOUN,2/11/2020,0,1,0,1
CALHOUN,2/12/2020,0,1,0,1
CALHOUN,2/13/2020,0,1,0,1
CALHOUN,2/14/2020,0,1,0,1
CALHOUN,2/15/2020,0,1,0,1
CALHOUN,2/16/2020,0,1,0,1
CALHOUN,2/17/2020,0,1,0,1
CALHOUN,2/18/2020,0,1,0,1
CALHOUN,2/19/2020,0,1,0,1
CALHOUN,2/20/2020,0,1,0,1
CALHOUN,2/21/2020,0,1,0,1
CALHOUN,2/22/2020,0,1,0,1
CALHOUN,2/23/2020,0,1,0,1
CALHOUN,2/24/2020,0,1,0,1
CALHOUN,2/25/2020,0,1,0,1
CALHOUN,2/26/2020,0,2,0,2
CALHOUN,2/27/2020,0,2,0,2
CALHOUN,2/28/2020,0,2,0,2
CALHOUN,2/29/2020,0,2,0,2
CALHOUN,3/1/2020,0,2,0,2
CALHOUN,3/2/2020,0,2,0,2
CALHOUN,3/3/2020,0,2,0,2
CALHOUN,3/4/2020,0,2,0,2
CALHOUN,3/5/2020,0,2,0,2
CALHOUN,3/6/2020,0,2,0,2
CALHOUN,3/7/2020,0,2,0,2
CALHOUN,3/8/2020,0,2,0,2
CALHOUN,3/9/2020,0,2,0,2
CALHOUN,3/10/2020,1,2,0,3
CALHOUN,3/11/2020,1,2,0,3
CALHOUN,3/12/2020,1,2,0,3
CALHOUN,3/13/2020,1,2,0,3
CALHOUN,3/14/2020,1,2,0,3
CALHOUN,3/15/2020,1,2,0,3
CALHOUN,3/16/2020,1,2,0,3
CALHOUN,3/17/2020,2,2,0,4
CALHOUN,3/18/2020,5,2,0,7
CALHOUN,3/19/2020,6,2,0,8
CALHOUN,3/20/2020,6,3,0,9
CALHOUN,3/21/2020,7,4,0,11
CALHOUN,3/22/2020,7,4,0,11
CALHOUN,3/23/2020,9,4,0,13
CALHOUN,3/24/2020,9,4,0,13
CALHOUN,3/25/2020,10,5,0,15
CALHOUN,3/26/2020,11,6,0,17
CALHOUN,3/27/2020,12,6,0,18
CALHOUN,3/28/2020,13,9,0,22
CALHOUN,3/29/2020,14,9,0,23
CALHOUN,3/30/2020,17,9,0,26
CALHOUN,3/31/2020,19,11,0,30
CALHOUN,4/1/2020,22,12,0,34
CALHOUN,4/2/2020,25,13,0,38
CALHOUN,4/3/2020,27,15,0,42
CALHOUN,4/4/2020,27,15,0,42
CALHOUN,4/5/2020,29,16,0,45
CALHOUN,4/6/2020,31,17,0,48
CALHOUN,4/7/2020,39,19,0,58
CALHOUN,4/8/2020,41,20,0,61
CALHOUN,4/9/2020,41,21,0,62
CALHOUN,4/10/2020,42,21,0,63
CALHOUN,4/11/2020,42,21,0,63
CALHOUN,4/12/2020,42,21,0,63
CALHOUN,4/13/2020,43,21,0,64
CALHOUN,4/14/2020,45,23,0,68
CALHOUN,4/15/2020,47,23,0,70
CALHOUN,4/16/2020,49,26,0,75
CALHOUN,4/17/2020,49,27,0,76
CALHOUN,4/18/2020,49,29,0,78
CALHOUN,4/19/2020,49,29,0,78
CALHOUN,4/20/2020,50,30,0,80
CALHOUN,4/21/2020,51,33,0,84
CALHOUN,4/22/2020,53,33,0,86
CALHOUN,4/23/2020,53,39,0,92
CALHOUN,4/24/2020,53,40,0,93
CALHOUN,4/25/2020,54,40,0,94
CALHOUN,4/26/2020,54,40,0,94
CALHOUN,4/27/2020,54,44,0,98
CALHOUN,4/28/2020,54,45,0,99
CALHOUN,4/29/2020,55,46,0,101
CALHOUN,4/30/2020,55,47,0,102
CALHOUN,5/1/2020,55,47,0,102
CALHOUN,5/2/2020,55,47,0,102
CALHOUN,5/3/2020,55,47,0,102
CALHOUN,5/4/2020,56,51,0,107
CALHOUN,5/5/2020,56,52,0,108
CALHOUN,5/6/2020,56,52,0,108
CALHOUN,5/7/2020,56,52,0,108
CALHOUN,5/8/2020,56,55,0,111
CALHOUN,5/9/2020,56,56,0,112
CALHOUN,5/10/2020,56,56,0,112
CALHOUN,5/11/2020,57,56,0,113
CALHOUN,5/12/2020,57,59,0,116
CALHOUN,5/13/2020,58,60,0,118
CALHOUN,5/14/2020,59,62,0,121
CALHOUN,5/15/2020,59,62,0,121
CALHOUN,5/16/2020,59,62,0,121
CALHOUN,5/17/2020,59,62,0,121
CALHOUN,5/18/2020,59,63,0,122
CALHOUN,5/19/2020,59,63,0,122
CALHOUN,5/20/2020,59,63,0,122
CALHOUN,5/21/2020,59,63,0,122
CALHOUN,5/22/2020,59,64,0,123
CALHOUN,5/23/2020,60,64,0,124
CALHOUN,5/24/2020,60,65,0,125
CALHOUN,5/25/2020,60,65,0,125
CALHOUN,5/26/2020,61,65,0,126
CALHOUN,5/27/2020,61,65,0,126
CALHOUN,5/28/2020,61,67,0,128
CALHOUN,5/29/2020,61,68,0,129
CALHOUN,5/30/2020,61,68,0,129
CALHOUN,5/31/2020,62,68,0,130
CALHOUN,6/1/2020,62,70,0,132
CALHOUN,6/2/2020,62,71,0,133
CALHOUN,6/3/2020,64,72,0,136
CALHOUN,6/4/2020,64,78,0,142
CALHOUN,6/5/2020,64,78,0,142
CALHOUN,6/6/2020,64,79,0,143
CALHOUN,6/7/2020,64,79,0,143
CALHOUN,6/8/2020,64,81,0,145
CALHOUN,6/9/2020,64,82,0,146
CALHOUN,6/10/2020,64,84,0,148
CALHOUN,6/11/2020,65,84,0,149
CALHOUN,6/12/2020,65,84,0,149
CALHOUN,6/13/2020,66,84,0,150
CALHOUN,6/14/2020,66,84,0,150
CALHOUN,6/15/2020,66,84,0,150
CALHOUN,6/16/2020,66,84,0,150
CALHOUN,6/17/2020,67,85,0,152
CALHOUN,6/18/2020,68,86,0,154
CALHOUN,6/19/2020,68,86,0,154
CALHOUN,6/20/2020,69,86,0,155
CALHOUN,6/21/2020,70,86,0,156
CALHOUN,6/22/2020,70,86,0,156
CALHOUN,6/23/2020,70,86,0,156
CALHOUN,6/24/2020,70,86,0,156
CALHOUN,6/25/2020,70,86,0,156
CALHOUN,6/26/2020,72,87,0,159
CALHOUN,6/27/2020,72,89,0,161
CALHOUN,6/28/2020,73,89,0,162
CALHOUN,6/29/2020,73,89,0,162
CALHOUN,6/30/2020,73,89,0,162
CALHOUN,7/1/2020,73,89,0,162
CALHOUN,7/2/2020,73,90,0,163
CALHOUN,7/3/2020,73,90,0,163
CALHOUN,7/4/2020,73,90,0,163
CALHOUN,7/5/2020,74,90,0,164
CALHOUN,7/6/2020,75,90,0,165
CALHOUN,7/7/2020,77,90,0,167
CALHOUN,7/8/2020,78,91,0,169
CALHOUN,7/9/2020,79,92,0,171
CALHOUN,7/10/2020,80,93,0,173
CALHOUN,7/11/2020,81,93,0,174
CALHOUN,7/12/2020,83,93,0,176
CALHOUN,7/13/2020,83,93,0,176
CALHOUN,7/14/2020,84,93,0,177
CALHOUN,7/15/2020,85,93,0,178
CALHOUN,7/16/2020,85,93,0,178
CALHOUN,7/17/2020,85,93,1,179
CALHOUN,7/18/2020,85,93,1,179
CALHOUN,7/19/2020,87,93,1,181
CALHOUN,7/20/2020,88,94,1,183
CALHOUN,7/21/2020,88,94,1,183
CALHOUN,7/22/2020,88,95,1,184
CALHOUN,7/23/2020,90,96,1,187
CALHOUN,7/24/2020,90,97,1,188
CALHOUN,7/25/2020,91,97,1,189
CALHOUN,7/26/2020,91,99,1,191
CALHOUN,7/27/2020,92,99,1,192
CALHOUN,7/28/2020,94,99,1,194
CALHOUN,7/29/2020,95,99,1,195
CALHOUN,7/30/2020,95,99,1,195
CALHOUN,7/31/2020,97,101,1,199
CALHOUN,8/1/2020,98,101,1,200
CALHOUN,8/2/2020,98,102,1,201
CALHOUN,8/3/2020,99,102,1,202
CALHOUN,8/4/2020,99,103,1,203
CALHOUN,8/5/2020,99,103,1,203
CALHOUN,8/6/2020,99,103,1,203
CALHOUN,8/7/2020,99,105,1,205
CALHOUN,8/8/2020,100,105,1,206
CALHOUN,8/9/2020,102,105,1,208
CALHOUN,8/10/2020,103,105,1,209
CALHOUN,8/11/2020,104,107,1,212
CALHOUN,8/12/2020,104,108,1,213
CALHOUN,8/13/2020,104,108,1,213
CALHOUN,8/14/2020,104,109,1,214
CALHOUN,8/15/2020,106,110,1,217
CALHOUN,8/16/2020,106,111,1,218
CALHOUN,8/17/2020,107,111,1,219
CALHOUN,8/18/2020,108,112,1,221
CALHOUN,8/19/2020,108,112,1,221
CALHOUN,8/20/2020,108,113,1,222
CALHOUN,8/21/2020,108,113,1,222
CALHOUN,8/22/2020,109,113,1,223
CALHOUN,8/23/2020,109,113,1,223
CALHOUN,8/24/2020,109,114,1,224
CALHOUN,8/25/2020,109,114,1,224
CALHOUN,8/26/2020,109,115,1,225
CALHOUN,8/27/2020,109,116,1,226
CALHOUN,8/28/2020,109,116,1,226
CALHOUN,8/29/2020,109,116,1,226
CALHOUN,8/30/2020,109,116,1,226
CALHOUN,8/31/2020,109,116,1,226
CALHOUN,9/1/2020,109,116,1,226
CALHOUN,9/2/2020,109,117,1,227
CALHOUN,9/3/2020,109,117,1,227
CALHOUN,9/4/2020,109,117,1,227
CALHOUN,9/5/2020,109,117,1,227
CALHOUN,9/6/2020,109,117,1,227
CALHOUN,9/7/2020,109,117,1,227
CALHOUN,9/8/2020,109,117,1,227
CALHOUN,9/9/2020,109,117,1,227
CALHOUN,9/10/2020,110,118,1,229
CALHOUN,9/11/2020,111,118,1,230
CALHOUN,9/12/2020,111,118,1,230
CALHOUN,9/13/2020,112,118,1,231
CALHOUN,9/14/2020,113,118,1,232
CALHOUN,9/15/2020,113,118,1,232
CALHOUN,9/16/2020,113,118,1,232
CALHOUN,9/17/2020,115,118,1,234
CALHOUN,9/18/2020,116,120,1,237
CALHOUN,9/19/2020,117,120,1,238
CALHOUN,9/20/2020,119,120,1,240
CALHOUN,9/21/2020,119,121,1,241
CALHOUN,9/22/2020,120,121,1,242
CALHOUN,9/23/2020,120,123,1,244
CALHOUN,9/24/2020,120,124,1,245
CALHOUN,9/25/2020,121,125,1,247
CALHOUN,9/26/2020,121,125,1,247
CALHOUN,9/27/2020,122,125,1,248
CALHOUN,9/28/2020,123,125,1,249
CALHOUN,9/29/2020,124,125,1,250
CALHOUN,9/30/2020,124,127,1,252
CALHOUN,10/1/2020,127,127,1,255
CALHOUN,10/2/2020,127,127,1,255
CALHOUN,10/3/2020,127,127,1,255
CALHOUN,10/4/2020,127,127,1,255
CALHOUN,10/5/2020,127,127,1,255
CALHOUN,10/6/2020,127,127,1,255
CALHOUN,10/7/2020,127,127,1,255
CALHOUN,10/8/2020,128,127,1,256
CALHOUN,10/9/2020,129,127,1,257
CALHOUN,10/10/2020,130,128,1,259
CALHOUN,10/11/2020,130,128,1,259
CALHOUN,10/12/2020,131,129,1,261
CALHOUN,10/13/2020,131,129,1,261
CALHOUN,10/14/2020,131,129,1,261
CALHOUN,10/15/2020,131,129,1,261
CALHOUN,10/16/2020,131,129,1,261
CALHOUN,10/17/2020,131,129,1,261
CALHOUN,10/18/2020,131,129,1,261
CALHOUN,10/19/2020,131,129,1,261
CALHOUN,10/20/2020,131,129,1,261
CHEROKEE,1/1/2020,0,0,0,0
CHEROKEE,1/2/2020,0,0,0,0
CHEROKEE,1/3/2020,0,0,0,0
CHEROKEE,1/4/2020,0,0,0,0
CHEROKEE,1/5/2020,0,0,0,0
CHEROKEE,1/6/2020,0,0,0,0
CHEROKEE,1/7/2020,0,0,0,0
CHEROKEE,1/8/2020,0,0,0,0
CHEROKEE,1/9/2020,0,0,0,0
CHEROKEE,1/10/2020,0,0,0,0
CHEROKEE,1/11/2020,0,0,0,0
CHEROKEE,1/12/2020,0,0,0,0
CHEROKEE,1/13/2020,0,0,0,0
CHEROKEE,1/14/2020,0,0,0,0
CHEROKEE,1/15/2020,0,0,0,0
CHEROKEE,1/16/2020,0,0,0,0
CHEROKEE,1/17/2020,0,0,0,0
CHEROKEE,1/18/2020,0,0,0,0
CHEROKEE,1/19/2020,0,0,0,0
CHEROKEE,1/20/2020,0,0,0,0
CHEROKEE,1/21/2020,0,1,0,1
CHEROKEE,1/22/2020,0,1,0,1
CHEROKEE,1/23/2020,0,1,0,1
CHEROKEE,1/24/2020,0,1,0,1
CHEROKEE,1/25/2020,0,1,0,1
CHEROKEE,1/26/2020,0,1,0,1
CHEROKEE,1/27/2020,0,1,0,1
CHEROKEE,1/28/2020,0,2,0,2
CHEROKEE,1/29/2020,0,2,0,2
CHEROKEE,1/30/2020,0,2,0,2
CHEROKEE,1/31/2020,0,2,0,2
CHEROKEE,2/1/2020,0,2,0,2
CHEROKEE,2/2/2020,0,2,0,2
CHEROKEE,2/3/2020,0,2,0,2
CHEROKEE,2/4/2020,0,2,0,2
CHEROKEE,2/5/2020,0,2,0,2
CHEROKEE,2/6/2020,0,2,0,2
CHEROKEE,2/7/2020,0,2,0,2
CHEROKEE,2/8/2020,0,2,0,2
CHEROKEE,2/9/2020,0,2,0,2
CHEROKEE,2/10/2020,0,2,0,2
CHEROKEE,2/11/2020,0,2,0,2
CHEROKEE,2/12/2020,0,2,0,2
CHEROKEE,2/13/2020,1,2,0,3
CHEROKEE,2/14/2020,1,2,0,3
CHEROKEE,2/15/2020,1,2,0,3
CHEROKEE,2/16/2020,1,2,0,3
CHEROKEE,2/17/2020,1,2,0,3
CHEROKEE,2/18/2020,1,2,0,3
CHEROKEE,2/19/2020,1,2,0,3
CHEROKEE,2/20/2020,1,2,0,3
CHEROKEE,2/21/2020,1,2,0,3
CHEROKEE,2/22/2020,1,2,0,3
CHEROKEE,2/23/2020,1,2,0,3
CHEROKEE,2/24/2020,1,2,0,3
CHEROKEE,2/25/2020,1,2,0,3
CHEROKEE,2/26/2020,1,2,0,3
CHEROKEE,2/27/2020,2,2,0,4
CHEROKEE,2/28/2020,2,2,0,4
CHEROKEE,2/29/2020,2,3,0,5
CHEROKEE,3/1/2020,3,3,0,6
CHEROKEE,3/2/2020,3,3,0,6
CHEROKEE,3/3/2020,4,4,0,8
CHEROKEE,3/4/2020,4,5,0,9
CHEROKEE,3/5/2020,6,6,0,12
CHEROKEE,3/6/2020,9,7,0,16
CHEROKEE,3/7/2020,9,7,0,16
CHEROKEE,3/8/2020,10,7,0,17
CHEROKEE,3/9/2020,12,10,0,22
CHEROKEE,3/10/2020,17,15,0,32
CHEROKEE,3/11/2020,18,18,0,36
CHEROKEE,3/12/2020,21,20,0,41
CHEROKEE,3/13/2020,28,22,0,50
CHEROKEE,3/14/2020,30,25,0,55
CHEROKEE,3/15/2020,33,27,0,60
CHEROKEE,3/16/2020,37,30,0,67
CHEROKEE,3/17/2020,41,33,0,74
CHEROKEE,3/18/2020,48,37,0,85
CHEROKEE,3/19/2020,50,39,0,89
CHEROKEE,3/20/2020,53,46,0,99
CHEROKEE,3/21/2020,58,46,0,104
CHEROKEE,3/22/2020,61,50,0,111
CHEROKEE,3/23/2020,68,52,0,120
CHEROKEE,3/24/2020,71,53,0,124
CHEROKEE,3/25/2020,77,60,0,137
CHEROKEE,3/26/2020,85,65,0,150
CHEROKEE,3/27/2020,90,70,0,160
CHEROKEE,3/28/2020,93,74,0,167
CHEROKEE,3/29/2020,95,76,0,171
CHEROKEE,3/30/2020,106,80,0,186
CHEROKEE,3/31/2020,112,85,0,197
CHEROKEE,4/1/2020,116,93,0,209
CHEROKEE,4/2/2020,119,99,0,218
CHEROKEE,4/3/2020,122,102,0,224
CHEROKEE,4/4/2020,126,105,0,231
CHEROKEE,4/5/2020,132,107,0,239
CHEROKEE,4/6/2020,139,111,0,250
CHEROKEE,4/7/2020,144,115,0,259
PUTNAM,7/9/2020,144,123,3,270
PUTNAM,7/10/2020,149,125,3,277
PUTNAM,7/11/2020,151,127,3,281
PUTNAM,7/12/2020,156,130,3,289
PUTNAM,7/13/2020,162,141,3,306
PUTNAM,7/14/2020,172,147,3,322
PUTNAM,7/15/2020,177,152,3,332
PUTNAM,7/16/2020,179,157,3,339
PUTNAM,7/17/2020,183,159,3,345
PUTNAM,7/18/2020,188,160,3,351
PUTNAM,7/19/2020,195,161,3,359
PUTNAM,7/20/2020,198,167,3,368
PUTNAM,7/21/2020,201,170,3,374
PUTNAM,7/22/2020,202,173,3,378
PUTNAM,7/23/2020,205,175,3,383
PUTNAM,7/24/2020,207,180,3,390
PUTNAM,7/25/2020,209,183,3,395
PUTNAM,7/26/2020,211,186,3,400
PUTNAM,7/27/2020,213,190,3,406
PUTNAM,7/28/2020,220,194,3,417
PUTNAM,7/29/2020,220,199,3,422
PUTNAM,7/30/2020,227,203,3,433
PUTNAM,7/31/2020,232,210,3,445
PUTNAM,8/1/2020,234,214,3,451
PUTNAM,8/2/2020,236,216,3,455
PUTNAM,8/3/2020,242,224,3,469
PUTNAM,8/4/2020,245,227,4,476
PUTNAM,8/5/2020,254,235,4,493
PUTNAM,8/6/2020,263,243,4,510
PUTNAM,8/7/2020,266,248,4,518
PUTNAM,8/8/2020,266,249,4,519
PUTNAM,8/9/2020,272,252,4,528
PUTNAM,8/10/2020,276,255,4,535
PUTNAM,8/11/2020,281,259,4,544
PUTNAM,8/12/2020,291,265,4,560
PUTNAM,8/13/2020,294,269,4,567
PUTNAM,8/14/2020,300,271,4,575
PUTNAM,8/15/2020,304,272,4,580
PUTNAM,8/16/2020,308,272,4,584
PUTNAM,8/17/2020,311,276,4,591
PUTNAM,8/18/2020,316,278,4,598
PUTNAM,8/19/2020,319,278,4,601
PUTNAM,8/20/2020,324,281,4,609
PUTNAM,8/21/2020,331,282,4,617
PUTNAM,8/22/2020,333,285,4,622
PUTNAM,8/23/2020,335,285,4,624
PUTNAM,8/24/2020,340,287,4,631
PUTNAM,8/25/2020,343,289,4,636
PUTNAM,8/26/2020,346,291,4,641
PUTNAM,8/27/2020,347,291,4,642
PUTNAM,8/28/2020,347,291,4,642
PUTNAM,8/29/2020,348,291,4,643
PUTNAM,8/30/2020,351,294,4,649
PUTNAM,8/31/2020,352,297,4,653
PUTNAM,9/1/2020,356,298,4,658
PUTNAM,9/2/2020,357,299,4,660
PUTNAM,9/3/2020,359,304,4,667
PUTNAM,9/4/2020,360,304,4,668
PUTNAM,9/5/2020,361,304,4,669
PUTNAM,9/6/2020,364,305,4,673
PUTNAM,9/7/2020,364,305,4,673
PUTNAM,9/8/2020,364,307,4,675
PUTNAM,9/9/2020,366,311,4,681
PUTNAM,9/10/2020,366,311,4,681
PUTNAM,9/11/2020,366,312,4,682
PUTNAM,9/12/2020,367,316,4,687
PUTNAM,9/13/2020,367,317,4,688
PUTNAM,9/14/2020,367,318,4,689
PUTNAM,9/15/2020,368,320,4,692
PUTNAM,9/16/2020,369,321,4,694
PUTNAM,9/17/2020,370,322,4,696
PUTNAM,9/18/2020,371,322,4,697
PUTNAM,9/19/2020,371,322,4,697
PUTNAM,9/20/2020,372,323,4,699
PUTNAM,9/21/2020,373,325,4,702
PUTNAM,9/22/2020,378,325,4,707
PUTNAM,9/23/2020,379,328,4,711
PUTNAM,9/24/2020,381,329,4,714
PUTNAM,9/25/2020,381,331,4,716
PUTNAM,9/26/2020,382,331,4,717
PUTNAM,9/27/2020,384,331,4,719
PUTNAM,9/28/2020,387,333,4,724
PUTNAM,9/29/2020,389,338,4,731
PUTNAM,9/30/2020,391,339,4,734
PUTNAM,10/1/2020,391,342,4,737
PUTNAM,10/2/2020,391,346,4,741
PUTNAM,10/3/2020,393,347,4,744
PUTNAM,10/4/2020,395,348,4,747
PUTNAM,10/5/2020,397,351,4,752
PUTNAM,10/6/2020,397,351,4,752
PUTNAM,10/7/2020,399,354,4,757
PUTNAM,10/8/2020,400,355,4,759
PUTNAM,10/9/2020,401,356,4,761
PUTNAM,10/10/2020,401,359,4,764
PUTNAM,10/11/2020,401,360,4,765
PUTNAM,10/12/2020,401,362,4,767
PUTNAM,10/13/2020,403,363,4,770
PUTNAM,10/14/2020,403,364,4,771
PUTNAM,10/15/2020,404,364,4,772
PUTNAM,10/16/2020,404,364,4,772
PUTNAM,10/17/2020,404,364,4,772
PUTNAM,10/18/2020,405,364,4,773
PUTNAM,10/19/2020,405,364,4,773
PUTNAM,10/20/2020,405,364,4,773
BROOKS,1/1/2020,0,0,0,0
BROOKS,1/2/2020,0,0,0,0
BROOKS,1/3/2020,0,0,0,0
BROOKS,1/4/2020,0,0,0,0
BROOKS,1/5/2020,0,0,0,0
BROOKS,1/6/2020,0,0,0,0
BROOKS,1/7/2020,0,0,0,0
BROOKS,1/8/2020,0,0,0,0
BROOKS,1/9/2020,0,0,0,0
BROOKS,1/10/2020,0,0,0,0
BROOKS,1/11/2020,0,0,0,0
BROOKS,1/12/2020,0,0,0,0
BROOKS,1/13/2020,0,0,0,0
BROOKS,1/14/2020,0,0,0,0
BROOKS,1/15/2020,0,0,0,0
BROOKS,1/16/2020,0,0,0,0
BROOKS,1/17/2020,0,0,0,0
BROOKS,1/18/2020,0,0,0,0
BROOKS,1/19/2020,0,0,0,0
BROOKS,1/20/2020,0,0,0,0
BROOKS,1/21/2020,0,0,0,0
BROOKS,1/22/2020,0,0,0,0
BROOKS,1/23/2020,0,0,0,0
BROOKS,1/24/2020,0,0,0,0
BROOKS,1/25/2020,0,0,0,0
BROOKS,1/26/2020,0,0,0,0
BROOKS,1/27/2020,0,0,0,0
BROOKS,1/28/2020,0,0,0,0
BROOKS,1/29/2020,0,0,0,0
BROOKS,1/30/2020,0,0,0,0
BROOKS,1/31/2020,0,0,0,0
BROOKS,2/1/2020,0,0,0,0
BROOKS,2/2/2020,0,0,0,0
BROOKS,2/3/2020,0,0,0,0
BROOKS,2/4/2020,0,0,0,0
BROOKS,2/5/2020,0,0,0,0
BROOKS,2/6/2020,0,0,0,0
BROOKS,2/7/2020,0,0,0,0
BROOKS,2/8/2020,0,0,0,0
BROOKS,2/9/2020,0,0,0,0
BROOKS,2/10/2020,0,0,0,0
BROOKS,2/11/2020,0,0,0,0
BROOKS,2/12/2020,0,0,0,0
BROOKS,2/13/2020,0,0,0,0
BROOKS,2/14/2020,0,0,0,0
BROOKS,2/15/2020,0,0,0,0
BROOKS,2/16/2020,0,0,0,0
BROOKS,2/17/2020,0,0,0,0
BROOKS,2/18/2020,0,0,0,0
BROOKS,2/19/2020,0,0,0,0
BROOKS,2/20/2020,0,0,0,0
BROOKS,2/21/2020,0,0,0,0
BROOKS,2/22/2020,0,0,0,0
BROOKS,2/23/2020,0,0,0,0
BROOKS,2/24/2020,0,0,0,0
BROOKS,2/25/2020,0,0,0,0
BROOKS,2/26/2020,0,0,0,0
BROOKS,2/27/2020,0,0,0,0
BROOKS,2/28/2020,0,0,0,0
BROOKS,2/29/2020,0,0,0,0
BROOKS,3/1/2020,0,0,0,0
BROOKS,3/2/2020,0,0,0,0
BROOKS,3/3/2020,0,0,0,0
BROOKS,3/4/2020,0,0,0,0
BROOKS,3/5/2020,0,0,0,0
BROOKS,3/6/2020,0,0,0,0
BROOKS,3/7/2020,0,0,0,0
BROOKS,3/8/2020,0,0,0,0
BROOKS,3/9/2020,0,0,0,0
BROOKS,3/10/2020,0,0,0,0
BROOKS,3/11/2020,0,0,0,0
BROOKS,3/12/2020,0,0,0,0
BROOKS,3/13/2020,0,0,0,0
BROOKS,3/14/2020,0,0,0,0
BROOKS,3/15/2020,0,0,0,0
BROOKS,3/16/2020,0,0,0,0
BROOKS,3/17/2020,0,0,0,0
BROOKS,3/18/2020,0,0,0,0
BROOKS,3/19/2020,0,0,0,0
BROOKS,3/20/2020,0,1,0,1
BROOKS,3/21/2020,0,1,0,1
BROOKS,3/22/2020,0,1,0,1
BROOKS,3/23/2020,0,2,0,2
BROOKS,3/24/2020,0,3,0,3
BROOKS,3/25/2020,1,3,0,4
BROOKS,3/26/2020,1,3,0,4
BROOKS,3/27/2020,5,5,0,10
BROOKS,3/28/2020,5,5,0,10
BROOKS,3/29/2020,5,5,0,10
BROOKS,3/30/2020,5,8,0,13
BROOKS,3/31/2020,6,8,0,14
BROOKS,4/1/2020,6,8,0,14
BROOKS,4/2/2020,6,8,0,14
BROOKS,4/3/2020,6,8,0,14
BROOKS,4/4/2020,6,8,0,14
BROOKS,4/5/2020,6,8,0,14
BROOKS,4/6/2020,6,8,0,14
BROOKS,4/7/2020,7,9,0,16
BROOKS,4/8/2020,7,9,0,16
BROOKS,4/9/2020,7,9,0,16
BROOKS,4/10/2020,8,10,0,18
BROOKS,4/11/2020,9,11,0,20
BROOKS,4/12/2020,9,11,0,20
BROOKS,4/13/2020,9,12,0,21
BROOKS,4/14/2020,10,12,0,22
BROOKS,4/15/2020,11,17,0,28
BROOKS,4/16/2020,12,18,0,30
BROOKS,4/17/2020,13,18,0,31
BROOKS,4/18/2020,14,20,0,34
BROOKS,4/19/2020,15,21,0,36
BROOKS,4/20/2020,17,22,0,39
BROOKS,4/21/2020,21,29,1,51
BROOKS,4/22/2020,22,30,2,54
BROOKS,4/23/2020,22,30,2,54
BROOKS,4/24/2020,22,30,2,54
BROOKS,4/25/2020,22,30,2,54
BROOKS,4/26/2020,22,30,2,54
BROOKS,4/27/2020,24,30,2,56
BROOKS,4/28/2020,25,30,2,57
BROOKS,4/29/2020,25,31,2,58
BROOKS,4/30/2020,25,31,2,58
BROOKS,5/1/2020,25,31,2,58
BROOKS,5/2/2020,25,31,2,58
BROOKS,5/3/2020,26,32,2,60
BROOKS,5/4/2020,27,32,2,61
BROOKS,5/5/2020,27,32,2,61
BROOKS,5/6/2020,27,32,2,61
BROOKS,5/7/2020,27,32,2,61
BROOKS,5/8/2020,27,32,2,61
BROOKS,5/9/2020,27,32,2,61
BROOKS,5/10/2020,27,32,2,61
BROOKS,5/11/2020,27,32,2,61
BROOKS,5/12/2020,27,34,2,63
BROOKS,5/13/2020,28,34,2,64
BROOKS,5/14/2020,28,34,2,64
BROOKS,5/15/2020,28,34,2,64
BROOKS,5/16/2020,28,34,2,64
BROOKS,5/17/2020,28,34,2,64
BROOKS,5/18/2020,29,36,2,67
BROOKS,5/19/2020,30,36,2,68
BROOKS,5/20/2020,30,36,2,68
BROOKS,5/21/2020,30,36,2,68
BROOKS,5/22/2020,30,36,2,68
BROOKS,5/23/2020,30,36,2,68
BROOKS,5/24/2020,30,36,2,68
BROOKS,5/25/2020,31,36,2,69
BROOKS,5/26/2020,31,37,2,70
BROOKS,5/27/2020,31,37,2,70
BROOKS,5/28/2020,33,37,2,72
BROOKS,5/29/2020,33,37,2,72
BROOKS,5/30/2020,36,37,2,75
BROOKS,5/31/2020,37,39,2,78
BROOKS,6/1/2020,37,41,2,80
BROOKS,6/2/2020,37,41,2,80
BROOKS,6/3/2020,37,42,2,81
BROOKS,6/4/2020,37,44,2,83
BROOKS,6/5/2020,38,46,2,86
BROOKS,6/6/2020,40,47,2,89
BROOKS,6/7/2020,40,48,2,90
BROOKS,6/8/2020,42,49,2,93
BROOKS,6/9/2020,42,52,2,96
BROOKS,6/10/2020,44,53,2,99
BROOKS,6/11/2020,44,53,2,99
BROOKS,6/12/2020,46,54,2,102
BROOKS,6/13/2020,46,55,2,103
BROOKS,6/14/2020,46,56,2,104
BROOKS,6/15/2020,49,61,2,112
BROOKS,6/16/2020,51,62,2,115
BROOKS,6/17/2020,54,63,2,119
BROOKS,6/18/2020,57,63,2,122
BROOKS,6/19/2020,65,65,2,132
BROOKS,6/20/2020,67,66,2,135
BROOKS,6/21/2020,68,67,2,137
BROOKS,6/22/2020,74,70,2,146
BROOKS,6/23/2020,80,71,2,153
BROOKS,6/24/2020,83,72,2,157
BROOKS,6/25/2020,88,73,2,163
BROOKS,6/26/2020,94,75,2,171
BROOKS,6/27/2020,95,75,2,172
BROOKS,6/28/2020,97,76,2,175
BROOKS,6/29/2020,106,83,2,191
BROOKS,6/30/2020,113,85,3,201
BROOKS,7/1/2020,117,88,3,208
BROOKS,7/2/2020,121,91,3,215
BROOKS,7/3/2020,122,92,3,217
BROOKS,7/4/2020,123,93,3,219
BROOKS,7/5/2020,124,94,3,221
BROOKS,7/6/2020,126,96,3,225
BROOKS,7/7/2020,130,102,3,235
BROOKS,7/8/2020,135,103,3,241
BROOKS,7/9/2020,143,107,3,253
BROOKS,7/10/2020,144,111,3,258
BROOKS,7/11/2020,149,117,4,270
BROOKS,7/12/2020,153,119,4,276
BROOKS,7/13/2020,157,121,4,282
BROOKS,7/14/2020,161,123,4,288
BROOKS,7/15/2020,166,126,4,296
BROOKS,7/16/2020,171,132,4,307
BROOKS,7/17/2020,177,133,4,314
BROOKS,7/18/2020,178,134,4,316
BROOKS,7/19/2020,178,136,4,318
BROOKS,7/20/2020,183,144,4,331
BROOKS,7/21/2020,187,151,4,342
BROOKS,7/22/2020,199,157,7,363
BROOKS,7/23/2020,204,160,7,371
BROOKS,7/24/2020,208,161,7,376
BROOKS,7/25/2020,211,163,7,381
BROOKS,7/26/2020,213,164,7,384
BROOKS,7/27/2020,218,165,7,390
BROOKS,7/28/2020,222,168,7,397
BROOKS,7/29/2020,223,168,7,398
BROOKS,7/30/2020,224,169,7,400
BROOKS,7/31/2020,226,170,7,403
BROOKS,8/1/2020,227,171,7,405
BROOKS,8/2/2020,228,171,9,408
BROOKS,8/3/2020,231,175,10,416
BROOKS,8/4/2020,233,178,10,421
BROOKS,8/5/2020,233,178,10,421
BROOKS,8/6/2020,235,180,11,426
BROOKS,8/7/2020,236,180,11,427
BROOKS,8/8/2020,236,183,11,430
BROOKS,8/9/2020,236,183,11,430
BROOKS,8/10/2020,240,183,11,434
BROOKS,8/11/2020,241,184,11,436
BROOKS,8/12/2020,241,190,11,442
BROOKS,8/13/2020,244,192,11,447
BROOKS,8/14/2020,247,197,11,455
BROOKS,8/15/2020,248,197,11,456
BROOKS,8/16/2020,249,199,11,459
BROOKS,8/17/2020,252,200,11,463
BROOKS,8/18/2020,253,200,11,464
BROOKS,8/19/2020,254,200,11,465
BROOKS,8/20/2020,258,200,11,469
BROOKS,8/21/2020,258,200,11,469
BROOKS,8/22/2020,260,201,11,472
BROOKS,8/23/2020,263,201,11,475
BROOKS,8/24/2020,266,204,11,481
BROOKS,8/25/2020,266,205,11,482
BROOKS,8/26/2020,268,205,11,484
BROOKS,8/27/2020,272,205,12,489
BROOKS,8/28/2020,272,205,12,489
BROOKS,8/29/2020,273,205,12,490
BROOKS,8/30/2020,273,206,12,491
BROOKS,8/31/2020,274,208,12,494
BROOKS,9/1/2020,274,209,12,495
BROOKS,9/2/2020,274,209,12,495
BROOKS,9/3/2020,275,209,12,496
BROOKS,9/4/2020,277,209,12,498
BROOKS,9/5/2020,277,210,12,499
BROOKS,9/6/2020,278,211,12,501
BROOKS,9/7/2020,279,211,12,502
BROOKS,9/8/2020,280,211,12,503
BROOKS,9/9/2020,280,211,12,503
BROOKS,9/10/2020,281,212,13,506
BROOKS,9/11/2020,281,214,13,508
BROOKS,9/12/2020,281,216,13,510
BROOKS,9/13/2020,281,218,13,512
BROOKS,9/14/2020,281,220,13,514
BROOKS,9/15/2020,281,222,13,516
BROOKS,9/16/2020,281,222,13,516
BROOKS,9/17/2020,283,222,13,518
BROOKS,9/18/2020,283,222,13,518
BROOKS,9/19/2020,283,223,13,519
BROOKS,9/20/2020,284,223,13,520
BROOKS,9/21/2020,284,224,13,521
BROOKS,9/22/2020,285,225,13,523
BROOKS,9/23/2020,286,226,13,525
BROOKS,9/24/2020,287,226,13,526
BROOKS,9/25/2020,289,227,13,529
BROOKS,9/26/2020,289,227,13,529
BROOKS,9/27/2020,289,227,13,529
BROOKS,9/28/2020,289,227,13,529
BROOKS,9/29/2020,289,227,13,529
BROOKS,9/30/2020,289,227,13,529
BROOKS,10/1/2020,289,228,13,530
BROOKS,10/2/2020,290,229,13,532
BROOKS,10/3/2020,290,229,13,532
BROOKS,10/4/2020,290,229,13,532
BROOKS,10/5/2020,291,229,13,533
BROOKS,10/6/2020,291,229,13,533
BROOKS,10/7/2020,291,229,13,533
BROOKS,10/8/2020,294,229,13,536
BROOKS,10/9/2020,294,229,13,536
BROOKS,10/10/2020,294,229,13,536
BROOKS,10/11/2020,294,229,13,536
BROOKS,10/12/2020,296,230,13,539
FANNIN,1/17/2020,0,0,0,0
FANNIN,1/18/2020,0,0,0,0
FANNIN,1/19/2020,0,0,0,0
FANNIN,1/20/2020,0,0,0,0
FANNIN,1/21/2020,0,0,0,0
FANNIN,1/22/2020,0,0,0,0
FANNIN,1/23/2020,0,0,0,0
FANNIN,1/24/2020,0,0,0,0
FANNIN,1/25/2020,0,0,0,0
FANNIN,1/26/2020,0,0,0,0
FANNIN,1/27/2020,0,0,0,0
FANNIN,1/28/2020,0,0,0,0
FANNIN,1/29/2020,0,0,0,0
FANNIN,1/30/2020,0,0,0,0
FANNIN,1/31/2020,0,0,0,0
FANNIN,2/1/2020,0,0,0,0
FANNIN,2/2/2020,0,0,0,0
FANNIN,2/3/2020,0,0,0,0
FANNIN,2/4/2020,0,0,0,0
FANNIN,2/5/2020,0,0,0,0
FANNIN,2/6/2020,0,0,0,0
FANNIN,2/7/2020,0,0,0,0
FANNIN,2/8/2020,0,0,0,0
FANNIN,2/9/2020,0,0,0,0
FANNIN,2/10/2020,0,0,0,0
FANNIN,2/11/2020,0,0,0,0
FANNIN,2/12/2020,0,0,0,0
FANNIN,2/13/2020,0,0,0,0
FANNIN,2/14/2020,0,0,0,0
FANNIN,2/15/2020,0,0,0,0
FANNIN,2/16/2020,0,0,0,0
FANNIN,2/17/2020,0,0,0,0
FANNIN,2/18/2020,0,0,0,0
FANNIN,2/19/2020,0,0,0,0
FANNIN,2/20/2020,0,0,0,0
FANNIN,2/21/2020,0,0,0,0
FANNIN,2/22/2020,0,0,0,0
FANNIN,2/23/2020,0,0,0,0
FANNIN,2/24/2020,0,0,0,0
FANNIN,2/25/2020,0,0,0,0
FANNIN,2/26/2020,0,0,0,0
FANNIN,2/27/2020,0,0,0,0
FANNIN,2/28/2020,0,0,0,0
FANNIN,2/29/2020,0,0,0,0
FANNIN,3/1/2020,0,0,0,0
FANNIN,3/2/2020,0,0,0,0
FANNIN,3/3/2020,0,0,0,0
FANNIN,3/4/2020,0,0,0,0
FANNIN,3/5/2020,0,0,0,0
FANNIN,3/6/2020,0,0,0,0
FANNIN,3/7/2020,0,0,0,0
FANNIN,3/8/2020,0,0,0,0
FANNIN,3/9/2020,0,0,0,0
FANNIN,3/10/2020,1,0,0,1
FANNIN,3/11/2020,1,0,0,1
FANNIN,3/12/2020,1,0,0,1
FANNIN,3/13/2020,1,0,0,1
FANNIN,3/14/2020,2,0,0,2
FANNIN,3/15/2020,3,0,0,3
FANNIN,3/16/2020,3,0,0,3
FANNIN,3/17/2020,3,0,0,3
FANNIN,3/18/2020,3,1,0,4
FANNIN,3/19/2020,4,1,0,5
FANNIN,3/20/2020,4,2,0,6
FANNIN,3/21/2020,4,2,0,6
FANNIN,3/22/2020,4,2,0,6
FANNIN,3/23/2020,4,2,0,6
FANNIN,3/24/2020,4,5,0,9
FANNIN,3/25/2020,5,5,0,10
FANNIN,3/26/2020,5,5,0,10
FANNIN,3/27/2020,5,5,0,10
FANNIN,3/28/2020,5,5,0,10
FANNIN,3/29/2020,5,5,0,10
FANNIN,3/30/2020,6,6,0,12
FANNIN,3/31/2020,6,6,0,12
FANNIN,4/1/2020,6,6,0,12
FANNIN,4/2/2020,6,6,0,12
FANNIN,4/3/2020,6,7,0,13
FANNIN,4/4/2020,6,7,0,13
FANNIN,4/5/2020,6,7,0,13
FANNIN,4/6/2020,6,10,0,16
FANNIN,4/7/2020,6,10,0,16
FANNIN,4/8/2020,6,11,0,17
FANNIN,4/9/2020,6,11,0,17
FANNIN,4/10/2020,6,11,0,17
FANNIN,4/11/2020,6,12,0,18
FANNIN,4/12/2020,7,13,0,20
FANNIN,4/13/2020,7,14,0,21
FANNIN,4/14/2020,8,14,0,22
FANNIN,4/15/2020,8,15,0,23
FANNIN,4/16/2020,8,15,0,23
FANNIN,4/17/2020,9,15,0,24
FANNIN,4/18/2020,10,15,0,25
FANNIN,4/19/2020,10,17,0,27
FANNIN,4/20/2020,10,18,0,28
FANNIN,4/21/2020,11,18,0,29
FANNIN,4/22/2020,11,18,0,29
FANNIN,4/23/2020,12,18,0,30
FANNIN,4/24/2020,13,19,0,32
FANNIN,4/25/2020,14,20,0,34
FANNIN,4/26/2020,16,20,0,36
FANNIN,4/27/2020,17,21,0,38
FANNIN,4/28/2020,17,21,0,38
FANNIN,4/29/2020,18,21,0,39
FANNIN,4/30/2020,18,21,0,39
FANNIN,5/1/2020,19,21,0,40
FANNIN,5/2/2020,19,21,0,40
FANNIN,5/3/2020,19,21,0,40
FANNIN,5/4/2020,20,21,0,41
FANNIN,5/5/2020,20,21,0,41
FANNIN,5/6/2020,21,21,0,42
FANNIN,5/7/2020,21,21,0,42
FANNIN,5/8/2020,21,21,0,42
FANNIN,5/9/2020,21,22,0,43
FANNIN,5/10/2020,21,22,0,43
FANNIN,5/11/2020,22,23,0,45
FANNIN,5/12/2020,22,23,0,45
FANNIN,5/13/2020,22,23,0,45
FANNIN,5/14/2020,22,23,0,45
FANNIN,5/15/2020,22,23,0,45
FANNIN,5/16/2020,22,23,0,45
FANNIN,5/17/2020,22,23,0,45
FANNIN,5/18/2020,22,23,0,45
FANNIN,5/19/2020,22,24,0,46
FANNIN,5/20/2020,22,24,0,46
FANNIN,5/21/2020,22,24,0,46
FANNIN,5/22/2020,22,25,0,47
FANNIN,5/23/2020,23,25,0,48
FANNIN,5/24/2020,23,25,0,48
FANNIN,5/25/2020,24,25,0,49
FANNIN,5/26/2020,24,26,0,50
FANNIN,5/27/2020,24,26,0,50
FANNIN,5/28/2020,26,28,0,54
FANNIN,5/29/2020,26,28,0,54
FANNIN,5/30/2020,26,28,0,54
FANNIN,5/31/2020,26,29,0,55
FANNIN,6/1/2020,27,31,0,58
FANNIN,6/2/2020,27,31,0,58
FANNIN,6/3/2020,28,31,0,59
FANNIN,6/4/2020,30,32,0,62
FANNIN,6/5/2020,32,34,0,66
FANNIN,6/6/2020,33,36,0,69
FANNIN,6/7/2020,33,36,0,69
FANNIN,6/8/2020,34,38,0,72
FANNIN,6/9/2020,34,39,0,73
FAYETTE,5/2/2020,108,81,0,189
FANNIN,6/10/2020,36,39,0,75
FANNIN,6/11/2020,36,41,0,77
FANNIN,6/12/2020,36,42,0,78
FANNIN,6/13/2020,36,42,0,78
FANNIN,6/14/2020,37,42,0,79
FANNIN,6/15/2020,38,43,0,81
FANNIN,6/16/2020,45,44,0,89
FANNIN,6/17/2020,46,47,0,93
FANNIN,6/18/2020,46,50,0,96
FANNIN,6/19/2020,47,52,0,99
FANNIN,6/20/2020,47,53,0,100
FANNIN,6/21/2020,47,53,0,100
FANNIN,6/22/2020,49,55,0,104
FANNIN,6/23/2020,49,55,0,104
FANNIN,6/24/2020,50,56,0,106
FANNIN,6/25/2020,51,57,0,108
FANNIN,6/26/2020,52,57,0,109
FANNIN,6/27/2020,52,59,0,111
FANNIN,6/28/2020,54,62,0,116
FANNIN,6/29/2020,56,62,0,118
FANNIN,6/30/2020,60,65,0,125
FANNIN,7/1/2020,61,66,0,127
FANNIN,7/2/2020,63,67,0,130
FANNIN,7/3/2020,64,69,0,133
FANNIN,7/4/2020,64,71,0,135
FANNIN,7/5/2020,64,71,0,135
FANNIN,7/6/2020,69,79,0,148
FANNIN,7/7/2020,72,82,0,154
FANNIN,7/8/2020,76,89,0,165
FANNIN,7/9/2020,81,96,0,177
FANNIN,7/10/2020,89,102,0,191
FANNIN,7/11/2020,96,103,0,199
FANNIN,7/12/2020,100,109,0,209
FANNIN,7/13/2020,105,113,0,218
FANNIN,7/14/2020,119,121,0,240
FANNIN,7/15/2020,121,125,0,246
FANNIN,7/16/2020,125,132,0,257
FANNIN,7/17/2020,131,133,0,264
FANNIN,7/18/2020,132,138,0,270
FANNIN,7/19/2020,133,140,0,273
FANNIN,7/20/2020,138,143,0,281
FANNIN,7/21/2020,140,149,0,289
FANNIN,7/22/2020,143,151,0,294
FANNIN,7/23/2020,150,155,0,305
FANNIN,7/24/2020,152,157,0,309
FANNIN,7/25/2020,152,162,0,314
FANNIN,7/26/2020,154,163,0,317
FANNIN,7/27/2020,155,166,0,321
FANNIN,7/28/2020,156,170,0,326
FANNIN,7/29/2020,160,171,0,331
FANNIN,7/30/2020,165,173,0,338
FANNIN,7/31/2020,168,175,0,343
FANNIN,8/1/2020,171,180,0,351
FANNIN,8/2/2020,171,181,0,352
FANNIN,8/3/2020,174,183,0,357
FANNIN,8/4/2020,177,189,0,366
FANNIN,8/5/2020,179,192,0,371
FANNIN,8/6/2020,183,194,0,377
FANNIN,8/7/2020,187,196,0,383
FANNIN,8/8/2020,189,198,0,387
FANNIN,8/9/2020,190,200,0,390
FANNIN,8/10/2020,194,200,0,394
FANNIN,8/11/2020,199,201,0,400
FANNIN,8/12/2020,202,203,0,405
FANNIN,8/13/2020,208,207,0,415
FANNIN,8/14/2020,209,209,0,418
FANNIN,8/15/2020,210,210,0,420
FANNIN,8/16/2020,214,211,0,425
FANNIN,8/17/2020,216,213,0,429
FANNIN,8/18/2020,218,217,0,435
FANNIN,8/19/2020,221,218,0,439
FANNIN,8/20/2020,221,223,0,444
FANNIN,8/21/2020,224,225,0,449
FANNIN,8/22/2020,225,225,0,450
FANNIN,8/23/2020,231,225,0,456
FANNIN,8/24/2020,234,228,0,462
FANNIN,8/25/2020,235,235,0,470
FANNIN,8/26/2020,240,236,0,476
FANNIN,8/27/2020,250,238,0,488
FANNIN,8/28/2020,256,240,0,496
FANNIN,8/29/2020,259,241,0,500
FANNIN,8/30/2020,262,244,0,506
FANNIN,8/31/2020,266,245,0,511
FANNIN,9/1/2020,270,245,0,515
FANNIN,9/2/2020,276,250,0,526
FANNIN,9/3/2020,279,254,0,533
FANNIN,9/4/2020,285,257,0,542
FANNIN,9/5/2020,287,261,0,548
FANNIN,9/6/2020,288,263,0,551
FANNIN,9/7/2020,292,265,0,557
FANNIN,9/8/2020,301,267,0,568
FANNIN,9/9/2020,305,272,0,577
FANNIN,9/10/2020,309,275,0,584
FANNIN,9/11/2020,315,279,0,594
FANNIN,9/12/2020,320,279,0,599
FANNIN,9/13/2020,322,281,0,603
FANNIN,9/14/2020,328,285,0,613
FANNIN,9/15/2020,336,293,0,629
FANNIN,9/16/2020,343,295,0,638
FANNIN,9/17/2020,345,299,0,644
FANNIN,9/18/2020,347,300,0,647
FANNIN,9/19/2020,349,301,0,650
FANNIN,9/20/2020,355,303,0,658
FANNIN,9/21/2020,360,305,0,665
FANNIN,9/22/2020,362,309,0,671
FANNIN,9/23/2020,364,312,0,676
FANNIN,9/24/2020,366,313,0,679
FANNIN,9/25/2020,373,315,0,688
FANNIN,9/26/2020,376,315,1,692
FANNIN,9/27/2020,377,316,1,694
FANNIN,9/28/2020,383,323,1,707
FANNIN,9/29/2020,390,327,1,718
FANNIN,9/30/2020,392,328,1,721
FANNIN,10/1/2020,396,329,1,726
FANNIN,10/2/2020,403,329,1,733
FANNIN,10/3/2020,405,330,1,736
FANNIN,10/4/2020,408,331,1,740
FANNIN,10/5/2020,411,332,1,744
FANNIN,10/6/2020,412,335,1,748
FANNIN,10/7/2020,416,336,1,753
FANNIN,10/8/2020,419,336,1,756
FANNIN,10/9/2020,420,338,2,760
FANNIN,10/10/2020,421,338,2,761
FANNIN,10/11/2020,423,338,2,763
FANNIN,10/12/2020,426,339,2,767
FANNIN,10/13/2020,429,339,3,771
FANNIN,10/14/2020,431,341,3,775
FANNIN,10/15/2020,434,343,3,780
FANNIN,10/16/2020,435,345,3,783
FANNIN,10/17/2020,435,345,3,783
FANNIN,10/18/2020,435,345,3,783
FANNIN,10/19/2020,435,345,3,783
FANNIN,10/20/2020,435,345,3,783
FAYETTE,1/1/2020,0,0,0,0
FAYETTE,1/2/2020,0,0,0,0
FAYETTE,1/3/2020,0,0,0,0
FAYETTE,1/4/2020,0,0,0,0
FAYETTE,1/5/2020,0,0,0,0
FAYETTE,1/6/2020,0,0,0,0
FAYETTE,1/7/2020,0,0,0,0
FAYETTE,1/8/2020,0,0,0,0
FAYETTE,1/9/2020,0,0,0,0
FAYETTE,1/10/2020,0,0,0,0
FAYETTE,1/11/2020,0,0,0,0
FAYETTE,1/12/2020,0,0,0,0
FAYETTE,1/13/2020,0,0,0,0
FAYETTE,1/14/2020,0,0,0,0
FAYETTE,1/15/2020,0,0,0,0
FAYETTE,1/16/2020,0,0,0,0
FAYETTE,1/17/2020,0,0,0,0
FAYETTE,1/18/2020,0,0,0,0
FAYETTE,1/19/2020,0,0,0,0
FAYETTE,1/20/2020,0,0,0,0
FAYETTE,1/21/2020,0,0,0,0
FAYETTE,1/22/2020,0,0,0,0
FAYETTE,1/23/2020,0,0,0,0
FAYETTE,1/24/2020,0,0,0,0
FAYETTE,1/25/2020,0,0,0,0
FAYETTE,1/26/2020,0,0,0,0
FAYETTE,1/27/2020,0,0,0,0
FAYETTE,1/28/2020,0,0,0,0
FAYETTE,1/29/2020,0,0,0,0
FAYETTE,1/30/2020,0,0,0,0
FAYETTE,1/31/2020,0,0,0,0
FAYETTE,2/1/2020,0,0,0,0
FAYETTE,2/2/2020,0,0,0,0
FAYETTE,2/3/2020,0,0,0,0
FAYETTE,2/4/2020,0,0,0,0
FAYETTE,2/5/2020,0,0,0,0
FAYETTE,2/6/2020,0,0,0,0
FAYETTE,2/7/2020,0,0,0,0
FAYETTE,2/8/2020,0,0,0,0
FAYETTE,2/9/2020,0,0,0,0
FAYETTE,2/10/2020,0,0,0,0
FAYETTE,2/11/2020,0,0,0,0
FAYETTE,2/12/2020,0,0,0,0
FAYETTE,2/13/2020,0,0,0,0
FAYETTE,2/14/2020,0,0,0,0
FAYETTE,2/15/2020,0,0,0,0
FAYETTE,2/16/2020,0,0,0,0
FAYETTE,2/17/2020,0,0,0,0
FAYETTE,2/18/2020,0,0,0,0
FAYETTE,2/19/2020,0,0,0,0
FAYETTE,2/20/2020,0,0,0,0
FAYETTE,2/21/2020,0,0,0,0
FAYETTE,2/22/2020,0,0,0,0
FAYETTE,2/23/2020,1,0,0,1
FAYETTE,2/24/2020,1,0,0,1
FAYETTE,2/25/2020,1,0,0,1
FAYETTE,2/26/2020,1,0,0,1
FAYETTE,2/27/2020,1,0,0,1
FAYETTE,2/28/2020,1,0,0,1
FAYETTE,2/29/2020,1,1,0,2
FAYETTE,3/1/2020,2,2,0,4
FAYETTE,3/2/2020,2,2,0,4
FAYETTE,3/3/2020,2,2,0,4
FAYETTE,3/4/2020,2,2,0,4
FAYETTE,3/5/2020,2,2,0,4
FAYETTE,3/6/2020,2,3,0,5
FAYETTE,3/7/2020,2,3,0,5
FAYETTE,3/8/2020,2,4,0,6
FAYETTE,3/9/2020,3,4,0,7
FAYETTE,3/10/2020,3,5,0,8
FAYETTE,3/11/2020,3,6,0,9
FAYETTE,3/12/2020,6,7,0,13
FAYETTE,3/13/2020,10,9,0,19
FAYETTE,3/14/2020,12,9,0,21
FAYETTE,3/15/2020,13,12,0,25
FAYETTE,3/16/2020,15,14,0,29
FAYETTE,3/17/2020,16,17,0,33
FAYETTE,3/18/2020,19,22,0,41
FAYETTE,3/19/2020,20,23,0,43
FAYETTE,3/20/2020,28,24,0,52
FAYETTE,3/21/2020,31,25,0,56
FAYETTE,3/22/2020,34,25,0,59
FAYETTE,3/23/2020,37,26,0,63
FAYETTE,3/24/2020,38,29,0,67
FAYETTE,3/25/2020,39,29,0,68
FAYETTE,3/26/2020,42,30,0,72
FAYETTE,3/27/2020,46,32,0,78
FAYETTE,3/28/2020,47,34,0,81
FAYETTE,3/29/2020,49,36,0,85
FAYETTE,3/30/2020,55,40,0,95
FAYETTE,3/31/2020,57,41,0,98
FAYETTE,4/1/2020,59,43,0,102
FAYETTE,4/2/2020,63,45,0,108
FAYETTE,4/3/2020,65,48,0,113
FAYETTE,4/4/2020,66,48,0,114
FAYETTE,4/5/2020,68,49,0,117
FAYETTE,4/6/2020,69,50,0,119
FAYETTE,4/7/2020,71,53,0,124
FAYETTE,4/8/2020,73,54,0,127
FAYETTE,4/9/2020,74,55,0,129
FAYETTE,4/10/2020,76,57,0,133
FAYETTE,4/11/2020,78,58,0,136
FAYETTE,4/12/2020,79,58,0,137
FAYETTE,4/13/2020,81,60,0,141
FAYETTE,4/14/2020,83,62,0,145
FAYETTE,4/15/2020,84,64,0,148
FAYETTE,4/16/2020,86,64,0,150
FAYETTE,4/17/2020,87,65,0,152
FAYETTE,4/18/2020,87,67,0,154
FAYETTE,4/19/2020,88,67,0,155
FAYETTE,4/20/2020,90,69,0,159
FAYETTE,4/21/2020,92,69,0,161
FAYETTE,4/22/2020,93,72,0,165
FAYETTE,4/23/2020,94,73,0,167
FAYETTE,4/24/2020,97,76,0,173
FAYETTE,4/25/2020,97,76,0,173
FAYETTE,4/26/2020,97,76,0,173
FAYETTE,4/27/2020,99,76,0,175
FAYETTE,4/28/2020,101,78,0,179
FAYETTE,4/29/2020,103,81,0,184
FAYETTE,4/30/2020,105,81,0,186
FAYETTE,5/1/2020,108,81,0,189
HARRIS,2/10/2020,0,0,0,0
HOUSTON,5/26/2020,240,163,1,404
FLOYD,8/16/2020,1169,953,32,2154
HARRIS,2/11/2020,0,0,0,0
HOUSTON,5/27/2020,241,164,1,406
FLOYD,8/17/2020,1185,967,36,2188
HARRIS,2/12/2020,0,0,0,0
HOUSTON,5/28/2020,243,168,1,412
FAYETTE,5/3/2020,108,81,0,189
HARRIS,2/13/2020,0,0,0,0
FLOYD,8/18/2020,1200,985,36,2221
HOUSTON,5/29/2020,247,169,1,417
FAYETTE,5/4/2020,111,84,0,195
HARRIS,2/14/2020,0,0,0,0
FLOYD,8/19/2020,1215,1000,36,2251
HOUSTON,5/30/2020,248,169,1,418
FAYETTE,5/5/2020,113,85,0,198
HARRIS,2/15/2020,0,0,0,0
HARRIS,2/16/2020,0,0,0,0
HARRIS,2/17/2020,0,0,0,0
HARRIS,2/18/2020,0,0,0,0
HARRIS,2/19/2020,0,0,0,0
HARRIS,2/20/2020,0,0,0,0
HARRIS,2/21/2020,0,0,0,0
HARRIS,2/22/2020,0,0,0,0
HARRIS,2/23/2020,0,0,0,0
HARRIS,2/24/2020,0,0,0,0
HARRIS,2/25/2020,0,0,0,0
HARRIS,2/26/2020,0,0,0,0
HARRIS,2/27/2020,0,0,0,0
HARRIS,2/28/2020,0,0,0,0
HARRIS,2/29/2020,0,0,0,0
HARRIS,3/1/2020,1,0,0,1
HARRIS,3/2/2020,1,0,0,1
HARRIS,3/3/2020,1,0,0,1
HARRIS,3/4/2020,1,0,0,1
HARRIS,3/5/2020,1,0,0,1
HARRIS,3/6/2020,1,0,0,1
HARRIS,3/7/2020,1,0,0,1
HARRIS,3/8/2020,1,0,0,1
HARRIS,3/9/2020,1,0,0,1
HARRIS,3/10/2020,1,0,0,1
HARRIS,3/11/2020,1,0,0,1
HARRIS,3/12/2020,1,0,0,1
HARRIS,3/13/2020,1,0,0,1
HARRIS,3/14/2020,2,0,0,2
HARRIS,3/15/2020,4,1,0,5
HARRIS,3/16/2020,5,2,0,7
HARRIS,3/17/2020,5,2,0,7
HARRIS,3/18/2020,5,2,0,7
HARRIS,3/19/2020,5,3,0,8
HARRIS,3/20/2020,5,6,0,11
HARRIS,3/21/2020,6,6,0,12
HARRIS,3/22/2020,6,6,0,12
HARRIS,3/23/2020,6,6,0,12
HARRIS,3/24/2020,6,7,0,13
HARRIS,3/25/2020,8,7,0,15
HARRIS,3/26/2020,10,7,0,17
HARRIS,3/27/2020,10,7,0,17
HARRIS,3/28/2020,11,7,0,18
HARRIS,3/29/2020,11,9,0,20
HARRIS,3/30/2020,12,11,0,23
HARRIS,3/31/2020,13,13,0,26
HARRIS,4/1/2020,13,14,0,27
HARRIS,4/2/2020,13,14,0,27
HARRIS,4/3/2020,15,14,0,29
HARRIS,4/4/2020,15,15,0,30
HARRIS,4/5/2020,15,15,0,30
HARRIS,4/6/2020,17,16,0,33
HARRIS,4/7/2020,17,17,0,34
HARRIS,4/8/2020,18,18,0,36
HARRIS,4/9/2020,18,18,0,36
HARRIS,4/10/2020,19,19,0,38
HARRIS,4/11/2020,20,19,0,39
HARRIS,4/12/2020,21,20,0,41
HARRIS,4/13/2020,22,20,0,42
HARRIS,4/14/2020,24,23,0,47
HARRIS,4/15/2020,28,24,0,52
HARRIS,4/16/2020,29,24,0,53
HARRIS,4/17/2020,29,26,0,55
HARRIS,4/18/2020,30,26,0,56
HARRIS,4/19/2020,30,26,0,56
HARRIS,4/20/2020,31,29,0,60
HARRIS,4/21/2020,31,30,0,61
HARRIS,4/22/2020,31,31,0,62
HARRIS,4/23/2020,31,31,0,62
HARRIS,4/24/2020,32,31,0,63
HARRIS,4/25/2020,32,31,0,63
HARRIS,4/26/2020,32,31,0,63
HARRIS,4/27/2020,32,32,0,64
HARRIS,4/28/2020,32,32,0,64
HARRIS,4/29/2020,32,32,0,64
HARRIS,4/30/2020,32,32,0,64
HARRIS,5/1/2020,32,32,0,64
HARRIS,5/2/2020,32,32,0,64
HARRIS,5/3/2020,32,32,0,64
HARRIS,5/4/2020,32,33,0,65
HARRIS,5/5/2020,33,33,0,66
HARRIS,5/6/2020,34,34,0,68
HARRIS,5/7/2020,35,35,0,70
HARRIS,5/8/2020,35,35,0,70
HARRIS,5/9/2020,35,36,0,71
HARRIS,5/10/2020,36,36,0,72
HARRIS,5/11/2020,36,38,0,74
HARRIS,5/12/2020,36,39,0,75
HARRIS,5/13/2020,39,39,0,78
HARRIS,5/14/2020,40,39,0,79
HARRIS,5/15/2020,42,40,0,82
HARRIS,5/16/2020,42,41,0,83
HARRIS,5/17/2020,42,43,0,85
HARRIS,5/18/2020,44,43,0,87
HARRIS,5/19/2020,44,45,0,89
HARRIS,5/20/2020,44,46,0,90
HARRIS,5/21/2020,44,46,0,90
HARRIS,5/22/2020,44,47,0,91
HARRIS,5/23/2020,45,47,0,92
HARRIS,5/24/2020,47,48,0,95
HARRIS,5/25/2020,48,50,0,98
HARRIS,5/26/2020,49,52,0,101
HARRIS,5/27/2020,52,54,0,106
HARRIS,5/28/2020,53,55,0,108
HARRIS,5/29/2020,62,82,0,144
HARRIS,5/30/2020,69,84,0,153
HARRIS,5/31/2020,72,90,0,162
HARRIS,6/1/2020,77,94,0,171
HARRIS,6/2/2020,82,98,0,180
HARRIS,6/3/2020,86,98,0,184
HARRIS,6/4/2020,94,102,0,196
HARRIS,6/5/2020,96,104,0,200
HARRIS,6/6/2020,98,105,0,203
HARRIS,6/7/2020,99,105,0,204
HARRIS,6/8/2020,102,108,0,210
HARRIS,6/9/2020,106,113,2,221
HARRIS,6/10/2020,108,117,2,227
HARRIS,6/11/2020,112,121,2,235
HARRIS,6/12/2020,116,128,2,246
HARRIS,6/13/2020,118,129,2,249
HARRIS,6/14/2020,121,132,2,255
HARRIS,6/15/2020,126,134,2,262
HARRIS,6/16/2020,130,137,2,269
HARRIS,6/17/2020,132,140,2,274
HARRIS,6/18/2020,134,142,3,279
HARRIS,6/19/2020,145,145,4,294
HARRIS,6/20/2020,146,151,4,301
HARRIS,6/21/2020,157,154,4,315
HARRIS,6/22/2020,162,164,4,330
HARRIS,6/23/2020,176,169,4,349
HARRIS,6/24/2020,184,173,4,361
HARRIS,6/25/2020,190,179,5,374
HARRIS,6/26/2020,200,184,5,389
HARRIS,6/27/2020,205,187,5,397
HARRIS,6/28/2020,210,191,5,406
HARRIS,6/29/2020,219,194,5,418
HARRIS,6/30/2020,224,199,5,428
HARRIS,7/1/2020,226,203,5,434
HARRIS,7/2/2020,231,208,5,444
HARRIS,7/3/2020,238,214,5,457
HARRIS,7/4/2020,244,219,5,468
HARRIS,7/5/2020,249,224,5,478
HARRIS,7/6/2020,254,229,5,488
HARRIS,7/7/2020,265,236,6,507
HARRIS,7/8/2020,271,240,6,517
HARRIS,7/9/2020,279,246,6,531
HARRIS,7/10/2020,287,251,6,544
HARRIS,7/11/2020,294,253,6,553
HARRIS,7/12/2020,297,260,6,563
HARRIS,7/13/2020,300,262,6,568
HARRIS,7/14/2020,307,264,6,577
HARRIS,7/15/2020,308,271,6,585
HARRIS,7/16/2020,312,272,6,590
HARRIS,7/17/2020,318,275,6,599
HARRIS,7/18/2020,320,278,6,604
HARRIS,7/19/2020,324,278,6,608
HARRIS,7/20/2020,332,280,6,618
HARRIS,7/21/2020,335,281,6,622
HARRIS,7/22/2020,338,284,6,628
HARRIS,7/23/2020,344,287,6,637
HARRIS,7/24/2020,347,288,6,641
HARRIS,7/25/2020,348,290,6,644
HARRIS,7/26/2020,349,291,6,646
HARRIS,7/27/2020,354,297,7,658
HARRIS,7/28/2020,355,301,7,663
HARRIS,7/29/2020,359,303,7,669
HARRIS,7/30/2020,363,306,7,676
HARRIS,7/31/2020,365,309,7,681
HARRIS,8/1/2020,366,310,7,683
HARRIS,8/2/2020,367,313,7,687
HARRIS,8/3/2020,368,313,7,688
HARRIS,8/4/2020,371,314,7,692
HARRIS,8/5/2020,373,314,7,694
HARRIS,8/6/2020,375,315,7,697
HARRIS,8/7/2020,376,316,7,699
HARRIS,8/8/2020,377,316,7,700
HARRIS,8/9/2020,381,316,7,704
HARRIS,8/10/2020,381,318,7,706
HARRIS,8/11/2020,385,319,7,711
HARRIS,8/12/2020,386,323,7,716
HARRIS,8/13/2020,388,323,7,718
HARRIS,8/14/2020,389,325,7,721
HARRIS,8/15/2020,390,326,7,723
HARRIS,8/16/2020,391,327,7,725
HARRIS,8/17/2020,391,327,7,725
HARRIS,8/18/2020,393,327,7,727
HARRIS,8/19/2020,394,328,7,729
HARRIS,8/20/2020,395,328,7,730
HARRIS,8/21/2020,396,329,8,733
HARRIS,8/22/2020,397,330,8,735
HARRIS,8/23/2020,398,330,8,736
HARRIS,8/24/2020,398,330,8,736
HARRIS,8/25/2020,400,332,8,740
HARRIS,8/26/2020,400,334,8,742
HARRIS,8/27/2020,403,334,8,745
HARRIS,8/28/2020,403,336,8,747
HARRIS,8/29/2020,403,338,8,749
HARRIS,8/30/2020,403,339,8,750
HARRIS,8/31/2020,404,339,8,751
HARRIS,9/1/2020,406,341,8,755
HARRIS,9/2/2020,410,344,8,762
HARRIS,9/3/2020,413,345,8,766
HARRIS,9/4/2020,414,348,8,770
HARRIS,9/5/2020,414,349,8,771
HARRIS,9/6/2020,415,349,8,772
HARRIS,9/7/2020,416,350,8,774
HARRIS,9/8/2020,416,351,8,775
HARRIS,9/9/2020,417,352,8,777
HARRIS,9/10/2020,418,354,8,780
HARRIS,9/11/2020,420,356,8,784
HARRIS,9/12/2020,421,356,8,785
HARRIS,9/13/2020,422,356,8,786
HARRIS,9/14/2020,425,357,8,790
HARRIS,9/15/2020,425,358,8,791
HARRIS,9/16/2020,426,359,8,793
HARRIS,9/17/2020,427,359,8,794
HARRIS,9/18/2020,427,359,8,794
HARRIS,9/19/2020,428,359,8,795
HARRIS,9/20/2020,429,359,8,796
HARRIS,9/21/2020,431,360,8,799
HARRIS,9/22/2020,431,360,8,799
HARRIS,9/23/2020,431,360,8,799
HARRIS,9/24/2020,433,360,8,801
HARRIS,9/25/2020,434,360,8,802
HARRIS,9/26/2020,434,361,8,803
HARRIS,9/27/2020,435,362,8,805
HARRIS,9/28/2020,437,363,8,808
HARRIS,9/29/2020,437,363,8,808
HARRIS,9/30/2020,440,364,8,812
HARRIS,10/1/2020,440,364,8,812
HARRIS,10/2/2020,441,366,8,815
HARRIS,10/3/2020,442,366,8,816
HARRIS,10/4/2020,442,367,8,817
HARRIS,10/5/2020,442,367,8,817
HARRIS,10/6/2020,442,369,8,819
HARRIS,10/7/2020,444,369,8,821
HARRIS,10/8/2020,445,370,8,823
HARRIS,10/9/2020,447,370,8,825
HARRIS,10/10/2020,448,370,8,826
HARRIS,10/11/2020,448,371,8,827
HARRIS,10/12/2020,452,372,8,832
HARRIS,10/13/2020,452,373,8,833
HARRIS,10/14/2020,452,375,8,835
HARRIS,10/15/2020,453,375,8,836
HARRIS,10/16/2020,454,376,8,838
HARRIS,10/17/2020,454,376,8,838
HARRIS,10/18/2020,454,376,8,838
HARRIS,10/19/2020,456,376,8,840
HARRIS,10/20/2020,456,376,8,840
HOUSTON,1/1/2020,0,0,0,0
HOUSTON,1/2/2020,0,0,0,0
HOUSTON,1/3/2020,0,0,0,0
HOUSTON,1/4/2020,0,0,0,0
HOUSTON,1/5/2020,0,0,0,0
HOUSTON,1/6/2020,0,0,0,0
HOUSTON,1/7/2020,0,0,0,0
HOUSTON,1/8/2020,0,0,0,0
HOUSTON,1/9/2020,0,0,0,0
HOUSTON,1/10/2020,0,0,0,0
HOUSTON,1/11/2020,0,0,0,0
HOUSTON,1/12/2020,0,0,0,0
HOUSTON,1/13/2020,0,0,0,0
HOUSTON,1/14/2020,0,0,0,0
HOUSTON,1/15/2020,0,0,0,0
HOUSTON,1/16/2020,0,0,0,0
HOUSTON,1/17/2020,0,0,0,0
HOUSTON,1/18/2020,0,0,0,0
HOUSTON,1/19/2020,0,0,0,0
HOUSTON,1/20/2020,0,0,0,0
HOUSTON,1/21/2020,0,0,0,0
HOUSTON,1/22/2020,0,0,0,0
HOUSTON,1/23/2020,0,0,0,0
HOUSTON,1/24/2020,0,0,0,0
HOUSTON,1/25/2020,0,0,0,0
HOUSTON,1/26/2020,0,0,0,0
HOUSTON,1/27/2020,0,0,0,0
HOUSTON,1/28/2020,0,0,0,0
HOUSTON,1/29/2020,0,0,0,0
HOUSTON,1/30/2020,0,0,0,0
HOUSTON,1/31/2020,0,0,0,0
HOUSTON,2/1/2020,0,0,0,0
HOUSTON,2/2/2020,0,0,0,0
HOUSTON,2/3/2020,0,0,0,0
HOUSTON,2/4/2020,0,0,0,0
HOUSTON,2/5/2020,0,0,0,0
HOUSTON,2/6/2020,0,0,0,0
HOUSTON,2/7/2020,0,0,0,0
HOUSTON,2/8/2020,0,0,0,0
HOUSTON,2/9/2020,0,0,0,0
HOUSTON,2/10/2020,0,0,0,0
HOUSTON,2/11/2020,0,0,0,0
HOUSTON,2/12/2020,0,0,0,0
HOUSTON,2/13/2020,0,0,0,0
HOUSTON,2/14/2020,0,0,0,0
HOUSTON,2/15/2020,0,0,0,0
HOUSTON,2/16/2020,0,0,0,0
HOUSTON,2/17/2020,0,0,0,0
HOUSTON,2/18/2020,0,0,0,0
HOUSTON,2/19/2020,0,0,0,0
HOUSTON,2/20/2020,0,0,0,0
HOUSTON,2/21/2020,0,0,0,0
HOUSTON,2/22/2020,0,0,0,0
HOUSTON,2/23/2020,0,0,0,0
HOUSTON,2/24/2020,0,0,0,0
HOUSTON,2/25/2020,0,0,0,0
HOUSTON,2/26/2020,0,0,0,0
HOUSTON,2/27/2020,0,0,0,0
HOUSTON,2/28/2020,0,0,0,0
HOUSTON,2/29/2020,0,0,0,0
HOUSTON,3/1/2020,0,0,0,0
HOUSTON,3/2/2020,0,0,0,0
HOUSTON,3/3/2020,0,0,0,0
HOUSTON,3/4/2020,0,1,0,1
HOUSTON,3/5/2020,0,1,0,1
HOUSTON,3/6/2020,0,1,0,1
HOUSTON,3/7/2020,0,1,0,1
HOUSTON,3/8/2020,0,1,0,1
HOUSTON,3/9/2020,1,2,0,3
HOUSTON,3/10/2020,1,3,0,4
HOUSTON,3/11/2020,1,4,0,5
HOUSTON,3/12/2020,1,6,0,7
HOUSTON,3/13/2020,4,7,0,11
HOUSTON,3/14/2020,4,7,0,11
HOUSTON,3/15/2020,5,9,0,14
HOUSTON,3/16/2020,9,13,0,22
HOUSTON,3/17/2020,12,14,0,26
HOUSTON,3/18/2020,15,15,0,30
HOUSTON,3/19/2020,20,20,0,40
HOUSTON,3/20/2020,22,22,0,44
HOUSTON,3/21/2020,28,22,0,50
HOUSTON,3/22/2020,31,24,0,55
HOUSTON,3/23/2020,34,25,0,59
HOUSTON,3/24/2020,39,26,0,65
HOUSTON,3/25/2020,41,28,0,69
HOUSTON,3/26/2020,44,29,0,73
HOUSTON,3/27/2020,48,29,0,77
HOUSTON,3/28/2020,55,30,0,85
HOUSTON,3/29/2020,61,32,0,93
HOUSTON,3/30/2020,64,33,0,97
HOUSTON,3/31/2020,67,35,0,102
HOUSTON,4/1/2020,69,42,0,111
HOUSTON,4/2/2020,72,46,0,118
HOUSTON,4/3/2020,76,55,0,131
HOUSTON,4/4/2020,81,56,0,137
HOUSTON,4/5/2020,84,58,0,142
HOUSTON,4/6/2020,87,62,0,149
HOUSTON,4/7/2020,88,64,0,152
HOUSTON,4/8/2020,92,65,0,157
HOUSTON,4/9/2020,98,67,0,165
HOUSTON,4/10/2020,106,69,0,175
HOUSTON,4/11/2020,107,70,0,177
HOUSTON,4/12/2020,110,71,0,181
HOUSTON,4/13/2020,114,71,0,185
HOUSTON,4/14/2020,117,71,0,188
HOUSTON,4/15/2020,121,71,0,192
HOUSTON,4/16/2020,123,73,0,196
HOUSTON,4/17/2020,132,81,0,213
HOUSTON,4/18/2020,134,82,0,216
HOUSTON,4/19/2020,135,86,0,221
HOUSTON,4/20/2020,138,88,0,226
HOUSTON,4/21/2020,140,89,0,229
HOUSTON,4/22/2020,141,91,0,232
HOUSTON,4/23/2020,144,92,0,236
HOUSTON,4/24/2020,146,93,0,239
HOUSTON,4/25/2020,147,94,0,241
HOUSTON,4/26/2020,153,95,0,248
HOUSTON,4/27/2020,156,98,0,254
HOUSTON,4/28/2020,160,100,0,260
HOUSTON,4/29/2020,162,101,0,263
HOUSTON,4/30/2020,170,105,1,276
HOUSTON,5/1/2020,171,109,1,281
HOUSTON,5/2/2020,175,109,1,285
HOUSTON,5/3/2020,176,109,1,286
HOUSTON,5/4/2020,178,111,1,290
HOUSTON,5/5/2020,179,114,1,294
HOUSTON,5/6/2020,183,114,1,298
HOUSTON,5/7/2020,185,115,1,301
HOUSTON,5/8/2020,189,125,1,315
HOUSTON,5/9/2020,191,127,1,319
HOUSTON,5/10/2020,191,134,1,326
HOUSTON,5/11/2020,199,140,1,340
HOUSTON,5/12/2020,201,140,1,342
HOUSTON,5/13/2020,204,142,1,347
HOUSTON,5/14/2020,204,143,1,348
HOUSTON,5/15/2020,207,146,1,354
HOUSTON,5/16/2020,209,148,1,358
HOUSTON,5/17/2020,209,148,1,358
HOUSTON,5/18/2020,209,149,1,359
HOUSTON,5/19/2020,213,151,1,365
HOUSTON,5/20/2020,215,152,1,368
HOUSTON,5/21/2020,216,153,1,370
HOUSTON,5/22/2020,219,154,1,374
HOUSTON,5/23/2020,222,155,1,378
HOUSTON,5/24/2020,222,155,1,378
HOUSTON,5/25/2020,232,158,1,391
FLOYD,8/20/2020,1228,1016,36,2280
HOUSTON,5/31/2020,248,169,1,418
HOUSTON,6/1/2020,252,171,1,424
FAYETTE,5/6/2020,113,86,0,199
FLOYD,8/21/2020,1245,1035,36,2316
HOUSTON,6/2/2020,255,174,1,430
FAYETTE,5/7/2020,115,86,0,201
FAYETTE,5/8/2020,115,87,0,202
FAYETTE,5/9/2020,115,87,0,202
FAYETTE,5/10/2020,119,88,0,207
FAYETTE,5/11/2020,121,89,0,210
FAYETTE,5/12/2020,122,91,0,213
FAYETTE,5/13/2020,126,93,0,219
FAYETTE,5/14/2020,127,95,0,222
FAYETTE,5/15/2020,128,102,0,230
FAYETTE,5/16/2020,128,103,0,231
FAYETTE,5/17/2020,128,103,0,231
FAYETTE,5/18/2020,128,103,0,231
FAYETTE,5/19/2020,129,106,0,235
FAYETTE,5/20/2020,129,107,0,236
FAYETTE,5/21/2020,129,110,0,239
FAYETTE,5/22/2020,129,111,0,240
FAYETTE,5/23/2020,129,111,0,240
FAYETTE,5/24/2020,129,113,0,242
FAYETTE,5/25/2020,129,113,0,242
FAYETTE,5/26/2020,129,113,0,242
FAYETTE,5/27/2020,130,113,0,243
FAYETTE,5/28/2020,131,113,0,244
FAYETTE,5/29/2020,132,115,0,247
FAYETTE,5/30/2020,133,117,0,250
FAYETTE,5/31/2020,133,117,0,250
FAYETTE,6/1/2020,135,117,0,252
FAYETTE,6/2/2020,138,119,0,257
FAYETTE,6/3/2020,139,119,0,258
FAYETTE,6/4/2020,139,120,0,259
FAYETTE,6/5/2020,141,121,0,262
FAYETTE,6/6/2020,141,122,0,263
FAYETTE,6/7/2020,142,123,0,265
FAYETTE,6/8/2020,144,127,0,271
FAYETTE,6/9/2020,144,130,0,274
FAYETTE,6/10/2020,144,131,0,275
FAYETTE,6/11/2020,145,132,0,277
FAYETTE,6/12/2020,149,137,0,286
FAYETTE,6/13/2020,150,138,0,288
FAYETTE,6/14/2020,152,139,0,291
FAYETTE,6/15/2020,157,146,0,303
FAYETTE,6/16/2020,162,147,0,309
FAYETTE,6/17/2020,164,153,0,317
FAYETTE,6/18/2020,168,155,0,323
FAYETTE,6/19/2020,173,159,0,332
FAYETTE,6/20/2020,177,159,0,336
FAYETTE,6/21/2020,178,161,0,339
FAYETTE,6/22/2020,186,167,0,353
FAYETTE,6/23/2020,192,173,0,365
FAYETTE,6/24/2020,203,178,0,381
FAYETTE,6/25/2020,211,184,0,395
FAYETTE,6/26/2020,221,192,0,413
FAYETTE,6/27/2020,225,198,0,423
FAYETTE,6/28/2020,230,199,0,429
FAYETTE,6/29/2020,250,205,1,456
FAYETTE,6/30/2020,262,219,2,483
FAYETTE,7/1/2020,276,227,3,506
FAYETTE,7/2/2020,304,241,6,551
FAYETTE,7/3/2020,314,256,6,576
FAYETTE,7/4/2020,318,257,6,581
FAYETTE,7/5/2020,326,263,6,595
FAYETTE,7/6/2020,351,278,7,636
FAYETTE,7/7/2020,370,291,7,668
FAYETTE,7/8/2020,389,303,7,699
FAYETTE,7/9/2020,409,330,9,748
FAYETTE,7/10/2020,428,344,9,781
FAYETTE,7/11/2020,434,354,9,797
FAYETTE,7/12/2020,435,359,9,803
FAYETTE,7/13/2020,463,374,12,849
FAYETTE,7/14/2020,479,380,13,872
FAYETTE,7/15/2020,493,391,13,897
FAYETTE,7/16/2020,513,398,14,925
FAYETTE,7/17/2020,530,413,15,958
FAYETTE,7/18/2020,531,417,15,963
FAYETTE,7/19/2020,536,425,15,976
FAYETTE,7/20/2020,547,446,16,1009
FAYETTE,7/21/2020,567,460,16,1043
FAYETTE,7/22/2020,584,469,16,1069
FAYETTE,7/23/2020,593,480,16,1089
FAYETTE,7/24/2020,609,489,16,1114
FAYETTE,7/25/2020,614,495,16,1125
FAYETTE,7/26/2020,619,499,16,1134
FAYETTE,7/27/2020,627,516,16,1159
FAYETTE,7/28/2020,638,532,18,1188
FAYETTE,7/29/2020,648,542,18,1208
FAYETTE,7/30/2020,661,556,19,1236
FAYETTE,7/31/2020,667,558,19,1244
FAYETTE,8/1/2020,672,558,19,1249
FAYETTE,8/2/2020,676,564,19,1259
FAYETTE,8/3/2020,696,571,19,1286
FAYETTE,8/4/2020,707,585,19,1311
FAYETTE,8/5/2020,726,600,19,1345
FAYETTE,8/6/2020,737,617,19,1373
FAYETTE,8/7/2020,755,634,19,1408
FAYETTE,8/8/2020,758,644,19,1421
FAYETTE,8/9/2020,769,650,19,1438
FAYETTE,8/10/2020,776,663,19,1458
FAYETTE,8/11/2020,784,670,19,1473
FAYETTE,8/12/2020,792,678,19,1489
FAYETTE,8/13/2020,797,682,19,1498
FAYETTE,8/14/2020,810,692,19,1521
FAYETTE,8/15/2020,817,697,19,1533
FAYETTE,8/16/2020,823,702,19,1544
FAYETTE,8/17/2020,834,709,19,1562
FAYETTE,8/18/2020,842,718,19,1579
FAYETTE,8/19/2020,852,724,19,1595
FAYETTE,8/20/2020,859,730,19,1608
FAYETTE,8/21/2020,862,733,19,1614
FAYETTE,8/22/2020,867,734,19,1620
FAYETTE,8/23/2020,873,736,19,1628
FAYETTE,8/24/2020,884,746,19,1649
FAYETTE,8/25/2020,890,757,19,1666
FAYETTE,8/26/2020,898,761,19,1678
FAYETTE,8/27/2020,906,768,20,1694
FAYETTE,8/28/2020,912,777,20,1709
FAYETTE,8/29/2020,913,780,20,1713
FAYETTE,8/30/2020,918,787,20,1725
FAYETTE,8/31/2020,925,792,20,1737
FAYETTE,9/1/2020,928,796,20,1744
FAYETTE,9/2/2020,930,799,20,1749
FAYETTE,9/3/2020,934,802,20,1756
FAYETTE,9/4/2020,938,809,20,1767
FAYETTE,9/5/2020,944,812,20,1776
FAYETTE,9/6/2020,947,812,20,1779
FAYETTE,9/7/2020,948,814,20,1782
FAYETTE,9/8/2020,953,815,20,1788
FAYETTE,9/9/2020,961,817,20,1798
FAYETTE,9/10/2020,965,822,20,1807
FAYETTE,9/11/2020,972,826,20,1818
FAYETTE,9/12/2020,976,829,20,1825
FAYETTE,9/13/2020,977,829,20,1826
FAYETTE,9/14/2020,984,834,20,1838
FAYETTE,9/15/2020,988,840,21,1849
FAYETTE,9/16/2020,992,843,21,1856
FAYETTE,9/17/2020,995,847,21,1863
FAYETTE,9/18/2020,1003,851,21,1875
FAYETTE,9/19/2020,1007,855,21,1883
FAYETTE,9/20/2020,1009,856,21,1886
FAYETTE,9/21/2020,1011,861,21,1893
FAYETTE,9/22/2020,1019,868,21,1908
FAYETTE,9/23/2020,1027,870,21,1918
FAYETTE,9/24/2020,1031,874,21,1926
FAYETTE,9/25/2020,1039,879,21,1939
FAYETTE,9/26/2020,1043,880,21,1944
FAYETTE,9/27/2020,1046,881,21,1948
FAYETTE,9/28/2020,1050,885,21,1956
FAYETTE,9/29/2020,1053,888,21,1962
FAYETTE,9/30/2020,1054,891,21,1966
FAYETTE,10/1/2020,1058,892,21,1971
FAYETTE,10/2/2020,1061,896,21,1978
FAYETTE,10/3/2020,1063,898,21,1982
FAYETTE,10/4/2020,1066,900,21,1987
FAYETTE,10/5/2020,1069,903,21,1993
FAYETTE,10/6/2020,1072,904,21,1997
FAYETTE,10/7/2020,1077,907,21,2005
FAYETTE,10/8/2020,1081,909,21,2011
FAYETTE,10/9/2020,1087,910,21,2018
FAYETTE,10/10/2020,1089,910,21,2020
FAYETTE,10/11/2020,1090,912,21,2023
FAYETTE,10/12/2020,1091,912,21,2024
FAYETTE,10/13/2020,1097,915,21,2033
FAYETTE,10/14/2020,1099,918,21,2038
FAYETTE,10/15/2020,1105,922,21,2048
FAYETTE,10/16/2020,1110,927,21,2058
FAYETTE,10/17/2020,1111,928,21,2060
FAYETTE,10/18/2020,1111,929,21,2061
FAYETTE,10/19/2020,1111,930,21,2062
FAYETTE,10/20/2020,1111,930,21,2062
FLOYD,1/1/2020,0,0,0,0
FLOYD,1/2/2020,0,0,0,0
FLOYD,1/3/2020,0,0,0,0
FLOYD,1/4/2020,0,0,0,0
FLOYD,1/5/2020,0,0,0,0
FLOYD,1/6/2020,0,0,0,0
FLOYD,1/7/2020,0,0,0,0
FLOYD,1/8/2020,0,0,0,0
FLOYD,1/9/2020,0,0,0,0
FLOYD,1/10/2020,0,0,0,0
FLOYD,1/11/2020,0,0,0,0
FLOYD,1/12/2020,0,0,0,0
FLOYD,1/13/2020,0,0,0,0
FLOYD,1/14/2020,0,0,0,0
FLOYD,1/15/2020,0,0,0,0
FLOYD,1/16/2020,0,0,0,0
FLOYD,1/17/2020,0,0,0,0
FLOYD,1/18/2020,0,0,0,0
FLOYD,1/19/2020,0,0,0,0
FLOYD,1/20/2020,0,0,0,0
FLOYD,1/21/2020,0,0,0,0
FLOYD,1/22/2020,0,0,0,0
FLOYD,1/23/2020,0,0,0,0
FLOYD,1/24/2020,0,0,0,0
FLOYD,1/25/2020,0,0,0,0
FLOYD,1/26/2020,0,0,0,0
FLOYD,1/27/2020,0,0,0,0
FLOYD,1/28/2020,0,0,0,0
FLOYD,1/29/2020,0,0,0,0
FLOYD,1/30/2020,0,0,0,0
FLOYD,1/31/2020,0,0,0,0
FLOYD,2/1/2020,0,0,0,0
FLOYD,2/2/2020,0,0,0,0
FLOYD,2/3/2020,0,0,0,0
FLOYD,2/4/2020,0,0,0,0
FLOYD,2/5/2020,0,0,0,0
FLOYD,2/6/2020,0,0,0,0
FLOYD,2/7/2020,0,0,0,0
FLOYD,2/8/2020,0,0,0,0
FLOYD,2/9/2020,0,0,0,0
FLOYD,2/10/2020,0,0,0,0
FLOYD,2/11/2020,0,0,0,0
FLOYD,2/12/2020,0,0,0,0
FLOYD,2/13/2020,0,0,0,0
FLOYD,2/14/2020,0,0,0,0
FLOYD,2/15/2020,0,0,0,0
FLOYD,2/16/2020,0,0,0,0
FLOYD,2/17/2020,0,0,0,0
FLOYD,2/18/2020,0,0,0,0
FLOYD,2/19/2020,0,0,0,0
FLOYD,2/20/2020,0,0,0,0
FLOYD,2/21/2020,0,0,0,0
FLOYD,2/22/2020,0,1,0,1
FLOYD,2/23/2020,0,1,0,1
FLOYD,2/24/2020,0,1,0,1
FLOYD,2/25/2020,0,1,0,1
FLOYD,2/26/2020,0,1,0,1
FLOYD,2/27/2020,0,1,0,1
FLOYD,2/28/2020,0,1,0,1
FLOYD,2/29/2020,0,1,0,1
FLOYD,3/1/2020,1,2,0,3
FLOYD,3/2/2020,1,2,0,3
FLOYD,3/3/2020,1,2,0,3
FLOYD,3/4/2020,1,2,0,3
FLOYD,3/5/2020,1,3,0,4
FLOYD,3/6/2020,2,3,0,5
FLOYD,3/7/2020,3,3,0,6
FLOYD,3/8/2020,4,4,0,8
FLOYD,3/9/2020,5,4,0,9
FLOYD,3/10/2020,7,4,0,11
FLOYD,3/11/2020,7,4,0,11
FLOYD,3/12/2020,7,4,0,11
FLOYD,3/13/2020,8,6,0,14
FLOYD,3/14/2020,8,7,0,15
FLOYD,3/15/2020,9,8,0,17
FLOYD,3/16/2020,11,11,0,22
FLOYD,3/17/2020,13,11,0,24
FLOYD,3/18/2020,16,12,0,28
FLOYD,3/19/2020,17,14,0,31
FLOYD,3/20/2020,19,16,0,35
FLOYD,3/21/2020,23,17,0,40
FLOYD,3/22/2020,26,18,0,44
FLOYD,3/23/2020,28,21,0,49
FLOYD,3/24/2020,34,25,0,59
FLOYD,3/25/2020,39,28,0,67
FLOYD,3/26/2020,45,32,0,77
FLOYD,3/27/2020,53,33,0,86
FLOYD,3/28/2020,53,34,0,87
FLOYD,3/29/2020,58,35,0,93
FLOYD,3/30/2020,64,35,0,99
FLOYD,3/31/2020,66,36,0,102
FLOYD,4/1/2020,71,38,0,109
FLOYD,4/2/2020,72,38,0,110
FLOYD,4/3/2020,72,42,0,114
FLOYD,4/4/2020,73,43,0,116
FLOYD,4/5/2020,76,43,0,119
FLOYD,4/6/2020,77,43,0,120
FLOYD,4/7/2020,78,44,0,122
FLOYD,4/8/2020,81,46,0,127
FLOYD,4/9/2020,81,46,0,127
FLOYD,4/10/2020,83,47,0,130
FLOYD,4/11/2020,83,47,0,130
FLOYD,4/12/2020,83,48,0,131
FLOYD,4/13/2020,85,48,0,133
FLOYD,4/14/2020,86,48,0,134
FLOYD,4/15/2020,86,48,0,134
FLOYD,4/16/2020,87,48,0,135
FLOYD,4/17/2020,87,49,0,136
FLOYD,4/18/2020,87,51,0,138
FLOYD,4/19/2020,87,51,0,138
FLOYD,4/20/2020,89,51,0,140
FLOYD,4/21/2020,91,52,0,143
FLOYD,4/22/2020,93,53,0,146
FLOYD,4/23/2020,94,54,0,148
FLOYD,4/24/2020,95,54,0,149
FLOYD,4/25/2020,97,54,0,151
FLOYD,4/26/2020,98,55,0,153
FLOYD,4/27/2020,104,58,0,162
FLOYD,4/28/2020,109,58,0,167
FLOYD,4/29/2020,110,58,1,169
FLOYD,4/30/2020,111,60,2,173
FLOYD,5/1/2020,111,63,2,176
FLOYD,5/2/2020,111,63,2,176
FLOYD,5/3/2020,112,64,2,178
FLOYD,5/4/2020,114,65,2,181
FLOYD,5/5/2020,115,65,2,182
FLOYD,5/6/2020,117,67,2,186
FLOYD,5/7/2020,120,67,2,189
FLOYD,5/8/2020,120,69,2,191
FLOYD,5/9/2020,120,69,2,191
FLOYD,5/10/2020,120,69,2,191
FLOYD,5/11/2020,122,74,2,198
FLOYD,5/12/2020,122,77,2,201
FLOYD,5/13/2020,129,84,2,215
FLOYD,5/14/2020,137,92,2,231
FLOYD,5/15/2020,138,94,2,234
FLOYD,5/16/2020,139,95,2,236
FLOYD,5/17/2020,140,95,2,237
FLOYD,5/18/2020,144,96,2,242
FLOYD,5/19/2020,146,96,2,244
FLOYD,5/20/2020,149,100,2,251
FLOYD,5/21/2020,152,100,2,254
FLOYD,5/22/2020,154,103,2,259
FLOYD,5/23/2020,155,103,2,260
FLOYD,5/24/2020,156,104,2,262
FLOYD,5/25/2020,157,105,2,264
FLOYD,5/26/2020,161,109,2,272
FLOYD,5/27/2020,162,112,2,276
FLOYD,5/28/2020,165,118,2,285
FLOYD,5/29/2020,175,122,2,299
FLOYD,5/30/2020,179,122,2,303
FLOYD,5/31/2020,179,122,2,303
FLOYD,6/1/2020,190,122,2,314
FLOYD,6/2/2020,200,131,2,333
FLOYD,6/3/2020,208,135,2,345
FLOYD,6/4/2020,214,136,2,352
FLOYD,6/5/2020,219,143,2,364
FLOYD,6/6/2020,224,144,2,370
FLOYD,6/7/2020,227,144,2,373
FLOYD,6/8/2020,235,156,2,393
FLOYD,6/9/2020,237,158,2,397
FLOYD,6/10/2020,237,159,2,398
FLOYD,6/11/2020,239,162,2,403
FLOYD,6/12/2020,247,168,3,418
FLOYD,6/13/2020,249,170,3,422
FLOYD,6/14/2020,251,173,3,427
FLOYD,6/15/2020,258,183,3,444
FLOYD,6/16/2020,265,187,3,455
FLOYD,6/17/2020,271,195,3,469
FLOYD,6/18/2020,277,201,3,481
FLOYD,6/19/2020,279,205,3,487
FLOYD,6/20/2020,292,212,3,507
FLOYD,6/21/2020,294,215,3,512
FLOYD,6/22/2020,309,223,4,536
FLOYD,6/23/2020,314,230,4,548
FLOYD,6/24/2020,325,240,4,569
FLOYD,6/25/2020,333,248,5,586
FLOYD,6/26/2020,344,252,5,601
FLOYD,6/27/2020,351,257,5,613
FLOYD,6/28/2020,358,266,5,629
FLOYD,6/29/2020,384,278,5,667
FLOYD,6/30/2020,399,290,9,698
FLOYD,7/1/2020,419,301,9,729
FLOYD,7/2/2020,433,318,9,760
FLOYD,7/3/2020,441,329,9,779
FLOYD,7/4/2020,453,335,9,797
FLOYD,7/5/2020,457,340,9,806
FLOYD,7/6/2020,478,368,10,856
FLOYD,7/7/2020,492,389,11,892
FLOYD,7/8/2020,507,401,13,921
FLOYD,7/9/2020,526,417,13,956
FLOYD,7/10/2020,539,426,13,978
FLOYD,7/11/2020,549,436,13,998
FLOYD,7/12/2020,559,449,15,1023
FLOYD,7/13/2020,578,465,16,1059
FLOYD,7/14/2020,605,497,16,1118
FLOYD,7/15/2020,626,514,16,1156
FLOYD,7/16/2020,637,528,17,1182
FLOYD,7/17/2020,656,542,17,1215
FLOYD,7/18/2020,662,551,18,1231
FLOYD,7/19/2020,678,557,19,1254
FLOYD,7/20/2020,694,579,19,1292
FLOYD,7/21/2020,704,587,19,1310
FLOYD,7/22/2020,719,603,19,1341
FLOYD,7/23/2020,736,619,19,1374
FLOYD,7/24/2020,759,632,19,1410
FLOYD,7/25/2020,767,640,19,1426
FLOYD,7/26/2020,779,644,19,1442
FLOYD,7/27/2020,796,662,20,1478
FLOYD,7/28/2020,811,681,22,1514
FLOYD,7/29/2020,821,694,24,1539
FLOYD,7/30/2020,832,707,24,1563
FLOYD,7/31/2020,846,720,24,1590
FLOYD,8/1/2020,859,727,24,1610
FLOYD,8/2/2020,869,736,24,1629
FLOYD,8/3/2020,885,750,24,1659
FLOYD,8/4/2020,907,772,24,1703
FLOYD,8/5/2020,934,789,25,1748
FLOYD,8/6/2020,952,798,27,1777
FLOYD,8/7/2020,980,824,27,1831
FLOYD,8/8/2020,1004,834,28,1866
FLOYD,8/9/2020,1023,843,29,1895
FLOYD,8/10/2020,1051,873,30,1954
FLOYD,8/11/2020,1074,894,30,1998
FLOYD,8/12/2020,1104,911,31,2046
FLOYD,8/13/2020,1121,925,32,2078
FLOYD,8/14/2020,1147,939,32,2118
FLOYD,8/15/2020,1161,949,32,2142
HOUSTON,6/3/2020,256,176,1,433
HOUSTON,6/4/2020,260,176,1,437
HOUSTON,6/5/2020,263,178,1,442
FLOYD,8/22/2020,1251,1046,36,2333
HOUSTON,6/6/2020,265,184,1,450
FLOYD,8/23/2020,1263,1050,36,2349
FLOYD,8/24/2020,1277,1065,37,2379
FLOYD,8/25/2020,1292,1082,37,2411
FLOYD,8/26/2020,1307,1092,37,2436
FLOYD,8/27/2020,1324,1110,37,2471
FLOYD,8/28/2020,1337,1124,38,2499
FLOYD,8/29/2020,1350,1129,38,2517
FLOYD,8/30/2020,1358,1134,39,2531
FLOYD,8/31/2020,1379,1158,39,2576
FLOYD,9/1/2020,1394,1180,39,2613
FLOYD,9/2/2020,1416,1197,39,2652
FLOYD,9/3/2020,1427,1212,39,2678
FLOYD,9/4/2020,1443,1227,39,2709
FLOYD,9/5/2020,1460,1233,39,2732
FLOYD,9/6/2020,1469,1237,39,2745
FLOYD,9/7/2020,1478,1244,39,2761
FLOYD,9/8/2020,1497,1264,39,2800
FLOYD,9/9/2020,1510,1286,39,2835
FLOYD,9/10/2020,1526,1309,39,2874
FLOYD,9/11/2020,1553,1326,41,2920
FLOYD,9/12/2020,1568,1341,41,2950
FLOYD,9/13/2020,1580,1354,41,2975
FLOYD,9/14/2020,1599,1379,42,3020
FLOYD,9/15/2020,1621,1394,42,3057
FLOYD,9/16/2020,1640,1402,42,3084
FLOYD,9/17/2020,1652,1407,42,3101
FLOYD,9/18/2020,1674,1418,42,3134
FLOYD,9/19/2020,1685,1429,42,3156
FLOYD,9/20/2020,1698,1442,42,3182
FLOYD,9/21/2020,1715,1460,43,3218
FLOYD,9/22/2020,1724,1471,43,3238
FLOYD,9/23/2020,1733,1481,43,3257
FLOYD,9/24/2020,1742,1494,43,3279
FLOYD,9/25/2020,1752,1498,43,3293
FLOYD,9/26/2020,1759,1501,43,3303
FLOYD,9/27/2020,1767,1507,44,3318
FLOYD,9/28/2020,1776,1518,44,3338
FLOYD,9/29/2020,1782,1521,44,3347
FLOYD,9/30/2020,1786,1528,44,3358
FLOYD,10/1/2020,1800,1535,44,3379
FLOYD,10/2/2020,1811,1546,44,3401
FLOYD,10/3/2020,1815,1557,44,3416
FLOYD,10/4/2020,1820,1558,44,3422
FLOYD,10/5/2020,1835,1568,44,3447
FLOYD,10/6/2020,1841,1580,45,3466
FLOYD,10/7/2020,1856,1594,45,3495
FLOYD,10/8/2020,1874,1608,45,3527
FLOYD,10/9/2020,1894,1614,45,3553
FLOYD,10/10/2020,1898,1619,45,3562
FLOYD,10/11/2020,1905,1625,45,3575
FLOYD,10/12/2020,1911,1639,45,3595
FLOYD,10/13/2020,1918,1645,45,3608
FLOYD,10/14/2020,1932,1655,45,3632
FLOYD,10/15/2020,1935,1660,45,3640
FLOYD,10/16/2020,1942,1668,45,3655
FLOYD,10/17/2020,1944,1676,45,3665
FLOYD,10/18/2020,1946,1676,45,3667
FLOYD,10/19/2020,1946,1676,45,3667
FLOYD,10/20/2020,1946,1676,45,3667
HALL,1/1/2020,0,0,0,0
HALL,1/2/2020,0,0,0,0
HALL,1/3/2020,0,0,0,0
HALL,1/4/2020,0,0,0,0
HALL,1/5/2020,0,0,0,0
HALL,1/6/2020,0,0,0,0
HALL,1/7/2020,0,0,0,0
HALL,1/8/2020,0,0,0,0
HALL,1/9/2020,0,0,0,0
HALL,1/10/2020,0,0,0,0
HALL,1/11/2020,0,0,0,0
HALL,1/12/2020,0,0,0,0
HALL,1/13/2020,0,0,0,0
HALL,1/14/2020,0,0,0,0
HALL,1/15/2020,0,0,0,0
HALL,1/16/2020,0,0,0,0
HALL,1/17/2020,0,0,0,0
HALL,1/18/2020,0,0,0,0
HALL,1/19/2020,0,0,0,0
HALL,1/20/2020,0,0,0,0
HALL,1/21/2020,0,0,0,0
HALL,1/22/2020,0,0,0,0
HALL,1/23/2020,0,0,0,0
HALL,1/24/2020,0,0,0,0
HALL,1/25/2020,0,0,0,0
HALL,1/26/2020,0,0,0,0
HALL,1/27/2020,0,0,0,0
HALL,1/28/2020,0,0,0,0
HALL,1/29/2020,0,0,0,0
HALL,1/30/2020,0,0,0,0
HALL,1/31/2020,0,0,0,0
HALL,2/1/2020,0,0,0,0
HALL,2/2/2020,0,0,0,0
HALL,2/3/2020,0,0,0,0
HALL,2/4/2020,0,0,0,0
HALL,2/5/2020,0,0,0,0
HALL,2/6/2020,0,0,0,0
HALL,2/7/2020,0,0,0,0
HALL,2/8/2020,0,0,0,0
HALL,2/9/2020,0,0,0,0
HALL,2/10/2020,1,0,0,1
HALL,2/11/2020,1,0,0,1
HALL,2/12/2020,1,0,0,1
HALL,2/13/2020,1,0,0,1
HALL,2/14/2020,1,0,0,1
HALL,2/15/2020,1,0,0,1
HALL,2/16/2020,1,0,0,1
HALL,2/17/2020,1,0,0,1
HALL,2/18/2020,1,0,0,1
HALL,2/19/2020,1,0,0,1
HALL,2/20/2020,1,0,0,1
HALL,2/21/2020,2,0,0,2
HALL,2/22/2020,2,0,0,2
HALL,2/23/2020,2,0,0,2
HALL,2/24/2020,2,0,0,2
HALL,2/25/2020,2,0,0,2
HALL,2/26/2020,2,0,0,2
HALL,2/27/2020,2,0,0,2
HALL,2/28/2020,2,0,0,2
HALL,2/29/2020,2,0,0,2
HALL,3/1/2020,4,1,0,5
HALL,3/2/2020,4,1,0,5
HALL,3/3/2020,4,1,0,5
HALL,3/4/2020,4,1,0,5
HALL,3/5/2020,5,2,0,7
HALL,3/6/2020,6,2,0,8
HALL,3/7/2020,6,2,0,8
HALL,3/8/2020,6,3,0,9
HALL,3/9/2020,6,4,0,10
HALL,3/10/2020,8,5,0,13
HALL,3/11/2020,8,5,0,13
HALL,3/12/2020,9,8,0,17
HALL,3/13/2020,11,8,0,19
HALL,3/14/2020,14,8,0,22
HALL,3/15/2020,15,11,0,26
HALL,3/16/2020,16,13,0,29
HALL,3/17/2020,19,14,0,33
HALL,3/18/2020,21,17,0,38
HALL,3/19/2020,24,20,0,44
HALL,3/20/2020,28,24,0,52
HALL,3/21/2020,28,27,0,55
HALL,3/22/2020,30,27,0,57
HALL,3/23/2020,38,31,0,69
HALL,3/24/2020,42,34,0,76
HALL,3/25/2020,47,40,0,87
HALL,3/26/2020,52,49,0,101
HALL,3/27/2020,57,51,0,108
HALL,3/28/2020,60,60,0,120
HALL,3/29/2020,61,63,0,124
HALL,3/30/2020,68,76,0,144
HALL,3/31/2020,86,90,0,176
HALL,4/1/2020,97,115,0,212
HALL,4/2/2020,120,136,0,256
HALL,4/3/2020,133,153,0,286
HALL,4/4/2020,147,164,0,311
HALL,4/5/2020,164,181,0,345
HALL,4/6/2020,197,206,0,403
HALL,4/7/2020,218,232,0,450
HALL,4/8/2020,253,264,0,517
HALL,4/9/2020,289,296,0,585
HALL,4/10/2020,320,323,0,643
HALL,4/11/2020,358,352,0,710
HALL,4/12/2020,376,363,0,739
HALL,4/13/2020,409,382,0,791
HALL,4/14/2020,441,421,0,862
HALL,4/15/2020,485,445,0,930
HALL,4/16/2020,514,473,0,987
HALL,4/17/2020,565,497,1,1063
HALL,4/18/2020,585,515,1,1101
HALL,4/19/2020,681,593,1,1275
HALL,4/20/2020,722,628,1,1351
HALL,4/21/2020,746,647,5,1398
HALL,4/22/2020,786,666,6,1458
HALL,4/23/2020,820,701,7,1528
HALL,4/24/2020,860,735,8,1603
HALL,4/25/2020,875,751,8,1634
HALL,4/26/2020,890,766,9,1665
HALL,4/27/2020,914,798,9,1721
HALL,4/28/2020,1021,889,11,1921
HALL,4/29/2020,1035,903,12,1950
HALL,4/30/2020,1047,917,12,1976
HALL,5/1/2020,1071,938,12,2021
HALL,5/2/2020,1083,954,12,2049
HALL,5/3/2020,1089,960,12,2061
HALL,5/4/2020,1103,979,12,2094
HALL,5/5/2020,1111,989,12,2112
HALL,5/6/2020,1123,1007,12,2142
HALL,5/7/2020,1132,1016,12,2160
HALL,5/8/2020,1144,1023,12,2179
HALL,5/9/2020,1156,1035,12,2203
HALL,5/10/2020,1159,1039,12,2210
HALL,5/11/2020,1171,1048,12,2231
HALL,5/12/2020,1185,1053,12,2250
HALL,5/13/2020,1193,1073,12,2278
HALL,5/14/2020,1199,1084,13,2296
HALL,5/15/2020,1215,1104,13,2332
HALL,5/16/2020,1223,1111,13,2347
HALL,5/17/2020,1235,1118,13,2366
HALL,5/18/2020,1245,1133,13,2391
HALL,5/19/2020,1259,1145,13,2417
HALL,5/20/2020,1275,1155,13,2443
HALL,5/21/2020,1282,1162,13,2457
HALL,5/22/2020,1304,1206,13,2523
HALL,5/23/2020,1312,1211,13,2536
HALL,5/24/2020,1317,1214,13,2544
HALL,5/25/2020,1328,1224,13,2565
HALL,5/26/2020,1334,1228,13,2575
HALL,5/27/2020,1343,1238,13,2594
HALL,5/28/2020,1353,1243,13,2609
HALL,5/29/2020,1359,1252,13,2624
HALL,5/30/2020,1366,1270,13,2649
HALL,5/31/2020,1371,1272,13,2656
HALL,6/1/2020,1389,1289,13,2691
HALL,6/2/2020,1410,1301,13,2724
HALL,6/3/2020,1419,1314,13,2746
HALL,6/4/2020,1431,1330,13,2774
HALL,6/5/2020,1448,1340,13,2801
HALL,6/6/2020,1457,1350,13,2820
HALL,6/7/2020,1463,1356,13,2832
HALL,6/8/2020,1474,1370,13,2857
HALL,6/9/2020,1482,1378,13,2873
HALL,6/10/2020,1500,1387,14,2901
HALL,6/11/2020,1509,1406,15,2930
HALL,6/12/2020,1520,1421,15,2956
HALL,6/13/2020,1541,1434,15,2990
HALL,6/14/2020,1559,1444,15,3018
HALL,6/15/2020,1581,1458,15,3054
HALL,6/16/2020,1605,1474,15,3094
HALL,6/17/2020,1623,1491,15,3129
HALL,6/18/2020,1635,1512,15,3162
HALL,6/19/2020,1657,1521,16,3194
HALL,6/20/2020,1671,1541,16,3228
HALL,6/21/2020,1688,1551,16,3255
HALL,6/22/2020,1720,1579,16,3315
HALL,6/23/2020,1733,1601,18,3352
HALL,6/24/2020,1751,1618,21,3390
HALL,6/25/2020,1788,1652,27,3467
HALL,6/26/2020,1818,1687,31,3536
HALL,6/27/2020,1839,1713,37,3589
HALL,6/28/2020,1866,1733,39,3638
HALL,6/29/2020,1907,1770,41,3718
HALL,6/30/2020,1937,1813,46,3796
HALL,7/1/2020,1988,1844,48,3880
HALL,7/2/2020,2042,1888,52,3982
HALL,7/3/2020,2069,1919,55,4043
HALL,7/4/2020,2098,1938,57,4093
HALL,7/5/2020,2135,1978,59,4172
HALL,7/6/2020,2208,2062,64,4334
HALL,7/7/2020,2277,2128,75,4480
HALL,7/8/2020,2337,2181,80,4598
HALL,7/9/2020,2419,2236,86,4741
HALL,7/10/2020,2487,2295,88,4870
HALL,7/11/2020,2542,2336,89,4967
HALL,7/12/2020,2588,2376,94,5058
HALL,7/13/2020,2653,2441,100,5194
HALL,7/14/2020,2716,2493,108,5317
HALL,7/15/2020,2760,2548,116,5424
HALL,7/16/2020,2819,2606,124,5549
HALL,7/17/2020,2873,2654,128,5655
HALL,7/18/2020,2932,2700,129,5761
HALL,7/19/2020,2967,2737,132,5836
HALL,7/20/2020,3034,2795,138,5967
HALL,7/21/2020,3090,2848,142,6080
HALL,7/22/2020,3133,2902,145,6180
HALL,7/23/2020,3189,2951,149,6289
HALL,7/24/2020,3248,3001,150,6399
HALL,7/25/2020,3299,3033,150,6482
HALL,7/26/2020,3329,3064,151,6544
HALL,7/27/2020,3403,3115,156,6674
HALL,7/28/2020,3453,3169,165,6787
HALL,7/29/2020,3503,3208,168,6879
HALL,7/30/2020,3552,3255,174,6981
HALL,7/31/2020,3605,3298,180,7083
HALL,8/1/2020,3657,3325,181,7163
HALL,8/2/2020,3691,3354,181,7226
HALL,8/3/2020,3740,3395,182,7317
HALL,8/4/2020,3788,3441,185,7414
HALL,8/5/2020,3838,3483,186,7507
HALL,8/6/2020,3877,3515,187,7579
HALL,8/7/2020,3914,3553,188,7655
HALL,8/8/2020,3943,3577,188,7708
HALL,8/9/2020,3971,3596,188,7755
HALL,8/10/2020,4010,3626,188,7824
HALL,8/11/2020,4038,3656,188,7882
HALL,8/12/2020,4069,3694,188,7951
HALL,8/13/2020,4106,3722,188,8016
HALL,8/14/2020,4127,3748,188,8063
HALL,8/15/2020,4154,3777,188,8119
HALL,8/16/2020,4171,3794,188,8153
HALL,8/17/2020,4195,3813,188,8196
HALL,8/18/2020,4226,3832,189,8247
HALL,8/19/2020,4244,3864,190,8298
HALL,8/20/2020,4273,3903,190,8366
HALL,8/21/2020,4300,3927,190,8417
HALL,8/22/2020,4321,3944,190,8455
HALL,8/23/2020,4338,3954,190,8482
HALL,8/24/2020,4370,3983,190,8543
HALL,8/25/2020,4390,4005,190,8585
HALL,8/26/2020,4408,4023,190,8621
HALL,8/27/2020,4434,4041,190,8665
HALL,8/28/2020,4455,4052,190,8697
HALL,8/29/2020,4469,4065,190,8724
HALL,8/30/2020,4484,4073,190,8747
HALL,8/31/2020,4505,4097,190,8792
HALL,9/1/2020,4524,4112,190,8826
HALL,9/2/2020,4540,4126,190,8856
HALL,9/3/2020,4564,4147,190,8901
HALL,9/4/2020,4584,4163,191,8938
HALL,9/5/2020,4602,4179,192,8973
HALL,9/6/2020,4614,4193,192,8999
HALL,9/7/2020,4635,4212,192,9039
HALL,9/8/2020,4654,4236,193,9083
HALL,9/9/2020,4680,4246,193,9119
HALL,9/10/2020,4698,4258,193,9149
HALL,9/11/2020,4725,4274,193,9192
HALL,9/12/2020,4752,4287,193,9232
HALL,9/13/2020,4767,4300,193,9260
HALL,9/14/2020,4785,4318,193,9296
HALL,9/15/2020,4803,4334,193,9330
HALL,9/16/2020,4815,4349,194,9358
HALL,9/17/2020,4836,4367,195,9398
HALL,9/18/2020,4855,4390,195,9440
HALL,9/19/2020,4872,4403,195,9470
HALL,9/20/2020,4886,4417,195,9498
HALL,9/21/2020,4911,4438,195,9544
HALL,9/22/2020,4937,4458,196,9591
HALL,9/23/2020,4967,4477,196,9640
HALL,9/24/2020,4995,4501,196,9692
HALL,9/25/2020,5015,4512,196,9723
HALL,9/26/2020,5026,4529,196,9751
HALL,9/27/2020,5038,4537,196,9771
HALL,9/28/2020,5057,4552,196,9805
HALL,9/29/2020,5077,4564,196,9837
HALL,9/30/2020,5099,4579,196,9874
HALL,10/1/2020,5120,4594,196,9910
HALL,10/2/2020,5149,4616,196,9961
HALL,10/3/2020,5162,4635,196,9993
HALL,10/4/2020,5176,4658,196,10030
HALL,10/5/2020,5192,4673,197,10062
HALL,10/6/2020,5208,4690,197,10095
HALL,10/7/2020,5221,4711,197,10129
HALL,10/8/2020,5242,4730,197,10169
HALL,10/9/2020,5263,4748,197,10208
HALL,10/10/2020,5279,4762,197,10238
HALL,10/11/2020,5285,4771,197,10253
HALL,10/12/2020,5298,4794,197,10289
HALL,10/13/2020,5309,4809,197,10315
HALL,10/14/2020,5328,4823,197,10348
HALL,10/15/2020,5346,4839,197,10382
HALL,10/16/2020,5353,4850,197,10400
HALL,10/17/2020,5357,4855,199,10411
HALL,10/18/2020,5358,4858,199,10415
HALL,10/19/2020,5358,4858,199,10415
HALL,10/20/2020,5358,4858,199,10415
HARRIS,1/1/2020,0,0,0,0
HARRIS,1/2/2020,0,0,0,0
HARRIS,1/3/2020,0,0,0,0
HARRIS,1/4/2020,0,0,0,0
HARRIS,1/5/2020,0,0,0,0
HARRIS,1/6/2020,0,0,0,0
HARRIS,1/7/2020,0,0,0,0
HARRIS,1/8/2020,0,0,0,0
HARRIS,1/9/2020,0,0,0,0
HARRIS,1/10/2020,0,0,0,0
HARRIS,1/11/2020,0,0,0,0
HARRIS,1/12/2020,0,0,0,0
HARRIS,1/13/2020,0,0,0,0
HARRIS,1/14/2020,0,0,0,0
HARRIS,1/15/2020,0,0,0,0
HARRIS,1/16/2020,0,0,0,0
HARRIS,1/17/2020,0,0,0,0
HARRIS,1/18/2020,0,0,0,0
HARRIS,1/19/2020,0,0,0,0
HARRIS,1/20/2020,0,0,0,0
HARRIS,1/21/2020,0,0,0,0
HARRIS,1/22/2020,0,0,0,0
HARRIS,1/23/2020,0,0,0,0
HARRIS,1/24/2020,0,0,0,0
HARRIS,1/25/2020,0,0,0,0
HARRIS,1/26/2020,0,0,0,0
HARRIS,1/27/2020,0,0,0,0
HARRIS,1/28/2020,0,0,0,0
HARRIS,1/29/2020,0,0,0,0
HARRIS,1/30/2020,0,0,0,0
HARRIS,1/31/2020,0,0,0,0
HARRIS,2/1/2020,0,0,0,0
HARRIS,2/2/2020,0,0,0,0
HARRIS,2/3/2020,0,0,0,0
HARRIS,2/4/2020,0,0,0,0
HARRIS,2/5/2020,0,0,0,0
HARRIS,2/6/2020,0,0,0,0
HARRIS,2/7/2020,0,0,0,0
HARRIS,2/8/2020,0,0,0,0
HARRIS,2/9/2020,0,0,0,0
HOUSTON,6/7/2020,269,184,1,454
HOUSTON,6/8/2020,274,187,1,462
HOUSTON,6/9/2020,280,190,1,471
HOUSTON,6/10/2020,288,195,1,484
HOUSTON,6/11/2020,291,199,1,491
HOUSTON,6/12/2020,293,206,1,500
HOUSTON,6/13/2020,295,207,1,503
HOUSTON,6/14/2020,300,209,1,510
HOUSTON,6/15/2020,307,214,1,522
HOUSTON,6/16/2020,314,218,2,534
HOUSTON,6/17/2020,324,220,2,546
HOUSTON,6/18/2020,331,226,4,561
HOUSTON,6/19/2020,345,231,4,580
HOUSTON,6/20/2020,352,236,4,592
HOUSTON,6/21/2020,355,241,4,600
HOUSTON,6/22/2020,368,253,4,625
HOUSTON,6/23/2020,375,268,4,647
HOUSTON,6/24/2020,386,282,5,673
HOUSTON,6/25/2020,401,295,5,701
HOUSTON,6/26/2020,412,308,5,725
HOUSTON,6/27/2020,430,320,5,755
HOUSTON,6/28/2020,446,332,5,783
HOUSTON,6/29/2020,463,349,6,818
HOUSTON,6/30/2020,493,366,6,865
HOUSTON,7/1/2020,516,392,6,914
HOUSTON,7/2/2020,537,410,7,954
HOUSTON,7/3/2020,558,426,7,991
HOUSTON,7/4/2020,576,441,7,1024
HOUSTON,7/5/2020,591,455,7,1053
HOUSTON,7/6/2020,624,480,7,1111
HOUSTON,7/7/2020,656,502,7,1165
HOUSTON,7/8/2020,692,523,7,1222
HOUSTON,7/9/2020,719,546,8,1273
HOUSTON,7/10/2020,752,573,8,1333
HOUSTON,7/11/2020,772,588,9,1369
HOUSTON,7/12/2020,790,599,11,1400
HOUSTON,7/13/2020,819,626,11,1456
HOUSTON,7/14/2020,841,647,12,1500
HOUSTON,7/15/2020,860,669,14,1543
HOUSTON,7/16/2020,874,686,14,1574
HOUSTON,7/17/2020,902,712,14,1628
HOUSTON,7/18/2020,919,725,16,1660
HOUSTON,7/19/2020,929,731,16,1676
HOUSTON,7/20/2020,951,754,18,1723
HOUSTON,7/21/2020,968,766,19,1753
HOUSTON,7/22/2020,988,785,21,1794
HOUSTON,7/23/2020,1001,800,21,1822
HOUSTON,7/24/2020,1014,815,21,1850
HOUSTON,7/25/2020,1028,833,21,1882
HOUSTON,7/26/2020,1035,844,21,1900
HOUSTON,7/27/2020,1049,857,21,1927
HOUSTON,7/28/2020,1074,872,21,1967
HOUSTON,7/29/2020,1088,884,21,1993
HOUSTON,7/30/2020,1096,895,21,2012
HOUSTON,7/31/2020,1104,899,21,2024
HOUSTON,8/1/2020,1118,915,21,2054
HOUSTON,8/2/2020,1126,923,21,2070
HOUSTON,8/3/2020,1147,937,21,2105
HOUSTON,8/4/2020,1164,951,21,2136
HOUSTON,8/5/2020,1187,960,22,2169
HOUSTON,8/6/2020,1196,975,22,2193
HOUSTON,8/7/2020,1213,987,22,2222
HOUSTON,8/8/2020,1228,997,22,2247
HOUSTON,8/9/2020,1238,1005,22,2265
HOUSTON,8/10/2020,1260,1024,22,2306
HOUSTON,8/11/2020,1280,1042,22,2344
HOUSTON,8/12/2020,1300,1052,22,2374
HOUSTON,8/13/2020,1323,1067,22,2412
HOUSTON,8/14/2020,1342,1084,22,2448
HOUSTON,8/15/2020,1354,1091,22,2467
HOUSTON,8/16/2020,1367,1102,23,2492
HOUSTON,8/17/2020,1390,1118,24,2532
HOUSTON,8/18/2020,1404,1135,24,2563
HOUSTON,8/19/2020,1420,1144,24,2588
HOUSTON,8/20/2020,1430,1158,24,2612
HOUSTON,8/21/2020,1447,1165,24,2636
HOUSTON,8/22/2020,1457,1171,24,2652
HOUSTON,8/23/2020,1465,1178,24,2667
HOUSTON,8/24/2020,1484,1186,24,2694
HOUSTON,8/25/2020,1495,1194,24,2713
HOUSTON,8/26/2020,1504,1209,24,2737
HOUSTON,8/27/2020,1511,1224,24,2759
HOUSTON,8/28/2020,1523,1234,25,2782
HOUSTON,8/29/2020,1530,1241,25,2796
HOUSTON,8/30/2020,1534,1251,25,2810
HOUSTON,8/31/2020,1548,1265,25,2838
HOUSTON,9/1/2020,1565,1280,25,2870
HOUSTON,9/2/2020,1582,1288,25,2895
HOUSTON,9/3/2020,1597,1301,25,2923
HOUSTON,9/4/2020,1607,1304,25,2936
HOUSTON,9/5/2020,1616,1312,25,2953
HOUSTON,9/6/2020,1622,1317,25,2964
HOUSTON,9/7/2020,1632,1322,25,2979
HOUSTON,9/8/2020,1645,1330,25,3000
HOUSTON,9/9/2020,1653,1334,25,3012
HOUSTON,9/10/2020,1661,1341,27,3029
HOUSTON,9/11/2020,1671,1347,27,3045
HOUSTON,9/12/2020,1675,1355,27,3057
HOUSTON,9/13/2020,1680,1360,27,3067
HOUSTON,9/14/2020,1689,1368,27,3084
HOUSTON,9/15/2020,1697,1373,27,3097
HOUSTON,9/16/2020,1705,1383,27,3115
HOUSTON,9/17/2020,1708,1391,27,3126
HOUSTON,9/18/2020,1718,1396,27,3141
HOUSTON,9/19/2020,1723,1399,27,3149
HOUSTON,9/20/2020,1725,1401,27,3153
HOUSTON,9/21/2020,1731,1411,27,3169
HOUSTON,9/22/2020,1738,1417,27,3182
HOUSTON,9/23/2020,1744,1420,27,3191
HOUSTON,9/24/2020,1749,1425,27,3201
HOUSTON,9/25/2020,1753,1429,27,3209
HOUSTON,9/26/2020,1758,1429,27,3214
HOUSTON,9/27/2020,1762,1434,27,3223
HOUSTON,9/28/2020,1772,1439,27,3238
HOUSTON,9/29/2020,1775,1442,27,3244
HOUSTON,9/30/2020,1782,1448,27,3257
HOUSTON,10/1/2020,1784,1455,27,3266
HOUSTON,10/2/2020,1792,1467,27,3286
HOUSTON,10/3/2020,1796,1470,27,3293
HOUSTON,10/4/2020,1803,1474,27,3304
HOUSTON,10/5/2020,1813,1481,27,3321
HOUSTON,10/6/2020,1819,1487,27,3333
HOUSTON,10/7/2020,1827,1494,27,3348
HOUSTON,10/8/2020,1836,1497,27,3360
HOUSTON,10/9/2020,1840,1507,27,3374
HOUSTON,10/10/2020,1848,1511,27,3386
HOUSTON,10/11/2020,1854,1515,27,3396
HOUSTON,10/12/2020,1861,1523,27,3411
HOUSTON,10/13/2020,1869,1527,27,3423
HOUSTON,10/14/2020,1877,1535,27,3439
HOUSTON,10/15/2020,1883,1540,27,3450
HOUSTON,10/16/2020,1888,1545,27,3460
HOUSTON,10/17/2020,1890,1548,27,3465
HOUSTON,10/18/2020,1890,1549,27,3466
HOUSTON,10/19/2020,1891,1550,27,3468
HOUSTON,10/20/2020,1891,1550,27,3468
JASPER,1/1/2020,0,0,0,0
JASPER,1/2/2020,0,0,0,0
JASPER,1/3/2020,0,0,0,0
JASPER,1/4/2020,0,0,0,0
JASPER,1/5/2020,0,0,0,0
JASPER,1/6/2020,0,0,0,0
JASPER,1/7/2020,0,0,0,0
JASPER,1/8/2020,0,0,0,0
JASPER,1/9/2020,0,0,0,0
JASPER,1/10/2020,0,0,0,0
JASPER,1/11/2020,0,0,0,0
JASPER,1/12/2020,0,0,0,0
JASPER,1/13/2020,0,0,0,0
JASPER,1/14/2020,0,0,0,0
JASPER,1/15/2020,0,0,0,0
JASPER,1/16/2020,0,0,0,0
JASPER,1/17/2020,0,0,0,0
JASPER,1/18/2020,0,0,0,0
JASPER,1/19/2020,0,0,0,0
JASPER,1/20/2020,0,0,0,0
JASPER,1/21/2020,0,0,0,0
JASPER,1/22/2020,0,0,0,0
JASPER,1/23/2020,0,0,0,0
JASPER,1/24/2020,0,0,0,0
JASPER,1/25/2020,0,0,0,0
JASPER,1/26/2020,0,0,0,0
JASPER,1/27/2020,0,0,0,0
JASPER,1/28/2020,0,0,0,0
JASPER,1/29/2020,0,0,0,0
JASPER,1/30/2020,0,0,0,0
JASPER,1/31/2020,0,0,0,0
JASPER,2/1/2020,0,0,0,0
JASPER,2/2/2020,0,0,0,0
JASPER,2/3/2020,0,0,0,0
JASPER,2/4/2020,0,0,0,0
JASPER,2/5/2020,0,0,0,0
JASPER,2/6/2020,0,0,0,0
JASPER,2/7/2020,0,0,0,0
JASPER,2/8/2020,0,0,0,0
JASPER,2/9/2020,0,0,0,0
JASPER,2/10/2020,0,0,0,0
JASPER,2/11/2020,0,0,0,0
JASPER,2/12/2020,0,0,0,0
JASPER,2/13/2020,0,0,0,0
JASPER,2/14/2020,0,0,0,0
JASPER,2/15/2020,0,0,0,0
JASPER,2/16/2020,0,0,0,0
JASPER,2/17/2020,0,0,0,0
JASPER,2/18/2020,0,0,0,0
JASPER,2/19/2020,0,0,0,0
JASPER,2/20/2020,0,0,0,0
JASPER,2/21/2020,0,0,0,0
JASPER,2/22/2020,0,0,0,0
JASPER,2/23/2020,0,0,0,0
JASPER,2/24/2020,0,0,0,0
JASPER,2/25/2020,0,0,0,0
JASPER,2/26/2020,0,0,0,0
JASPER,2/27/2020,0,0,0,0
JASPER,2/28/2020,0,0,0,0
JASPER,2/29/2020,0,0,0,0
JASPER,3/1/2020,0,0,0,0
JASPER,3/2/2020,0,0,0,0
JASPER,3/3/2020,0,0,0,0
JASPER,3/4/2020,0,0,0,0
JASPER,3/5/2020,0,0,0,0
JASPER,3/6/2020,0,0,0,0
JASPER,3/7/2020,0,0,0,0
JASPER,3/8/2020,0,0,0,0
JASPER,3/9/2020,0,0,0,0
JASPER,3/10/2020,0,0,0,0
JASPER,3/11/2020,0,0,0,0
JASPER,3/12/2020,1,0,0,1
JASPER,3/13/2020,1,0,0,1
JASPER,3/14/2020,3,0,0,3
JASPER,3/15/2020,4,0,0,4
JASPER,3/16/2020,4,1,0,5
JASPER,3/17/2020,4,1,0,5
JASPER,3/18/2020,4,1,0,5
JASPER,3/19/2020,4,1,0,5
JASPER,3/20/2020,4,1,0,5
JASPER,3/21/2020,4,1,0,5
JASPER,3/22/2020,4,1,0,5
JASPER,3/23/2020,4,1,0,5
JASPER,3/24/2020,4,1,0,5
JASPER,3/25/2020,4,1,0,5
JASPER,3/26/2020,4,1,0,5
JASPER,3/27/2020,4,1,0,5
JASPER,3/28/2020,5,1,0,6
JASPER,3/29/2020,5,1,0,6
JASPER,3/30/2020,5,1,0,6
JASPER,3/31/2020,5,1,0,6
JASPER,4/1/2020,6,1,0,7
JASPER,4/2/2020,6,1,0,7
JASPER,4/3/2020,6,1,0,7
JASPER,4/4/2020,6,2,0,8
JASPER,4/5/2020,7,2,0,9
JASPER,4/6/2020,7,3,0,10
JASPER,4/7/2020,7,3,0,10
JASPER,4/8/2020,7,3,0,10
JASPER,4/9/2020,8,3,0,11
JASPER,4/10/2020,9,5,0,14
JASPER,4/11/2020,9,6,0,15
JASPER,4/12/2020,9,6,0,15
JASPER,4/13/2020,11,7,0,18
JASPER,4/14/2020,11,7,0,18
JASPER,4/15/2020,12,7,0,19
JASPER,4/16/2020,12,7,0,19
JASPER,4/17/2020,14,7,0,21
JASPER,4/18/2020,14,7,0,21
JASPER,4/19/2020,15,7,0,22
JASPER,4/20/2020,15,9,0,24
JASPER,4/21/2020,15,9,0,24
JASPER,4/22/2020,15,9,0,24
JASPER,4/23/2020,15,9,0,24
JASPER,4/24/2020,15,9,0,24
JASPER,4/25/2020,16,9,0,25
JASPER,4/26/2020,16,9,0,25
JASPER,4/27/2020,17,10,0,27
JASPER,4/28/2020,17,11,0,28
JASPER,4/29/2020,18,11,0,29
JASPER,4/30/2020,18,11,0,29
JASPER,5/1/2020,19,11,0,30
JASPER,5/2/2020,19,11,0,30
JASPER,5/3/2020,19,11,0,30
JASPER,5/4/2020,19,11,0,30
JASPER,5/5/2020,19,11,0,30
JASPER,5/6/2020,20,11,0,31
JASPER,5/7/2020,20,11,0,31
JASPER,5/8/2020,20,12,0,32
JASPER,5/9/2020,20,12,0,32
JASPER,5/10/2020,20,12,0,32
JASPER,5/11/2020,20,12,0,32
JASPER,5/12/2020,20,12,0,32
JASPER,5/13/2020,22,12,0,34
JASPER,5/14/2020,22,12,0,34
JASPER,5/15/2020,23,14,0,37
JASPER,5/16/2020,23,14,0,37
JASPER,5/17/2020,23,14,0,37
JASPER,5/18/2020,24,14,0,38
JASPER,5/19/2020,24,14,0,38
JASPER,5/20/2020,24,14,0,38
JASPER,5/21/2020,24,14,0,38
JASPER,5/22/2020,25,14,0,39
JASPER,5/23/2020,26,14,0,40
JASPER,5/24/2020,28,14,0,42
JASPER,5/25/2020,29,14,0,43
JASPER,5/26/2020,31,16,0,47
JASPER,5/27/2020,31,18,0,49
JASPER,5/28/2020,32,18,0,50
JASPER,5/29/2020,34,18,0,52
JASPER,5/30/2020,35,18,0,53
JASPER,5/31/2020,35,18,0,53
JASPER,6/1/2020,36,19,0,55
JASPER,6/2/2020,36,19,0,55
JASPER,6/3/2020,37,19,0,56
JASPER,6/4/2020,37,21,0,58
JASPER,6/5/2020,39,22,0,61
JASPER,6/6/2020,40,23,0,63
JASPER,6/7/2020,40,23,0,63
JASPER,6/8/2020,40,24,0,64
JASPER,6/9/2020,40,25,0,65
JASPER,6/10/2020,40,26,0,66
JASPER,6/11/2020,40,26,0,66
JASPER,6/12/2020,40,26,0,66
JASPER,6/13/2020,40,26,0,66
JASPER,6/14/2020,41,27,0,68
JASPER,6/15/2020,41,27,0,68
JASPER,6/16/2020,42,27,0,69
JASPER,6/17/2020,43,29,0,72
JASPER,6/18/2020,43,29,0,72
JASPER,6/19/2020,43,31,0,74
JASPER,6/20/2020,43,31,0,74
JASPER,6/21/2020,44,31,0,75
JASPER,6/22/2020,44,32,0,76
JASPER,6/23/2020,44,32,0,76
JASPER,6/24/2020,44,33,0,77
JASPER,6/25/2020,44,33,0,77
JASPER,6/26/2020,44,33,0,77
JASPER,6/27/2020,45,34,0,79
JASPER,6/28/2020,47,37,0,84
JASPER,6/29/2020,50,38,0,88
JASPER,6/30/2020,50,39,0,89
JASPER,7/1/2020,51,40,0,91
JASPER,7/2/2020,52,41,0,93
JASPER,7/3/2020,52,41,0,93
JASPER,7/4/2020,52,42,0,94
JASPER,7/5/2020,52,42,0,94
JASPER,7/6/2020,53,44,0,97
JASPER,7/7/2020,54,45,0,99
JASPER,7/8/2020,54,46,0,100
JASPER,7/9/2020,55,46,0,101
JASPER,7/10/2020,57,48,0,105
JASPER,7/11/2020,57,50,0,107
JASPER,7/12/2020,57,50,0,107
JASPER,7/13/2020,59,50,1,110
JASPER,7/14/2020,61,50,1,112
JASPER,7/15/2020,62,50,1,113
JASPER,7/16/2020,62,50,1,113
JASPER,7/17/2020,63,52,1,116
JASPER,7/18/2020,63,53,1,117
JASPER,7/19/2020,65,53,2,120
JASPER,7/20/2020,66,55,2,123
JASPER,7/21/2020,69,56,2,127
JASPER,7/22/2020,73,56,2,131
JASPER,7/23/2020,73,57,2,132
JASPER,7/24/2020,74,57,2,133
JASPER,7/25/2020,77,59,2,138
JASPER,7/26/2020,77,61,2,140
JASPER,7/27/2020,78,62,2,142
JASPER,7/28/2020,81,63,2,146
JASPER,7/29/2020,83,64,2,149
JASPER,7/30/2020,88,64,2,154
JASPER,7/31/2020,88,64,2,154
JASPER,8/1/2020,89,65,2,156
JASPER,8/2/2020,89,65,2,156
JASPER,8/3/2020,89,69,2,160
JASPER,8/4/2020,91,69,2,162
JASPER,8/5/2020,91,71,2,164
JASPER,8/6/2020,92,72,2,166
JASPER,8/7/2020,92,72,2,166
JASPER,8/8/2020,92,73,2,167
JASPER,8/9/2020,94,74,2,170
JASPER,8/10/2020,96,74,2,172
JASPER,8/11/2020,97,74,2,173
JASPER,8/12/2020,98,76,2,176
JASPER,8/13/2020,98,76,2,176
JASPER,8/14/2020,99,77,2,178
JASPER,8/15/2020,99,78,2,179
JASPER,8/16/2020,100,78,2,180
JASPER,8/17/2020,100,78,2,180
JASPER,8/18/2020,100,78,2,180
JASPER,8/19/2020,103,78,2,183
JASPER,8/20/2020,103,78,2,183
JASPER,8/21/2020,106,79,2,187
JASPER,8/22/2020,106,80,2,188
JASPER,8/23/2020,106,80,2,188
JASPER,8/24/2020,106,81,2,189
JASPER,8/25/2020,106,83,2,191
JASPER,8/26/2020,106,83,2,191
JASPER,8/27/2020,107,83,2,192
JASPER,8/28/2020,110,83,2,195
JASPER,8/29/2020,110,83,2,195
JASPER,8/30/2020,111,83,2,196
JASPER,8/31/2020,112,85,2,199
JASPER,9/1/2020,114,85,2,201
JASPER,9/2/2020,114,85,2,201
JASPER,9/3/2020,115,85,2,202
JASPER,9/4/2020,115,86,2,203
JASPER,9/5/2020,116,87,2,205
JASPER,9/6/2020,117,87,2,206
JASPER,9/7/2020,117,87,2,206
JASPER,9/8/2020,118,88,2,208
JOHNSON,3/5/2020,2,0,0,2
JOHNSON,3/6/2020,2,0,0,2
JOHNSON,3/7/2020,2,0,0,2
JOHNSON,3/8/2020,2,0,0,2
JOHNSON,3/9/2020,2,0,0,2
JOHNSON,3/10/2020,2,0,0,2
JOHNSON,3/11/2020,2,0,0,2
JOHNSON,3/12/2020,2,0,0,2
JOHNSON,3/13/2020,2,0,0,2
JOHNSON,3/14/2020,2,0,0,2
JOHNSON,3/15/2020,2,0,0,2
JOHNSON,3/16/2020,2,0,0,2
JOHNSON,3/17/2020,2,0,0,2
JOHNSON,3/18/2020,2,0,0,2
JOHNSON,3/19/2020,2,0,0,2
JOHNSON,3/20/2020,2,0,0,2
JOHNSON,3/21/2020,2,0,0,2
JOHNSON,3/22/2020,2,0,0,2
JOHNSON,3/23/2020,2,1,0,3
JOHNSON,3/24/2020,2,1,0,3
JOHNSON,3/25/2020,2,1,0,3
JOHNSON,3/26/2020,2,1,0,3
JOHNSON,3/27/2020,2,1,0,3
JOHNSON,3/28/2020,3,1,0,4
JOHNSON,3/29/2020,3,1,0,4
JOHNSON,3/30/2020,3,4,0,7
JOHNSON,3/31/2020,3,4,0,7
JOHNSON,4/1/2020,3,4,0,7
JOHNSON,4/2/2020,3,6,0,9
JOHNSON,4/3/2020,3,6,0,9
JOHNSON,4/4/2020,3,8,0,11
JOHNSON,4/5/2020,4,13,0,17
JOHNSON,4/6/2020,4,15,0,19
JOHNSON,4/7/2020,4,16,0,20
JOHNSON,4/8/2020,4,18,0,22
JOHNSON,4/9/2020,4,21,0,25
JOHNSON,4/10/2020,4,25,0,29
JOHNSON,4/11/2020,4,29,0,33
JOHNSON,4/12/2020,5,31,0,36
JOHNSON,4/13/2020,7,33,0,40
JOHNSON,4/14/2020,7,34,0,41
JOHNSON,4/15/2020,7,35,0,42
JOHNSON,4/16/2020,7,35,0,42
JOHNSON,4/17/2020,7,35,0,42
JOHNSON,4/18/2020,7,35,0,42
JOHNSON,4/19/2020,7,36,0,43
JOHNSON,4/20/2020,9,36,0,45
JOHNSON,4/21/2020,9,37,0,46
JOHNSON,4/22/2020,9,37,0,46
JOHNSON,4/23/2020,11,38,0,49
JOHNSON,4/24/2020,12,39,0,51
JOHNSON,4/25/2020,13,39,0,52
JOHNSON,4/26/2020,13,41,0,54
JOHNSON,4/27/2020,13,44,0,57
JOHNSON,4/28/2020,13,47,0,60
JOHNSON,4/29/2020,13,48,0,61
JOHNSON,4/30/2020,13,48,0,61
JOHNSON,5/1/2020,13,48,0,61
JOHNSON,5/2/2020,14,49,0,63
JOHNSON,5/3/2020,15,49,0,64
JOHNSON,5/4/2020,15,49,0,64
JOHNSON,5/5/2020,15,50,0,65
JOHNSON,5/6/2020,15,50,0,65
JOHNSON,5/7/2020,15,52,0,67
JOHNSON,5/8/2020,15,52,0,67
JOHNSON,5/9/2020,15,54,0,69
JOHNSON,5/10/2020,15,54,0,69
JOHNSON,5/11/2020,16,54,0,70
JOHNSON,5/12/2020,17,54,0,71
JOHNSON,5/13/2020,17,54,0,71
JOHNSON,5/14/2020,17,55,0,72
JOHNSON,5/15/2020,17,55,0,72
JOHNSON,5/16/2020,17,62,0,79
JOHNSON,5/17/2020,17,62,0,79
JOHNSON,5/18/2020,17,63,0,80
JOHNSON,5/19/2020,17,63,0,80
JOHNSON,5/20/2020,17,63,0,80
JOHNSON,5/21/2020,17,63,0,80
JOHNSON,5/22/2020,17,63,0,80
JOHNSON,5/23/2020,17,63,0,80
JOHNSON,5/24/2020,17,63,0,80
JOHNSON,5/25/2020,17,63,0,80
JOHNSON,5/26/2020,17,63,0,80
JOHNSON,5/27/2020,17,63,0,80
JOHNSON,5/28/2020,17,63,0,80
JOHNSON,5/29/2020,17,63,0,80
JOHNSON,5/30/2020,17,63,0,80
JOHNSON,5/31/2020,17,63,0,80
JOHNSON,6/1/2020,18,63,0,81
JOHNSON,6/2/2020,18,63,0,81
JOHNSON,6/3/2020,18,63,0,81
JOHNSON,6/4/2020,18,63,0,81
JOHNSON,6/5/2020,18,64,0,82
JOHNSON,6/6/2020,18,64,0,82
JOHNSON,6/7/2020,18,64,0,82
JOHNSON,6/8/2020,18,65,0,83
JOHNSON,6/9/2020,18,65,0,83
JOHNSON,6/10/2020,18,65,0,83
JOHNSON,6/11/2020,20,65,0,85
JOHNSON,6/12/2020,20,66,0,86
JOHNSON,6/13/2020,20,66,0,86
JOHNSON,6/14/2020,20,66,0,86
JOHNSON,6/15/2020,20,66,0,86
JOHNSON,6/16/2020,20,66,0,86
JOHNSON,6/17/2020,20,66,0,86
JOHNSON,6/18/2020,20,66,0,86
JOHNSON,6/19/2020,21,66,0,87
JOHNSON,6/20/2020,22,66,0,88
JOHNSON,6/21/2020,22,66,0,88
JOHNSON,6/22/2020,23,67,0,90
JOHNSON,6/23/2020,25,68,0,93
JOHNSON,6/24/2020,31,71,0,102
JOHNSON,6/25/2020,31,75,0,106
JOHNSON,6/26/2020,32,76,0,108
JOHNSON,6/27/2020,33,79,0,112
JOHNSON,6/28/2020,34,79,0,113
JOHNSON,6/29/2020,36,79,0,115
JOHNSON,6/30/2020,37,81,0,118
JOHNSON,7/1/2020,38,84,0,122
JOHNSON,7/2/2020,41,85,0,126
JOHNSON,7/3/2020,42,85,0,127
JOHNSON,7/4/2020,44,85,0,129
JOHNSON,7/5/2020,44,86,0,130
JOHNSON,7/6/2020,45,91,0,136
JOHNSON,7/7/2020,47,94,0,141
JOHNSON,7/8/2020,48,94,0,142
JOHNSON,7/9/2020,52,97,0,149
JOHNSON,7/10/2020,53,99,0,152
JOHNSON,7/11/2020,53,100,0,153
JOHNSON,7/12/2020,53,100,0,153
JOHNSON,7/13/2020,58,105,0,163
JOHNSON,7/14/2020,61,110,0,171
JOHNSON,7/15/2020,62,112,0,174
JOHNSON,7/16/2020,64,113,0,177
JOHNSON,7/17/2020,69,115,0,184
JOHNSON,7/18/2020,69,117,0,186
JOHNSON,7/19/2020,74,118,0,192
JOHNSON,7/20/2020,77,122,0,199
JOHNSON,7/21/2020,78,124,0,202
JOHNSON,7/22/2020,79,124,0,203
JOHNSON,7/23/2020,80,125,0,205
JOHNSON,7/24/2020,85,125,0,210
JOHNSON,7/25/2020,85,126,0,211
JOHNSON,7/26/2020,86,126,0,212
JOHNSON,7/27/2020,89,131,0,220
JOHNSON,7/28/2020,96,133,0,229
JOHNSON,7/29/2020,98,135,0,233
JOHNSON,7/30/2020,104,136,0,240
JOHNSON,7/31/2020,109,137,0,246
JOHNSON,8/1/2020,111,138,0,249
JOHNSON,8/2/2020,112,138,0,250
JOHNSON,8/3/2020,113,140,0,253
JOHNSON,8/4/2020,114,140,0,254
JOHNSON,8/5/2020,115,142,0,257
JOHNSON,8/6/2020,116,142,0,258
JOHNSON,8/7/2020,119,143,0,262
JOHNSON,8/8/2020,120,143,0,263
JOHNSON,8/9/2020,121,144,0,265
JOHNSON,8/10/2020,121,146,0,267
JOHNSON,8/11/2020,124,147,0,271
JOHNSON,8/12/2020,126,149,0,275
JOHNSON,8/13/2020,128,150,0,278
JOHNSON,8/14/2020,129,150,0,279
JOHNSON,8/15/2020,130,151,0,281
JOHNSON,8/16/2020,131,152,0,283
JOHNSON,8/17/2020,133,152,0,285
JOHNSON,8/18/2020,139,154,0,293
JOHNSON,8/19/2020,139,154,0,293
JOHNSON,8/20/2020,142,155,0,297
JOHNSON,8/21/2020,143,155,0,298
JOHNSON,8/22/2020,145,157,0,302
JOHNSON,8/23/2020,146,159,0,305
JOHNSON,8/24/2020,148,161,0,309
JOHNSON,8/25/2020,150,161,0,311
JOHNSON,8/26/2020,156,161,0,317
JOHNSON,8/27/2020,160,161,0,321
JOHNSON,8/28/2020,184,169,0,353
JOHNSON,8/29/2020,184,170,0,354
JOHNSON,8/30/2020,185,173,0,358
JOHNSON,8/31/2020,189,173,0,362
JOHNSON,9/1/2020,191,174,0,365
JOHNSON,9/2/2020,194,176,0,370
JOHNSON,9/3/2020,198,177,0,375
JOHNSON,9/4/2020,207,180,0,387
JOHNSON,9/5/2020,209,181,0,390
JOHNSON,9/6/2020,209,182,0,391
JOHNSON,9/7/2020,210,183,0,393
JOHNSON,9/8/2020,211,183,0,394
JOHNSON,9/9/2020,212,183,0,395
JOHNSON,9/10/2020,216,185,0,401
JOHNSON,9/11/2020,216,186,0,402
JOHNSON,9/12/2020,216,188,0,404
JOHNSON,9/13/2020,217,189,0,406
JOHNSON,9/14/2020,218,189,0,407
JOHNSON,9/15/2020,218,189,0,407
JOHNSON,9/16/2020,221,190,0,411
JOHNSON,9/17/2020,221,190,0,411
JOHNSON,9/18/2020,222,191,0,413
JOHNSON,9/19/2020,222,191,0,413
JOHNSON,9/20/2020,222,191,0,413
JOHNSON,9/21/2020,223,192,0,415
JOHNSON,9/22/2020,223,193,0,416
JOHNSON,9/23/2020,223,193,0,416
JOHNSON,9/24/2020,223,193,0,416
JOHNSON,9/25/2020,223,193,0,416
JOHNSON,9/26/2020,224,193,0,417
JOHNSON,9/27/2020,225,194,0,419
JOHNSON,9/28/2020,226,196,0,422
JOHNSON,9/29/2020,226,196,0,422
JOHNSON,9/30/2020,227,196,0,423
JOHNSON,10/1/2020,227,197,0,424
JOHNSON,10/2/2020,228,197,0,425
JOHNSON,10/3/2020,228,197,0,425
JOHNSON,10/4/2020,229,198,0,427
JOHNSON,10/5/2020,230,199,0,429
JOHNSON,10/6/2020,231,200,0,431
JOHNSON,10/7/2020,231,200,0,431
JOHNSON,10/8/2020,233,200,0,433
JOHNSON,10/9/2020,233,200,0,433
JOHNSON,10/10/2020,233,200,0,433
JOHNSON,10/11/2020,234,200,0,434
JOHNSON,10/12/2020,234,200,0,434
JOHNSON,10/13/2020,236,202,0,438
JOHNSON,10/14/2020,236,202,0,438
JOHNSON,10/15/2020,236,202,0,438
JOHNSON,10/16/2020,236,202,0,438
JOHNSON,10/17/2020,236,202,0,438
JOHNSON,10/18/2020,236,202,0,438
JOHNSON,10/19/2020,236,202,0,438
JOHNSON,10/20/2020,236,202,0,438
JONES,1/1/2020,0,0,0,0
JONES,1/2/2020,0,0,0,0
JONES,1/3/2020,0,0,0,0
JONES,1/4/2020,0,0,0,0
JONES,1/5/2020,0,0,0,0
JONES,1/6/2020,0,0,0,0
JONES,1/7/2020,0,0,0,0
JONES,1/8/2020,0,0,0,0
JONES,1/9/2020,0,0,0,0
JONES,1/10/2020,0,0,0,0
JONES,1/11/2020,0,0,0,0
JONES,1/12/2020,0,0,0,0
JONES,1/13/2020,0,0,0,0
JONES,1/14/2020,0,0,0,0
JONES,1/15/2020,0,0,0,0
JONES,1/16/2020,0,0,0,0
JONES,1/17/2020,0,0,0,0
JONES,1/18/2020,0,0,0,0
JONES,1/19/2020,0,0,0,0
JONES,1/20/2020,0,0,0,0
JONES,1/21/2020,0,0,0,0
JONES,1/22/2020,0,0,0,0
JONES,1/23/2020,0,0,0,0
JONES,1/24/2020,0,0,0,0
JONES,1/25/2020,0,0,0,0
JONES,1/26/2020,0,0,0,0
JONES,1/27/2020,0,0,0,0
JONES,1/28/2020,0,0,0,0
JONES,1/29/2020,0,0,0,0
JONES,1/30/2020,0,0,0,0
JONES,1/31/2020,0,0,0,0
JONES,2/1/2020,0,0,0,0
JONES,2/2/2020,0,0,0,0
JONES,2/3/2020,0,0,0,0
JONES,2/4/2020,0,0,0,0
JONES,2/5/2020,0,0,0,0
JONES,2/6/2020,0,0,0,0
JONES,2/7/2020,0,0,0,0
JONES,2/8/2020,0,0,0,0
JONES,2/9/2020,0,0,0,0
JONES,2/10/2020,0,0,0,0
JONES,2/11/2020,0,0,0,0
JONES,2/12/2020,0,0,0,0
JONES,2/13/2020,0,0,0,0
JONES,2/14/2020,0,0,0,0
JONES,2/15/2020,0,0,0,0
JONES,2/16/2020,0,0,0,0
JONES,2/17/2020,0,0,0,0
JONES,2/18/2020,0,0,0,0
JONES,2/19/2020,0,0,0,0
JONES,2/20/2020,0,0,0,0
JONES,2/21/2020,0,0,0,0
JONES,2/22/2020,0,0,0,0
JONES,2/23/2020,0,0,0,0
JONES,2/24/2020,0,0,0,0
JONES,2/25/2020,0,0,0,0
JONES,2/26/2020,0,0,0,0
JONES,2/27/2020,0,0,0,0
JONES,2/28/2020,0,0,0,0
JONES,2/29/2020,0,0,0,0
JONES,3/1/2020,0,0,0,0
JONES,3/2/2020,0,0,0,0
JONES,3/3/2020,0,0,0,0
JONES,3/4/2020,0,0,0,0
JONES,3/5/2020,0,0,0,0
JONES,3/6/2020,0,0,0,0
JONES,3/7/2020,0,0,0,0
JONES,3/8/2020,0,0,0,0
JONES,3/9/2020,0,0,0,0
JONES,3/10/2020,0,0,0,0
JONES,3/11/2020,0,0,0,0
JONES,3/12/2020,0,0,0,0
JONES,3/13/2020,1,0,0,1
JONES,3/14/2020,1,0,0,1
JONES,3/15/2020,1,0,0,1
JONES,3/16/2020,2,0,0,2
JONES,3/17/2020,2,0,0,2
JONES,3/18/2020,3,0,0,3
JONES,3/19/2020,3,0,0,3
JONES,3/20/2020,3,1,0,4
JONES,3/21/2020,3,1,0,4
JONES,3/22/2020,3,2,0,5
JONES,3/23/2020,3,3,0,6
JONES,3/24/2020,3,4,0,7
JONES,3/25/2020,3,5,0,8
JONES,3/26/2020,3,5,0,8
JONES,3/27/2020,3,5,0,8
JONES,3/28/2020,3,6,0,9
JONES,3/29/2020,4,6,0,10
JONES,3/30/2020,4,6,0,10
JONES,3/31/2020,4,6,0,10
JONES,4/1/2020,4,7,0,11
JONES,4/2/2020,7,7,0,14
JONES,4/3/2020,8,7,0,15
JONES,4/4/2020,8,7,0,15
JONES,4/5/2020,8,9,0,17
JONES,4/6/2020,8,9,0,17
JONES,4/7/2020,9,9,0,18
JONES,4/8/2020,9,9,0,18
JONES,4/9/2020,9,9,0,18
JONES,4/10/2020,9,9,0,18
JONES,4/11/2020,10,9,0,19
JONES,4/12/2020,10,9,0,19
JONES,4/13/2020,10,9,0,19
JONES,4/14/2020,10,9,0,19
JONES,4/15/2020,11,9,0,20
JONES,4/16/2020,13,9,0,22
JONES,4/17/2020,13,9,0,22
JONES,4/18/2020,14,9,0,23
JONES,4/19/2020,15,9,0,24
JONES,4/20/2020,18,9,0,27
JONES,4/21/2020,18,10,0,28
JONES,4/22/2020,18,10,0,28
JONES,4/23/2020,18,10,0,28
JONES,4/24/2020,18,11,0,29
JONES,4/25/2020,18,11,0,29
JONES,4/26/2020,18,11,0,29
JONES,4/27/2020,18,11,0,29
JONES,4/28/2020,18,11,0,29
JONES,4/29/2020,19,11,0,30
JONES,4/30/2020,19,11,0,30
JONES,5/1/2020,20,11,0,31
JONES,5/2/2020,20,11,0,31
JONES,5/3/2020,20,11,0,31
JONES,5/4/2020,20,11,0,31
JONES,5/5/2020,20,11,0,31
JONES,5/6/2020,20,11,0,31
JONES,5/7/2020,20,11,0,31
JONES,5/8/2020,20,11,0,31
JONES,5/9/2020,20,11,0,31
JONES,5/10/2020,20,11,0,31
JONES,5/11/2020,21,11,0,32
JONES,5/12/2020,21,11,0,32
JONES,5/13/2020,21,11,0,32
JONES,5/14/2020,21,11,0,32
JONES,5/15/2020,21,11,0,32
JONES,5/16/2020,21,11,0,32
JONES,5/17/2020,23,12,0,35
JONES,5/18/2020,23,12,0,35
JONES,5/19/2020,24,12,0,36
JONES,5/20/2020,24,12,0,36
JONES,5/21/2020,24,12,0,36
JONES,5/22/2020,24,13,0,37
JONES,5/23/2020,24,13,0,37
JONES,5/24/2020,24,13,0,37
JONES,5/25/2020,25,13,0,38
JONES,5/26/2020,25,13,0,38
JONES,5/27/2020,26,14,0,40
JONES,5/28/2020,26,14,0,40
JONES,5/29/2020,27,16,0,43
JONES,5/30/2020,27,16,0,43
JONES,5/31/2020,27,16,0,43
JONES,6/1/2020,31,16,0,47
JONES,6/2/2020,32,16,0,48
JONES,6/3/2020,34,16,0,50
JONES,6/4/2020,34,16,0,50
JONES,6/5/2020,35,16,0,51
JONES,6/6/2020,35,16,0,51
JONES,6/7/2020,35,16,0,51
JONES,6/8/2020,35,17,0,52
JONES,6/9/2020,35,17,0,52
JONES,6/10/2020,35,17,0,52
JONES,6/11/2020,35,17,0,52
JONES,6/12/2020,35,17,0,52
JONES,6/13/2020,35,17,0,52
JONES,6/14/2020,35,17,0,52
JONES,6/15/2020,35,17,0,52
JONES,6/16/2020,36,18,0,54
JONES,6/17/2020,37,20,0,57
JONES,6/18/2020,37,22,0,59
JASPER,9/9/2020,118,88,2,208
JASPER,9/10/2020,118,88,2,208
JASPER,9/11/2020,118,88,2,208
JASPER,9/12/2020,118,89,2,209
JASPER,9/13/2020,118,90,2,210
JASPER,9/14/2020,119,91,2,212
JASPER,9/15/2020,119,92,2,213
JASPER,9/16/2020,120,92,2,214
JASPER,9/17/2020,120,92,2,214
JASPER,9/18/2020,120,92,2,214
JASPER,9/19/2020,120,92,2,214
JASPER,9/20/2020,121,93,2,216
JASPER,9/21/2020,122,93,2,217
JASPER,9/22/2020,122,93,2,217
JASPER,9/23/2020,124,93,2,219
JASPER,9/24/2020,126,93,2,221
JASPER,9/25/2020,127,93,2,222
JASPER,9/26/2020,128,93,2,223
JASPER,9/27/2020,128,93,2,223
JASPER,9/28/2020,128,93,2,223
JASPER,9/29/2020,128,94,2,224
JASPER,9/30/2020,129,95,2,226
JASPER,10/1/2020,129,95,2,226
JASPER,10/2/2020,129,98,2,229
JASPER,10/3/2020,129,99,2,230
JASPER,10/4/2020,130,100,2,232
JASPER,10/5/2020,130,100,2,232
JASPER,10/6/2020,131,100,2,233
JASPER,10/7/2020,131,100,2,233
JASPER,10/8/2020,133,101,2,236
JASPER,10/9/2020,134,101,2,237
JASPER,10/10/2020,135,101,2,238
JASPER,10/11/2020,136,101,2,239
JASPER,10/12/2020,136,102,2,240
JASPER,10/13/2020,136,103,2,241
JASPER,10/14/2020,136,103,2,241
JASPER,10/15/2020,136,103,2,241
JASPER,10/16/2020,136,103,2,241
JASPER,10/17/2020,136,103,2,241
JASPER,10/18/2020,136,103,2,241
JASPER,10/19/2020,136,103,2,241
JASPER,10/20/2020,136,103,2,241
JEFF DAVIS,1/1/2020,0,0,0,0
JEFF DAVIS,1/2/2020,0,0,0,0
JEFF DAVIS,1/3/2020,0,0,0,0
JEFF DAVIS,1/4/2020,0,0,0,0
JEFF DAVIS,1/5/2020,0,0,0,0
JEFF DAVIS,1/6/2020,0,0,0,0
JEFF DAVIS,1/7/2020,0,0,0,0
JEFF DAVIS,1/8/2020,0,0,0,0
JEFF DAVIS,1/9/2020,0,0,0,0
JEFF DAVIS,1/10/2020,0,0,0,0
JEFF DAVIS,1/11/2020,0,0,0,0
JEFF DAVIS,1/12/2020,0,0,0,0
JEFF DAVIS,1/13/2020,0,0,0,0
JEFF DAVIS,1/14/2020,0,0,0,0
JEFF DAVIS,1/15/2020,0,0,0,0
JONES,6/19/2020,37,22,0,59
JEFF DAVIS,1/16/2020,0,0,0,0
JEFF DAVIS,1/17/2020,0,0,0,0
JEFF DAVIS,1/18/2020,0,0,0,0
JEFF DAVIS,1/19/2020,0,0,0,0
JEFF DAVIS,1/20/2020,0,0,0,0
JEFF DAVIS,1/21/2020,0,0,0,0
JEFF DAVIS,1/22/2020,0,0,0,0
JEFF DAVIS,1/23/2020,0,0,0,0
JEFF DAVIS,1/24/2020,0,0,0,0
JEFF DAVIS,1/25/2020,0,0,0,0
JEFF DAVIS,1/26/2020,0,0,0,0
JEFF DAVIS,1/27/2020,0,0,0,0
JEFF DAVIS,1/28/2020,0,0,0,0
JEFF DAVIS,1/29/2020,0,0,0,0
JEFF DAVIS,1/30/2020,0,0,0,0
JEFF DAVIS,1/31/2020,0,0,0,0
JEFF DAVIS,2/1/2020,0,0,0,0
JEFF DAVIS,2/2/2020,0,0,0,0
JEFF DAVIS,2/3/2020,0,0,0,0
JEFF DAVIS,2/4/2020,0,0,0,0
JEFF DAVIS,2/5/2020,0,0,0,0
JEFF DAVIS,2/6/2020,0,0,0,0
JEFF DAVIS,2/7/2020,0,0,0,0
JEFF DAVIS,2/8/2020,0,0,0,0
JEFF DAVIS,2/9/2020,0,0,0,0
JEFF DAVIS,2/10/2020,0,0,0,0
JEFF DAVIS,2/11/2020,0,0,0,0
JEFF DAVIS,2/12/2020,0,0,0,0
JEFF DAVIS,2/13/2020,0,0,0,0
JEFF DAVIS,2/14/2020,0,0,0,0
JEFF DAVIS,2/15/2020,0,0,0,0
JEFF DAVIS,2/16/2020,0,0,0,0
JEFF DAVIS,2/17/2020,0,0,0,0
JEFF DAVIS,2/18/2020,0,0,0,0
JEFF DAVIS,2/19/2020,0,0,0,0
JEFF DAVIS,2/20/2020,0,0,0,0
JEFF DAVIS,2/21/2020,0,0,0,0
JEFF DAVIS,2/22/2020,0,0,0,0
JEFF DAVIS,2/23/2020,0,0,0,0
JEFF DAVIS,2/24/2020,0,0,0,0
JEFF DAVIS,2/25/2020,0,0,0,0
JEFF DAVIS,2/26/2020,0,0,0,0
JEFF DAVIS,2/27/2020,0,0,0,0
JEFF DAVIS,2/28/2020,0,0,0,0
JEFF DAVIS,2/29/2020,0,0,0,0
JEFF DAVIS,3/1/2020,0,0,0,0
JEFF DAVIS,3/2/2020,0,0,0,0
JEFF DAVIS,3/3/2020,0,0,0,0
JEFF DAVIS,3/4/2020,0,0,0,0
JEFF DAVIS,3/5/2020,0,0,0,0
JEFF DAVIS,3/6/2020,0,0,0,0
JEFF DAVIS,3/7/2020,0,0,0,0
JEFF DAVIS,3/8/2020,0,0,0,0
JEFF DAVIS,3/9/2020,0,0,0,0
JEFF DAVIS,3/10/2020,0,0,0,0
JEFF DAVIS,3/11/2020,0,0,0,0
JEFF DAVIS,3/12/2020,0,0,0,0
JEFF DAVIS,3/13/2020,0,0,0,0
JEFF DAVIS,3/14/2020,0,0,0,0
JEFF DAVIS,3/15/2020,0,0,0,0
JEFF DAVIS,3/16/2020,0,0,0,0
JEFF DAVIS,3/17/2020,0,0,0,0
JEFF DAVIS,3/18/2020,0,0,0,0
JEFF DAVIS,3/19/2020,0,0,0,0
JEFF DAVIS,3/20/2020,0,0,0,0
JEFF DAVIS,3/21/2020,0,0,0,0
JEFF DAVIS,3/22/2020,0,0,0,0
JEFF DAVIS,3/23/2020,0,0,0,0
JEFF DAVIS,3/24/2020,0,0,0,0
JEFF DAVIS,3/25/2020,0,0,0,0
JEFF DAVIS,3/26/2020,0,0,0,0
JEFF DAVIS,3/27/2020,1,0,0,1
JEFF DAVIS,3/28/2020,1,1,0,2
JEFF DAVIS,3/29/2020,1,1,0,2
JEFF DAVIS,3/30/2020,1,1,0,2
JEFF DAVIS,3/31/2020,1,1,0,2
JEFF DAVIS,4/1/2020,1,1,0,2
JEFF DAVIS,4/2/2020,2,1,0,3
JEFF DAVIS,4/3/2020,2,1,0,3
JEFF DAVIS,4/4/2020,3,1,0,4
JEFF DAVIS,4/5/2020,3,1,0,4
JEFF DAVIS,4/6/2020,3,1,0,4
JEFF DAVIS,4/7/2020,3,1,0,4
JEFF DAVIS,4/8/2020,3,1,0,4
JEFF DAVIS,4/9/2020,3,1,0,4
JEFF DAVIS,4/10/2020,3,1,0,4
JEFF DAVIS,4/11/2020,3,1,0,4
JEFF DAVIS,4/12/2020,3,1,0,4
JEFF DAVIS,4/13/2020,4,3,0,7
JEFF DAVIS,4/14/2020,5,4,0,9
JEFF DAVIS,4/15/2020,5,4,0,9
JEFF DAVIS,4/16/2020,5,4,0,9
JEFF DAVIS,4/17/2020,6,4,0,10
JEFF DAVIS,4/18/2020,8,4,0,12
JEFF DAVIS,4/19/2020,8,4,0,12
JEFF DAVIS,4/20/2020,9,5,0,14
JEFF DAVIS,4/21/2020,9,6,0,15
JEFF DAVIS,4/22/2020,9,6,0,15
JEFF DAVIS,4/23/2020,10,8,0,18
JEFF DAVIS,4/24/2020,11,8,0,19
JEFF DAVIS,4/25/2020,11,8,0,19
JEFF DAVIS,4/26/2020,12,8,0,20
JEFF DAVIS,4/27/2020,13,8,0,21
JEFF DAVIS,4/28/2020,13,8,0,21
JEFF DAVIS,4/29/2020,14,10,0,24
JEFF DAVIS,4/30/2020,14,11,0,25
JEFF DAVIS,5/1/2020,14,11,0,25
JEFF DAVIS,5/2/2020,15,11,0,26
JEFF DAVIS,5/3/2020,15,11,0,26
JEFF DAVIS,5/4/2020,15,11,0,26
JEFF DAVIS,5/5/2020,15,11,0,26
JEFF DAVIS,5/6/2020,15,11,0,26
JEFF DAVIS,5/7/2020,15,11,0,26
JEFF DAVIS,5/8/2020,15,11,0,26
JEFF DAVIS,5/9/2020,15,11,0,26
JEFF DAVIS,5/10/2020,15,11,0,26
JEFF DAVIS,5/11/2020,15,11,0,26
JEFF DAVIS,5/12/2020,16,11,0,27
JEFF DAVIS,5/13/2020,17,11,0,28
JEFF DAVIS,5/14/2020,17,11,0,28
JEFF DAVIS,5/15/2020,18,12,0,30
JEFF DAVIS,5/16/2020,18,12,0,30
JEFF DAVIS,5/17/2020,18,12,0,30
JEFF DAVIS,5/18/2020,19,12,0,31
JEFF DAVIS,5/19/2020,20,12,0,32
JEFF DAVIS,5/20/2020,20,13,0,33
JEFF DAVIS,5/21/2020,20,14,0,34
JEFF DAVIS,5/22/2020,20,14,0,34
JEFF DAVIS,5/23/2020,21,14,0,35
JEFF DAVIS,5/24/2020,21,14,0,35
JEFF DAVIS,5/25/2020,22,15,0,37
JEFF DAVIS,5/26/2020,22,15,0,37
JEFF DAVIS,5/27/2020,22,16,0,38
JEFF DAVIS,5/28/2020,23,17,0,40
JEFF DAVIS,5/29/2020,23,17,0,40
JEFF DAVIS,5/30/2020,23,17,0,40
JEFF DAVIS,5/31/2020,23,17,0,40
JEFF DAVIS,6/1/2020,25,20,0,45
JEFF DAVIS,6/2/2020,26,20,0,46
JEFF DAVIS,6/3/2020,26,23,0,49
JEFF DAVIS,6/4/2020,26,23,0,49
JEFF DAVIS,6/5/2020,27,23,0,50
JEFF DAVIS,6/6/2020,27,23,0,50
JEFF DAVIS,6/7/2020,28,24,0,52
JEFF DAVIS,6/8/2020,29,25,0,54
JEFF DAVIS,6/9/2020,29,27,0,56
JEFF DAVIS,6/10/2020,31,28,0,59
JEFF DAVIS,6/11/2020,32,30,0,62
JEFF DAVIS,6/12/2020,32,31,0,63
JEFF DAVIS,6/13/2020,33,31,0,64
JEFF DAVIS,6/14/2020,35,32,0,67
JEFF DAVIS,6/15/2020,36,35,0,71
JEFF DAVIS,6/16/2020,36,36,0,72
JEFF DAVIS,6/17/2020,36,38,0,74
JEFF DAVIS,6/18/2020,36,39,0,75
JEFF DAVIS,6/19/2020,38,41,0,79
JEFF DAVIS,6/20/2020,40,43,0,83
JEFF DAVIS,6/21/2020,40,44,0,84
JEFF DAVIS,6/22/2020,43,49,0,92
JEFF DAVIS,6/23/2020,49,55,0,104
JEFF DAVIS,6/24/2020,51,62,0,113
JEFF DAVIS,6/25/2020,55,71,0,126
JEFF DAVIS,6/26/2020,58,72,0,130
JEFF DAVIS,6/27/2020,60,73,0,133
JEFF DAVIS,6/28/2020,61,74,0,135
JEFF DAVIS,6/29/2020,69,80,0,149
JEFF DAVIS,6/30/2020,75,85,0,160
JEFF DAVIS,7/1/2020,80,88,0,168
JEFF DAVIS,7/2/2020,90,92,0,182
JEFF DAVIS,7/3/2020,91,96,0,187
JEFF DAVIS,7/4/2020,92,96,0,188
JEFF DAVIS,7/5/2020,94,99,0,193
JEFF DAVIS,7/6/2020,105,108,0,213
JEFF DAVIS,7/7/2020,118,120,0,238
JEFF DAVIS,7/8/2020,130,134,0,264
JEFF DAVIS,7/9/2020,146,156,0,302
JEFF DAVIS,7/10/2020,154,164,1,319
JEFF DAVIS,7/11/2020,158,165,1,324
JEFF DAVIS,7/12/2020,160,167,1,328
JEFF DAVIS,7/13/2020,173,185,1,359
JEFF DAVIS,7/14/2020,181,193,1,375
JEFF DAVIS,7/15/2020,193,201,1,395
JEFF DAVIS,7/16/2020,203,207,1,411
JEFF DAVIS,7/17/2020,209,212,1,422
JEFF DAVIS,7/18/2020,210,213,1,424
JEFF DAVIS,7/19/2020,211,213,1,425
JEFF DAVIS,7/20/2020,218,219,1,438
JEFF DAVIS,7/21/2020,220,223,1,444
JEFF DAVIS,7/22/2020,223,228,1,452
JEFF DAVIS,7/23/2020,226,228,1,455
JEFF DAVIS,7/24/2020,235,230,1,466
JEFF DAVIS,7/25/2020,237,230,1,468
JEFF DAVIS,7/26/2020,240,230,1,471
JEFF DAVIS,7/27/2020,245,232,2,479
JEFF DAVIS,7/28/2020,252,237,2,491
JEFF DAVIS,7/29/2020,256,237,2,495
JEFF DAVIS,7/30/2020,260,240,2,502
JEFF DAVIS,7/31/2020,267,246,2,515
JEFF DAVIS,8/1/2020,269,248,2,519
JEFF DAVIS,8/2/2020,272,248,2,522
JEFF DAVIS,8/3/2020,276,257,2,535
JEFF DAVIS,8/4/2020,280,259,2,541
JEFF DAVIS,8/5/2020,282,261,2,545
JEFF DAVIS,8/6/2020,290,263,2,555
JEFF DAVIS,8/7/2020,291,264,2,557
JEFF DAVIS,8/8/2020,291,264,2,557
JEFF DAVIS,8/9/2020,291,267,2,560
JEFF DAVIS,8/10/2020,294,274,2,570
JEFF DAVIS,8/11/2020,295,274,2,571
JEFF DAVIS,8/12/2020,300,275,2,577
JEFF DAVIS,8/13/2020,305,279,2,586
JEFF DAVIS,8/14/2020,307,283,2,592
JEFF DAVIS,8/15/2020,309,283,2,594
JEFF DAVIS,8/16/2020,311,283,2,596
JEFF DAVIS,8/17/2020,319,289,2,610
JEFF DAVIS,8/18/2020,322,293,2,617
JEFF DAVIS,8/19/2020,326,299,2,627
JEFF DAVIS,8/20/2020,333,303,2,638
JEFF DAVIS,8/21/2020,336,306,2,644
JEFF DAVIS,8/22/2020,340,306,2,648
JEFF DAVIS,8/23/2020,342,307,2,651
JEFF DAVIS,8/24/2020,349,313,2,664
JEFF DAVIS,8/25/2020,356,314,2,672
JEFF DAVIS,8/26/2020,358,315,2,675
JEFF DAVIS,8/27/2020,361,318,2,681
JEFF DAVIS,8/28/2020,363,318,2,683
JEFF DAVIS,8/29/2020,363,319,2,684
JEFF DAVIS,8/30/2020,363,319,2,684
JEFF DAVIS,8/31/2020,365,321,2,688
JEFF DAVIS,9/1/2020,367,321,2,690
JEFF DAVIS,9/2/2020,369,323,2,694
JEFF DAVIS,9/3/2020,370,326,2,698
JEFF DAVIS,9/4/2020,372,326,2,700
JEFF DAVIS,9/5/2020,372,326,2,700
JEFF DAVIS,9/6/2020,373,326,2,701
JEFF DAVIS,9/7/2020,377,326,2,705
JEFF DAVIS,9/8/2020,379,328,2,709
JEFF DAVIS,9/9/2020,380,331,2,713
JEFF DAVIS,9/10/2020,380,331,2,713
JEFF DAVIS,9/11/2020,382,332,2,716
JEFF DAVIS,9/12/2020,383,332,2,717
JEFF DAVIS,9/13/2020,383,334,2,719
JEFF DAVIS,9/14/2020,384,335,2,721
JEFF DAVIS,9/15/2020,385,336,2,723
JEFF DAVIS,9/16/2020,386,336,2,724
JEFF DAVIS,9/17/2020,389,337,2,728
JEFF DAVIS,9/18/2020,391,337,2,730
JEFF DAVIS,9/19/2020,391,338,2,731
JEFF DAVIS,9/20/2020,392,338,2,732
JEFF DAVIS,9/21/2020,393,340,2,735
JEFF DAVIS,9/22/2020,395,341,2,738
JEFF DAVIS,9/23/2020,395,341,2,738
JEFF DAVIS,9/24/2020,397,341,2,740
LIBERTY,3/29/2020,2,12,0,14
JEFF DAVIS,9/25/2020,397,342,2,741
JEFF DAVIS,9/26/2020,398,342,2,742
JEFF DAVIS,9/27/2020,398,342,2,742
JEFF DAVIS,9/28/2020,399,342,2,743
JEFF DAVIS,9/29/2020,399,342,2,743
JEFF DAVIS,9/30/2020,400,342,2,744
JEFF DAVIS,10/1/2020,402,347,2,751
JEFF DAVIS,10/2/2020,402,347,2,751
JEFF DAVIS,10/3/2020,403,347,2,752
JEFF DAVIS,10/4/2020,403,347,2,752
JEFF DAVIS,10/5/2020,406,348,2,756
JEFF DAVIS,10/6/2020,406,348,2,756
JEFF DAVIS,10/7/2020,407,349,2,758
JEFF DAVIS,10/8/2020,408,350,2,760
JEFF DAVIS,10/9/2020,410,351,2,763
JEFF DAVIS,10/10/2020,410,353,2,765
JEFF DAVIS,10/11/2020,410,353,2,765
JEFF DAVIS,10/12/2020,412,355,2,769
JEFF DAVIS,10/13/2020,414,357,2,773
JEFF DAVIS,10/14/2020,415,358,2,775
JEFF DAVIS,10/15/2020,415,359,2,776
JEFF DAVIS,10/16/2020,416,359,2,777
JEFF DAVIS,10/17/2020,416,359,2,777
JEFF DAVIS,10/18/2020,416,359,2,777
JEFF DAVIS,10/19/2020,416,359,2,777
JEFF DAVIS,10/20/2020,416,359,2,777
JOHNSON,1/1/2020,0,0,0,0
JOHNSON,1/2/2020,0,0,0,0
JOHNSON,1/3/2020,0,0,0,0
JOHNSON,1/4/2020,0,0,0,0
JOHNSON,1/5/2020,0,0,0,0
JOHNSON,1/6/2020,0,0,0,0
JOHNSON,1/7/2020,0,0,0,0
JOHNSON,1/8/2020,0,0,0,0
JOHNSON,1/9/2020,0,0,0,0
JOHNSON,1/10/2020,0,0,0,0
JOHNSON,1/11/2020,0,0,0,0
JOHNSON,1/12/2020,0,0,0,0
JOHNSON,1/13/2020,0,0,0,0
JOHNSON,1/14/2020,0,0,0,0
JOHNSON,1/15/2020,0,0,0,0
JOHNSON,1/16/2020,0,0,0,0
JOHNSON,1/17/2020,0,0,0,0
JOHNSON,1/18/2020,0,0,0,0
JOHNSON,1/19/2020,0,0,0,0
JOHNSON,1/20/2020,0,0,0,0
JOHNSON,1/21/2020,0,0,0,0
JOHNSON,1/22/2020,0,0,0,0
JOHNSON,1/23/2020,0,0,0,0
JOHNSON,1/24/2020,0,0,0,0
JOHNSON,1/25/2020,0,0,0,0
JOHNSON,1/26/2020,0,0,0,0
JOHNSON,1/27/2020,0,0,0,0
JOHNSON,1/28/2020,0,0,0,0
JOHNSON,1/29/2020,0,0,0,0
JOHNSON,1/30/2020,0,0,0,0
JOHNSON,1/31/2020,0,0,0,0
JOHNSON,2/1/2020,0,0,0,0
JOHNSON,2/2/2020,0,0,0,0
JOHNSON,2/3/2020,0,0,0,0
JOHNSON,2/4/2020,0,0,0,0
JOHNSON,2/5/2020,0,0,0,0
JOHNSON,2/6/2020,0,0,0,0
JOHNSON,2/7/2020,0,0,0,0
JOHNSON,2/8/2020,0,0,0,0
JOHNSON,2/9/2020,0,0,0,0
JOHNSON,2/10/2020,0,0,0,0
JOHNSON,2/11/2020,0,0,0,0
JOHNSON,2/12/2020,0,0,0,0
JOHNSON,2/13/2020,0,0,0,0
JOHNSON,2/14/2020,0,0,0,0
JOHNSON,2/15/2020,0,0,0,0
JOHNSON,2/16/2020,0,0,0,0
JOHNSON,2/17/2020,0,0,0,0
JOHNSON,2/18/2020,0,0,0,0
JOHNSON,2/19/2020,0,0,0,0
JOHNSON,2/20/2020,0,0,0,0
JOHNSON,2/21/2020,0,0,0,0
JOHNSON,2/22/2020,0,0,0,0
JOHNSON,2/23/2020,0,0,0,0
JOHNSON,2/24/2020,0,0,0,0
JOHNSON,2/25/2020,0,0,0,0
JOHNSON,2/26/2020,0,0,0,0
JOHNSON,2/27/2020,0,0,0,0
JOHNSON,2/28/2020,0,0,0,0
JOHNSON,2/29/2020,0,0,0,0
JOHNSON,3/1/2020,2,0,0,2
JOHNSON,3/2/2020,2,0,0,2
JOHNSON,3/3/2020,2,0,0,2
JOHNSON,3/4/2020,2,0,0,2
LAMAR,10/3/2020,221,165,2,388
JONES,6/20/2020,39,22,0,61
LAMAR,10/4/2020,222,165,2,389
JONES,6/21/2020,40,22,0,62
JONES,6/22/2020,42,23,0,65
LAMAR,10/5/2020,222,166,2,390
JONES,6/23/2020,44,24,0,68
LIBERTY,3/30/2020,3,13,0,16
LIBERTY,3/31/2020,4,13,0,17
LIBERTY,4/1/2020,4,13,0,17
LIBERTY,4/2/2020,4,13,0,17
LAMAR,10/6/2020,222,168,2,392
LIBERTY,4/3/2020,6,13,0,19
LAMAR,10/7/2020,222,168,2,392
LIBERTY,4/4/2020,6,13,0,19
LAMAR,10/8/2020,222,168,2,392
LIBERTY,4/5/2020,6,13,0,19
LIBERTY,4/6/2020,6,16,0,22
LIBERTY,4/7/2020,7,16,0,23
LIBERTY,4/8/2020,7,19,0,26
LIBERTY,4/9/2020,8,21,0,29
LIBERTY,4/10/2020,10,22,0,32
LIBERTY,4/11/2020,10,23,0,33
LIBERTY,4/12/2020,10,23,0,33
LIBERTY,4/13/2020,10,23,0,33
LIBERTY,4/14/2020,11,24,0,35
LIBERTY,4/15/2020,13,24,0,37
LIBERTY,4/16/2020,13,24,0,37
LIBERTY,4/17/2020,13,24,0,37
LIBERTY,4/18/2020,13,24,0,37
LIBERTY,4/19/2020,13,24,0,37
LIBERTY,4/20/2020,14,24,0,38
LIBERTY,4/21/2020,14,24,0,38
LIBERTY,4/22/2020,14,24,0,38
LIBERTY,4/23/2020,14,25,0,39
JONES,6/24/2020,49,28,0,77
LIBERTY,4/24/2020,14,25,0,39
LIBERTY,4/25/2020,14,25,0,39
LIBERTY,4/26/2020,15,25,0,40
LIBERTY,4/27/2020,16,25,0,41
LIBERTY,4/28/2020,16,25,0,41
LIBERTY,4/29/2020,16,25,0,41
LIBERTY,4/30/2020,16,26,0,42
LIBERTY,5/1/2020,18,27,0,45
LIBERTY,5/2/2020,19,27,0,46
LIBERTY,5/3/2020,19,27,0,46
LIBERTY,5/4/2020,19,27,0,46
LIBERTY,5/5/2020,20,27,0,47
LIBERTY,5/6/2020,20,27,0,47
LIBERTY,5/7/2020,20,27,0,47
LIBERTY,5/8/2020,20,27,0,47
LIBERTY,5/9/2020,20,27,0,47
LIBERTY,5/10/2020,20,27,0,47
LIBERTY,5/11/2020,21,27,0,48
LIBERTY,5/12/2020,21,29,0,50
LIBERTY,5/13/2020,31,30,0,61
LIBERTY,5/14/2020,31,31,0,62
LIBERTY,5/15/2020,31,32,0,63
LIBERTY,5/16/2020,31,32,0,63
LIBERTY,5/17/2020,31,33,0,64
LIBERTY,5/18/2020,32,34,1,67
LIBERTY,5/19/2020,32,34,1,67
LIBERTY,5/20/2020,32,35,1,68
LIBERTY,5/21/2020,35,36,1,72
LIBERTY,5/22/2020,35,37,1,73
LIBERTY,5/23/2020,37,37,1,75
LIBERTY,5/24/2020,39,37,1,77
LIBERTY,5/25/2020,40,37,1,78
LIBERTY,5/26/2020,40,40,1,81
LIBERTY,5/27/2020,40,40,1,81
LIBERTY,5/28/2020,42,40,1,83
LIBERTY,5/29/2020,42,41,1,84
LIBERTY,5/30/2020,42,41,1,84
LIBERTY,5/31/2020,43,41,1,85
LIBERTY,6/1/2020,43,43,1,87
LIBERTY,6/2/2020,43,43,1,87
LIBERTY,6/3/2020,44,45,1,90
LIBERTY,6/4/2020,44,45,1,90
LIBERTY,6/5/2020,44,45,1,90
LIBERTY,6/6/2020,44,45,1,90
LIBERTY,6/7/2020,44,45,1,90
LIBERTY,6/8/2020,44,46,1,91
LIBERTY,6/9/2020,44,47,1,92
LIBERTY,6/10/2020,45,50,1,96
LIBERTY,6/11/2020,47,53,1,101
LIBERTY,6/12/2020,48,53,1,102
LIBERTY,6/13/2020,51,53,1,105
LIBERTY,6/14/2020,51,54,1,106
LIBERTY,6/15/2020,52,55,1,108
LIBERTY,6/16/2020,54,58,1,113
LIBERTY,6/17/2020,55,59,1,115
LIBERTY,6/18/2020,55,60,1,116
LIBERTY,6/19/2020,56,63,1,120
LIBERTY,6/20/2020,61,65,1,127
LIBERTY,6/21/2020,63,65,1,129
LIBERTY,6/22/2020,65,68,1,134
LIBERTY,6/23/2020,66,69,1,136
LIBERTY,6/24/2020,71,72,1,144
LIBERTY,6/25/2020,74,76,1,151
LIBERTY,6/26/2020,77,77,1,155
LIBERTY,6/27/2020,78,78,1,157
LIBERTY,6/28/2020,79,78,1,158
LIBERTY,6/29/2020,87,83,2,172
LIBERTY,6/30/2020,97,87,2,186
LIBERTY,7/1/2020,113,101,2,216
LIBERTY,7/2/2020,120,109,3,232
LIBERTY,7/3/2020,125,114,3,242
LIBERTY,7/4/2020,133,120,3,256
LIBERTY,7/5/2020,140,124,3,267
LIBERTY,7/6/2020,170,138,4,312
LIBERTY,7/7/2020,196,149,5,350
LIBERTY,7/8/2020,210,153,7,370
LIBERTY,7/9/2020,221,166,7,394
LIBERTY,7/10/2020,232,181,7,420
LIBERTY,7/11/2020,236,188,7,431
LIBERTY,7/12/2020,246,189,7,442
LIBERTY,7/13/2020,261,203,10,474
LIBERTY,7/14/2020,272,212,10,494
LIBERTY,7/15/2020,290,221,11,522
LIBERTY,7/16/2020,297,228,11,536
LIBERTY,7/17/2020,309,232,11,552
LIBERTY,7/18/2020,315,234,11,560
LIBERTY,7/19/2020,318,235,11,564
LIBERTY,7/20/2020,324,242,11,577
LIBERTY,7/21/2020,330,245,11,586
LIBERTY,7/22/2020,340,248,12,600
LIBERTY,7/23/2020,354,255,12,621
LIBERTY,7/24/2020,370,260,12,642
LIBERTY,7/25/2020,380,265,12,657
LIBERTY,7/26/2020,385,273,12,670
LIBERTY,7/27/2020,393,283,12,688
LIBERTY,7/28/2020,399,289,12,700
LIBERTY,7/29/2020,407,294,12,713
LIBERTY,7/30/2020,414,299,13,726
LIBERTY,7/31/2020,422,301,13,736
LIBERTY,8/1/2020,428,302,13,743
LIBERTY,8/2/2020,430,304,13,747
LIBERTY,8/3/2020,441,320,14,775
LIBERTY,8/4/2020,455,334,14,803
LIBERTY,8/5/2020,459,339,14,812
LIBERTY,8/6/2020,466,354,14,834
LIBERTY,8/7/2020,473,360,14,847
LIBERTY,8/8/2020,476,366,15,857
LIBERTY,8/9/2020,477,367,15,859
LIBERTY,8/10/2020,481,373,15,869
LIBERTY,8/11/2020,487,379,15,881
LIBERTY,8/12/2020,493,383,15,891
LIBERTY,8/13/2020,498,391,15,904
LIBERTY,8/14/2020,502,396,15,913
LIBERTY,8/15/2020,504,399,15,918
LIBERTY,8/16/2020,506,400,15,921
LIBERTY,8/17/2020,510,402,15,927
LIBERTY,8/18/2020,518,408,15,941
LIBERTY,8/19/2020,524,411,15,950
LIBERTY,8/20/2020,531,412,15,958
LIBERTY,8/21/2020,537,415,16,968
LIBERTY,8/22/2020,539,422,16,977
LIBERTY,8/23/2020,541,425,16,982
LIBERTY,8/24/2020,549,427,16,992
LIBERTY,8/25/2020,554,428,16,998
LIBERTY,8/26/2020,556,430,16,1002
LIBERTY,8/27/2020,557,432,16,1005
LIBERTY,8/28/2020,559,432,16,1007
LIBERTY,8/29/2020,559,432,16,1007
LIBERTY,8/30/2020,560,434,16,1010
LIBERTY,8/31/2020,561,437,16,1014
LIBERTY,9/1/2020,568,444,16,1028
LIBERTY,9/2/2020,574,448,16,1038
LIBERTY,9/3/2020,575,450,16,1041
LIBERTY,9/4/2020,579,451,16,1046
LIBERTY,9/5/2020,581,453,16,1050
LIBERTY,9/6/2020,582,457,16,1055
LIBERTY,9/7/2020,584,459,16,1059
LIBERTY,9/8/2020,591,459,16,1066
LIBERTY,9/9/2020,596,463,16,1075
LIBERTY,9/10/2020,598,464,16,1078
LIBERTY,9/11/2020,600,466,16,1082
LIBERTY,9/12/2020,604,470,16,1090
LIBERTY,9/13/2020,608,472,16,1096
LIBERTY,9/14/2020,610,477,16,1103
LIBERTY,9/15/2020,615,477,16,1108
LIBERTY,9/16/2020,620,478,16,1114
LIBERTY,9/17/2020,622,483,16,1121
LIBERTY,9/18/2020,623,484,16,1123
LIBERTY,9/19/2020,626,485,16,1127
LIBERTY,9/20/2020,626,486,16,1128
LIBERTY,9/21/2020,628,489,16,1133
LIBERTY,9/22/2020,630,491,16,1137
LIBERTY,9/23/2020,631,491,16,1138
LIBERTY,9/24/2020,635,493,16,1144
LIBERTY,9/25/2020,640,494,17,1151
LIBERTY,9/26/2020,642,495,17,1154
LIBERTY,9/27/2020,643,497,17,1157
LIBERTY,9/28/2020,643,497,17,1157
LIBERTY,9/29/2020,644,500,17,1161
LIBERTY,9/30/2020,644,503,17,1164
LIBERTY,10/1/2020,647,503,17,1167
LIBERTY,10/2/2020,648,504,18,1170
LIBERTY,10/3/2020,649,505,18,1172
LIBERTY,10/4/2020,652,507,18,1177
LIBERTY,10/5/2020,654,511,19,1184
LIBERTY,10/6/2020,654,513,19,1186
LIBERTY,10/7/2020,654,518,19,1191
LIBERTY,10/8/2020,655,522,19,1196
LIBERTY,10/9/2020,656,522,19,1197
LIBERTY,10/10/2020,658,522,19,1199
LIBERTY,10/11/2020,658,523,19,1200
LIBERTY,10/12/2020,659,525,19,1203
LIBERTY,10/13/2020,659,526,19,1204
LIBERTY,10/14/2020,659,527,19,1205
LIBERTY,10/15/2020,660,529,19,1208
LIBERTY,10/16/2020,661,531,19,1211
LIBERTY,10/17/2020,661,531,19,1211
LIBERTY,10/18/2020,662,531,19,1212
LIBERTY,10/19/2020,662,531,19,1212
LIBERTY,10/20/2020,662,531,19,1212
MARION,1/1/2020,0,0,0,0
MARION,1/2/2020,0,0,0,0
MARION,1/3/2020,0,0,0,0
MARION,1/4/2020,0,0,0,0
MARION,1/5/2020,0,0,0,0
MARION,1/6/2020,0,0,0,0
MARION,1/7/2020,0,0,0,0
MARION,1/8/2020,0,0,0,0
MARION,1/9/2020,0,0,0,0
MARION,1/10/2020,0,0,0,0
MARION,1/11/2020,0,0,0,0
MARION,1/12/2020,0,0,0,0
MARION,1/13/2020,0,0,0,0
MARION,1/14/2020,0,0,0,0
MARION,1/15/2020,0,0,0,0
MARION,1/16/2020,0,0,0,0
MARION,1/17/2020,0,0,0,0
MARION,1/18/2020,0,0,0,0
MARION,1/19/2020,0,0,0,0
MARION,1/20/2020,0,0,0,0
MARION,1/21/2020,0,0,0,0
MARION,1/22/2020,0,0,0,0
MARION,1/23/2020,0,0,0,0
MARION,1/24/2020,0,0,0,0
MARION,1/25/2020,0,0,0,0
MARION,1/26/2020,0,0,0,0
MARION,1/27/2020,0,0,0,0
MARION,1/28/2020,0,0,0,0
MARION,1/29/2020,0,0,0,0
MARION,1/30/2020,0,0,0,0
MARION,1/31/2020,0,0,0,0
MARION,2/1/2020,0,0,0,0
MARION,2/2/2020,0,0,0,0
MARION,2/3/2020,0,0,0,0
MARION,2/4/2020,0,0,0,0
MARION,2/5/2020,0,0,0,0
MARION,2/6/2020,0,0,0,0
MARION,2/7/2020,0,0,0,0
MARION,2/8/2020,0,0,0,0
MARION,2/9/2020,0,0,0,0
MARION,2/10/2020,0,0,0,0
MARION,2/11/2020,0,0,0,0
MARION,2/12/2020,0,0,0,0
MARION,2/13/2020,0,0,0,0
MARION,2/14/2020,0,0,0,0
MARION,2/15/2020,0,0,0,0
MARION,2/16/2020,0,0,0,0
MARION,2/17/2020,0,0,0,0
MARION,2/18/2020,0,0,0,0
MARION,2/19/2020,0,0,0,0
MARION,2/20/2020,0,0,0,0
MARION,2/21/2020,0,0,0,0
MARION,2/22/2020,0,0,0,0
MARION,2/23/2020,0,0,0,0
MARION,2/24/2020,0,0,0,0
MARION,2/25/2020,0,0,0,0
MARION,2/26/2020,0,0,0,0
MARION,2/27/2020,0,0,0,0
MARION,2/28/2020,0,0,0,0
MARION,2/29/2020,0,0,0,0
MARION,3/1/2020,0,0,0,0
MARION,3/2/2020,0,0,0,0
MARION,3/3/2020,0,0,0,0
MARION,3/4/2020,0,0,0,0
MARION,3/5/2020,0,0,0,0
MARION,3/6/2020,0,0,0,0
MARION,3/7/2020,0,0,0,0
MARION,3/8/2020,0,0,0,0
MARION,3/9/2020,0,0,0,0
MARION,3/10/2020,0,0,0,0
MARION,3/11/2020,0,0,0,0
MARION,3/12/2020,0,0,0,0
MARION,3/13/2020,0,0,0,0
MARION,3/14/2020,0,0,0,0
MARION,3/15/2020,0,0,0,0
MARION,3/16/2020,0,1,0,1
MARION,3/17/2020,0,1,0,1
MARION,3/18/2020,0,1,0,1
MARION,3/19/2020,0,1,0,1
MARION,3/20/2020,0,1,0,1
MARION,3/21/2020,0,1,0,1
MARION,3/22/2020,0,1,0,1
MARION,3/23/2020,0,1,0,1
MARION,3/24/2020,0,2,0,2
MARION,3/25/2020,0,2,0,2
MARION,3/26/2020,0,3,0,3
MARION,3/27/2020,2,3,0,5
MARION,3/28/2020,2,3,0,5
MARION,3/29/2020,2,3,0,5
MARION,3/30/2020,2,3,0,5
MARION,3/31/2020,2,3,0,5
MARION,4/1/2020,2,3,0,5
MARION,4/2/2020,2,3,0,5
MARION,4/3/2020,2,3,0,5
MARION,4/4/2020,2,4,0,6
MARION,4/5/2020,2,4,0,6
MARION,4/6/2020,3,6,0,9
MARION,4/7/2020,3,6,0,9
MARION,4/8/2020,3,7,0,10
MARION,4/9/2020,4,7,0,11
MARION,4/10/2020,7,8,0,15
MARION,4/11/2020,9,8,0,17
MARION,4/12/2020,11,8,0,19
MARION,4/13/2020,13,8,0,21
MARION,4/14/2020,13,8,0,21
MARION,4/15/2020,16,9,0,25
MARION,4/16/2020,18,9,0,27
MARION,4/17/2020,18,10,0,28
MARION,4/18/2020,19,10,0,29
MARION,4/19/2020,19,10,0,29
MARION,4/20/2020,20,11,0,31
MARION,4/21/2020,20,11,0,31
MARION,4/22/2020,21,11,0,32
MARION,4/23/2020,22,11,0,33
MARION,4/24/2020,23,11,0,34
MARION,4/25/2020,24,11,0,35
MARION,4/26/2020,24,12,0,36
MARION,4/27/2020,24,12,0,36
MARION,4/28/2020,24,12,0,36
MARION,4/29/2020,24,12,0,36
MARION,4/30/2020,24,12,0,36
MARION,5/1/2020,25,12,0,37
MARION,5/2/2020,25,13,0,38
MARION,5/3/2020,25,13,0,38
MARION,5/4/2020,26,13,0,39
MARION,5/5/2020,26,13,0,39
MARION,5/6/2020,27,13,0,40
MARION,5/7/2020,27,13,0,40
MARION,5/8/2020,27,13,0,40
MARION,5/9/2020,27,13,0,40
MARION,5/10/2020,27,13,0,40
MARION,5/11/2020,29,13,0,42
MARION,5/12/2020,30,14,0,44
MARION,5/13/2020,31,15,0,46
MARION,5/14/2020,35,15,0,50
MARION,5/15/2020,36,15,0,51
MARION,5/16/2020,36,15,0,51
MARION,5/17/2020,36,15,0,51
MARION,5/18/2020,37,17,0,54
MARION,5/19/2020,38,17,0,55
MARION,5/20/2020,38,17,0,55
MARION,5/21/2020,38,17,0,55
MARION,5/22/2020,38,17,0,55
MARION,5/23/2020,38,17,0,55
MARION,5/24/2020,38,17,0,55
MARION,5/25/2020,40,18,0,58
MARION,5/26/2020,40,18,0,58
MARION,5/27/2020,42,18,0,60
MARION,5/28/2020,42,19,0,61
MARION,5/29/2020,42,21,0,63
MARION,5/30/2020,42,21,0,63
MARION,5/31/2020,42,21,0,63
MARION,6/1/2020,42,21,0,63
MARION,6/2/2020,42,21,0,63
MARION,6/3/2020,42,21,0,63
MARION,6/4/2020,43,21,0,64
MARION,6/5/2020,43,21,0,64
MARION,6/6/2020,43,21,0,64
MARION,6/7/2020,43,21,0,64
MARION,6/8/2020,43,21,0,64
MARION,6/9/2020,46,23,0,69
MARION,6/10/2020,47,24,0,71
MARION,6/11/2020,49,26,0,75
MARION,6/12/2020,51,27,0,78
MARION,6/13/2020,51,27,0,78
MARION,6/14/2020,52,27,0,79
MARION,6/15/2020,53,28,0,81
MARION,6/16/2020,53,28,0,81
MARION,6/17/2020,55,28,0,83
MARION,6/18/2020,55,29,0,84
MARION,6/19/2020,55,30,0,85
MARION,6/20/2020,56,30,0,86
MARION,6/21/2020,56,31,0,87
MARION,6/22/2020,56,31,0,87
MARION,6/23/2020,57,32,0,89
MARION,6/24/2020,58,32,0,90
MARION,6/25/2020,58,32,0,90
MARION,6/26/2020,58,32,0,90
MARION,6/27/2020,59,32,0,91
MARION,6/28/2020,59,32,0,91
MARION,6/29/2020,61,32,0,93
MARION,6/30/2020,62,32,0,94
MARION,7/1/2020,67,33,0,100
MARION,7/2/2020,67,33,0,100
MARION,7/3/2020,68,33,0,101
MARION,7/4/2020,68,34,0,102
MARION,7/5/2020,70,34,0,104
MARION,7/6/2020,75,35,0,110
MARION,7/7/2020,77,36,0,113
MARION,7/8/2020,80,36,0,116
MARION,7/9/2020,82,37,0,119
MARION,7/10/2020,83,37,0,120
MARION,7/11/2020,83,38,0,121
MARION,7/12/2020,83,38,0,121
LAMAR,10/9/2020,222,168,2,392
LAMAR,10/10/2020,222,169,2,393
LAMAR,10/11/2020,223,169,2,394
LAMAR,10/12/2020,223,170,2,395
LAMAR,10/13/2020,224,172,2,398
LAMAR,10/14/2020,225,172,2,399
LAMAR,10/15/2020,227,173,2,402
LAMAR,10/16/2020,227,173,2,402
LAMAR,10/17/2020,227,173,2,402
LAMAR,10/18/2020,227,173,2,402
LAMAR,10/19/2020,227,173,2,402
LAMAR,10/20/2020,227,173,2,402
LEE,1/1/2020,0,0,0,0
LEE,1/2/2020,0,0,0,0
LEE,1/3/2020,0,0,0,0
LEE,1/4/2020,0,0,0,0
LEE,1/5/2020,0,0,0,0
LEE,1/6/2020,0,0,0,0
LEE,1/7/2020,0,0,0,0
LEE,1/8/2020,0,0,0,0
LEE,1/9/2020,0,0,0,0
LEE,1/10/2020,0,0,0,0
LEE,1/11/2020,0,0,0,0
LEE,1/12/2020,0,0,0,0
LEE,1/13/2020,0,0,0,0
JONES,6/25/2020,51,30,0,81
LEE,1/14/2020,0,0,0,0
LEE,1/15/2020,0,0,0,0
LEE,1/16/2020,0,0,0,0
LEE,1/17/2020,0,0,0,0
LEE,1/18/2020,0,0,0,0
LEE,1/19/2020,0,0,0,0
LEE,1/20/2020,0,0,0,0
LEE,1/21/2020,0,0,0,0
LEE,1/22/2020,0,0,0,0
LEE,1/23/2020,0,0,0,0
LEE,1/24/2020,0,0,0,0
LEE,1/25/2020,0,0,0,0
LEE,1/26/2020,0,0,0,0
LEE,1/27/2020,0,0,0,0
LEE,1/28/2020,0,0,0,0
LEE,1/29/2020,0,0,0,0
LEE,1/30/2020,0,0,0,0
LEE,1/31/2020,0,0,0,0
LEE,2/1/2020,0,0,0,0
LEE,2/2/2020,0,0,0,0
LEE,2/3/2020,0,0,0,0
LEE,2/4/2020,0,0,0,0
LEE,2/5/2020,0,0,0,0
LEE,2/6/2020,0,0,0,0
LEE,2/7/2020,0,0,0,0
LEE,2/8/2020,0,0,0,0
LEE,2/9/2020,0,0,0,0
LEE,2/10/2020,0,0,0,0
LEE,2/11/2020,0,0,0,0
LEE,2/12/2020,0,0,0,0
LEE,2/13/2020,0,0,0,0
LEE,2/14/2020,0,0,0,0
LEE,2/15/2020,0,0,0,0
LEE,2/16/2020,0,0,0,0
LEE,2/17/2020,0,0,0,0
LEE,2/18/2020,0,0,0,0
LEE,2/19/2020,0,0,0,0
LEE,2/20/2020,0,0,0,0
LEE,2/21/2020,0,0,0,0
LEE,2/22/2020,0,0,0,0
LEE,2/23/2020,0,0,0,0
LEE,2/24/2020,0,0,0,0
LEE,2/25/2020,0,0,0,0
LEE,2/26/2020,0,0,0,0
LEE,2/27/2020,0,0,0,0
LEE,2/28/2020,0,1,0,1
LEE,2/29/2020,0,1,0,1
LEE,3/1/2020,0,2,0,2
LEE,3/2/2020,0,3,0,3
LEE,3/3/2020,0,4,0,4
LEE,3/4/2020,0,5,0,5
LEE,3/5/2020,0,5,0,5
LEE,3/6/2020,1,5,0,6
LEE,3/7/2020,2,5,0,7
LEE,3/8/2020,2,6,0,8
LEE,3/9/2020,5,7,0,12
LEE,3/10/2020,5,8,0,13
LEE,3/11/2020,10,8,0,18
LEE,3/12/2020,14,9,0,23
LEE,3/13/2020,15,11,0,26
LEE,3/14/2020,16,12,0,28
LEE,3/15/2020,23,12,0,35
LEE,3/16/2020,25,22,0,47
LEE,3/17/2020,34,24,0,58
LEE,3/18/2020,39,24,0,63
LEE,3/19/2020,46,28,0,74
LEE,3/20/2020,52,37,0,89
LEE,3/21/2020,52,39,0,91
LEE,3/22/2020,58,44,0,102
LEE,3/23/2020,62,49,0,111
LEE,3/24/2020,74,58,0,132
LEE,3/25/2020,84,62,0,146
LEE,3/26/2020,90,69,0,159
LEE,3/27/2020,96,78,0,174
LEE,3/28/2020,100,88,0,188
LEE,3/29/2020,103,96,0,199
LEE,3/30/2020,109,102,0,211
LEE,3/31/2020,114,106,0,220
LEE,4/1/2020,129,110,0,239
LEE,4/2/2020,134,114,0,248
LEE,4/3/2020,142,117,0,259
LEE,4/4/2020,143,118,0,261
LEE,4/5/2020,148,121,2,271
LEE,4/6/2020,150,122,2,274
LEE,4/7/2020,151,125,2,278
LEE,4/8/2020,154,127,2,283
LEE,4/9/2020,156,129,2,287
LEE,4/10/2020,156,130,2,288
LEE,4/11/2020,157,130,3,290
LEE,4/12/2020,157,130,3,290
LEE,4/13/2020,159,131,3,293
LEE,4/14/2020,160,132,3,295
LEE,4/15/2020,161,134,3,298
LEE,4/16/2020,163,135,3,301
LEE,4/17/2020,164,137,3,304
LEE,4/18/2020,164,138,3,305
LEE,4/19/2020,165,138,3,306
LEE,4/20/2020,167,141,3,311
LEE,4/21/2020,168,144,3,315
LEE,4/22/2020,170,144,3,317
LEE,4/23/2020,171,144,3,318
LEE,4/24/2020,175,144,3,322
LEE,4/25/2020,176,145,3,324
LEE,4/26/2020,176,145,3,324
LEE,4/27/2020,179,146,3,328
LEE,4/28/2020,180,147,3,330
LEE,4/29/2020,181,148,3,332
LEE,4/30/2020,183,148,3,334
LEE,5/1/2020,183,149,3,335
LEE,5/2/2020,183,149,3,335
LEE,5/3/2020,183,149,3,335
LEE,5/4/2020,183,150,3,336
LEE,5/5/2020,183,150,3,336
LEE,5/6/2020,183,150,3,336
LEE,5/7/2020,184,150,3,337
LEE,5/8/2020,184,150,3,337
LEE,5/9/2020,184,150,3,337
LEE,5/10/2020,185,151,3,339
LEE,5/11/2020,187,152,3,342
LEE,5/12/2020,190,153,3,346
LEE,5/13/2020,191,154,3,348
LEE,5/14/2020,191,154,3,348
LEE,5/15/2020,192,155,3,350
LEE,5/16/2020,193,155,3,351
LEE,5/17/2020,193,155,3,351
LEE,5/18/2020,194,156,3,353
LEE,5/19/2020,196,156,3,355
LEE,5/20/2020,197,157,3,357
LEE,5/21/2020,199,158,3,360
LEE,5/22/2020,199,159,3,361
LEE,5/23/2020,199,159,3,361
LEE,5/24/2020,199,159,3,361
LEE,5/25/2020,199,160,3,362
LEE,5/26/2020,199,160,3,362
LEE,5/27/2020,200,160,3,363
LEE,5/28/2020,201,160,3,364
LEE,5/29/2020,201,161,3,365
LEE,5/30/2020,202,161,3,366
LEE,5/31/2020,202,161,3,366
LEE,6/1/2020,202,161,3,366
LEE,6/2/2020,202,162,3,367
LEE,6/3/2020,202,162,3,367
LEE,6/4/2020,202,162,3,367
LEE,6/5/2020,203,163,3,369
LEE,6/6/2020,205,163,3,371
LEE,6/7/2020,206,163,3,372
LEE,6/8/2020,207,164,3,374
LEE,6/9/2020,207,164,3,374
LEE,6/10/2020,207,165,3,375
LEE,6/11/2020,207,166,3,376
LEE,6/12/2020,208,168,3,379
LEE,6/13/2020,208,169,3,380
LEE,6/14/2020,208,169,3,380
LEE,6/15/2020,209,171,3,383
LEE,6/16/2020,212,173,3,388
LEE,6/17/2020,212,173,3,388
LEE,6/18/2020,212,173,3,388
LEE,6/19/2020,212,174,3,389
LEE,6/20/2020,212,174,3,389
LEE,6/21/2020,212,175,3,390
LEE,6/22/2020,213,176,3,392
LEE,6/23/2020,214,176,3,393
LEE,6/24/2020,214,177,3,394
LEE,6/25/2020,215,177,3,395
LEE,6/26/2020,216,177,3,396
LEE,6/27/2020,216,180,3,399
LEE,6/28/2020,219,182,3,404
LEE,6/29/2020,221,184,3,408
LEE,6/30/2020,225,186,3,414
LEE,7/1/2020,226,188,3,417
LEE,7/2/2020,228,194,3,425
LEE,7/3/2020,228,194,3,425
LEE,7/4/2020,229,196,3,428
LEE,7/5/2020,229,196,3,428
LEE,7/6/2020,231,198,3,432
LEE,7/7/2020,235,199,3,437
LEE,7/8/2020,241,202,3,446
LEE,7/9/2020,244,204,3,451
LEE,7/10/2020,247,206,3,456
LEE,7/11/2020,248,207,4,459
LEE,7/12/2020,248,207,4,459
LEE,7/13/2020,248,208,4,460
LEE,7/14/2020,250,211,4,465
LEE,7/15/2020,254,213,4,471
LEE,7/16/2020,256,214,4,474
LEE,7/17/2020,257,217,4,478
LEE,7/18/2020,260,219,4,483
LEE,7/19/2020,263,219,4,486
LEE,7/20/2020,264,222,4,490
LEE,7/21/2020,269,222,4,495
LEE,7/22/2020,271,224,4,499
LEE,7/23/2020,271,226,4,501
LEE,7/24/2020,272,228,4,504
LEE,7/25/2020,274,231,4,509
LEE,7/26/2020,276,233,4,513
LEE,7/27/2020,279,233,4,516
LEE,7/28/2020,280,235,4,519
LEE,7/29/2020,282,237,4,523
LEE,7/30/2020,284,240,4,528
LEE,7/31/2020,285,241,4,530
LEE,8/1/2020,286,242,4,532
LEE,8/2/2020,286,242,4,532
LEE,8/3/2020,290,247,4,541
LEE,8/4/2020,293,250,4,547
LEE,8/5/2020,297,252,4,553
LEE,8/6/2020,300,254,4,558
LEE,8/7/2020,302,256,4,562
LEE,8/8/2020,303,260,4,567
LEE,8/9/2020,304,261,4,569
LEE,8/10/2020,307,264,4,575
LEE,8/11/2020,309,267,4,580
LEE,8/12/2020,314,268,4,586
LEE,8/13/2020,318,270,4,592
LEE,8/14/2020,322,270,4,596
LEE,8/15/2020,323,272,4,599
LEE,8/16/2020,324,273,4,601
LEE,8/17/2020,326,275,4,605
LEE,8/18/2020,329,276,4,609
LEE,8/19/2020,332,276,4,612
LEE,8/20/2020,333,277,4,614
LEE,8/21/2020,337,278,4,619
LEE,8/22/2020,337,281,4,622
LEE,8/23/2020,337,281,4,622
LEE,8/24/2020,338,283,4,625
LEE,8/25/2020,339,283,4,626
LEE,8/26/2020,342,284,4,630
LEE,8/27/2020,344,286,4,634
LEE,8/28/2020,346,288,4,638
LEE,8/29/2020,348,291,4,643
LEE,8/30/2020,349,291,4,644
LEE,8/31/2020,350,294,4,648
LEE,9/1/2020,352,294,4,650
LEE,9/2/2020,352,295,4,651
LEE,9/3/2020,353,297,4,654
LEE,9/4/2020,354,297,4,655
LEE,9/5/2020,355,297,4,656
LEE,9/6/2020,355,299,4,658
LEE,9/7/2020,357,301,4,662
LEE,9/8/2020,359,304,4,667
LEE,9/9/2020,360,307,4,671
LEE,9/10/2020,361,309,4,674
LEE,9/11/2020,363,311,4,678
LEE,9/12/2020,364,311,4,679
LEE,9/13/2020,365,311,4,680
LEE,9/14/2020,368,313,4,685
LEE,9/15/2020,369,315,4,688
LEE,9/16/2020,369,317,4,690
LEE,9/17/2020,370,320,4,694
LEE,9/18/2020,371,320,4,695
LEE,9/19/2020,371,320,4,695
LEE,9/20/2020,371,322,4,697
LEE,9/21/2020,374,323,4,701
LEE,9/22/2020,375,323,4,702
LEE,9/23/2020,375,324,4,703
LEE,9/24/2020,377,324,4,705
LEE,9/25/2020,378,324,4,706
LEE,9/26/2020,378,324,4,706
LEE,9/27/2020,378,324,4,706
LEE,9/28/2020,378,325,4,707
LEE,9/29/2020,380,328,4,712
LEE,9/30/2020,381,330,4,715
LEE,10/1/2020,381,332,4,717
LEE,10/2/2020,382,333,4,719
LEE,10/3/2020,383,333,4,720
LEE,10/4/2020,386,334,4,724
LEE,10/5/2020,388,334,4,726
LEE,10/6/2020,390,334,4,728
LEE,10/7/2020,390,334,4,728
LEE,10/8/2020,391,334,4,729
LEE,10/9/2020,391,335,4,730
LEE,10/10/2020,392,336,4,732
LEE,10/11/2020,392,336,4,732
LEE,10/12/2020,393,336,4,733
LEE,10/13/2020,394,336,4,734
LEE,10/14/2020,396,337,4,737
LEE,10/15/2020,397,337,4,738
LEE,10/16/2020,398,337,4,739
LEE,10/17/2020,398,337,4,739
LEE,10/18/2020,398,337,4,739
LEE,10/19/2020,398,337,4,739
LEE,10/20/2020,398,337,4,739
LIBERTY,1/1/2020,0,0,0,0
LIBERTY,1/2/2020,0,0,0,0
LIBERTY,1/3/2020,0,0,0,0
LIBERTY,1/4/2020,0,0,0,0
LIBERTY,1/5/2020,0,0,0,0
LIBERTY,1/6/2020,0,0,0,0
LIBERTY,1/7/2020,0,0,0,0
LIBERTY,1/8/2020,0,0,0,0
LIBERTY,1/9/2020,0,0,0,0
LIBERTY,1/10/2020,0,0,0,0
LIBERTY,1/11/2020,0,0,0,0
LIBERTY,1/12/2020,0,0,0,0
LIBERTY,1/13/2020,0,0,0,0
LIBERTY,1/14/2020,0,0,0,0
LIBERTY,1/15/2020,0,0,0,0
LIBERTY,1/16/2020,0,0,0,0
LIBERTY,1/17/2020,0,0,0,0
LIBERTY,1/18/2020,0,0,0,0
LIBERTY,1/19/2020,0,0,0,0
LIBERTY,1/20/2020,0,0,0,0
LIBERTY,1/21/2020,0,0,0,0
LIBERTY,1/22/2020,0,0,0,0
LIBERTY,1/23/2020,0,0,0,0
LIBERTY,1/24/2020,0,0,0,0
LIBERTY,1/25/2020,0,0,0,0
LIBERTY,1/26/2020,0,0,0,0
LIBERTY,1/27/2020,0,0,0,0
LIBERTY,1/28/2020,0,0,0,0
LIBERTY,1/29/2020,0,0,0,0
LIBERTY,1/30/2020,0,0,0,0
LIBERTY,1/31/2020,0,0,0,0
LIBERTY,2/1/2020,0,0,0,0
LIBERTY,2/2/2020,0,0,0,0
LIBERTY,2/3/2020,0,0,0,0
LIBERTY,2/4/2020,0,0,0,0
LIBERTY,2/5/2020,0,0,0,0
LIBERTY,2/6/2020,0,0,0,0
LIBERTY,2/7/2020,0,0,0,0
LIBERTY,2/8/2020,0,0,0,0
LIBERTY,2/9/2020,0,0,0,0
LIBERTY,2/10/2020,0,0,0,0
LIBERTY,2/11/2020,0,0,0,0
LIBERTY,2/12/2020,0,0,0,0
LIBERTY,2/13/2020,0,0,0,0
LIBERTY,2/14/2020,0,0,0,0
LIBERTY,2/15/2020,0,0,0,0
LIBERTY,2/16/2020,0,0,0,0
LIBERTY,2/17/2020,0,0,0,0
LIBERTY,2/18/2020,0,0,0,0
LIBERTY,2/19/2020,0,0,0,0
LIBERTY,2/20/2020,0,0,0,0
LIBERTY,2/21/2020,0,0,0,0
LIBERTY,2/22/2020,0,0,0,0
LIBERTY,2/23/2020,0,0,0,0
LIBERTY,2/24/2020,0,0,0,0
LIBERTY,2/25/2020,0,0,0,0
LIBERTY,2/26/2020,0,0,0,0
LIBERTY,2/27/2020,0,0,0,0
LIBERTY,2/28/2020,0,0,0,0
LIBERTY,2/29/2020,0,0,0,0
LIBERTY,3/1/2020,0,0,0,0
LIBERTY,3/2/2020,0,0,0,0
LIBERTY,3/3/2020,0,0,0,0
LIBERTY,3/4/2020,0,0,0,0
LIBERTY,3/5/2020,0,0,0,0
LIBERTY,3/6/2020,0,0,0,0
LIBERTY,3/7/2020,0,0,0,0
LIBERTY,3/8/2020,0,0,0,0
LIBERTY,3/9/2020,0,0,0,0
LIBERTY,3/10/2020,0,0,0,0
LIBERTY,3/11/2020,0,0,0,0
LIBERTY,3/12/2020,0,1,0,1
LIBERTY,3/13/2020,0,1,0,1
LIBERTY,3/14/2020,0,1,0,1
LIBERTY,3/15/2020,0,1,0,1
LIBERTY,3/16/2020,0,1,0,1
LIBERTY,3/17/2020,0,3,0,3
LIBERTY,3/18/2020,0,5,0,5
LIBERTY,3/19/2020,0,7,0,7
LIBERTY,3/20/2020,0,8,0,8
LIBERTY,3/21/2020,0,8,0,8
LIBERTY,3/22/2020,0,8,0,8
LIBERTY,3/23/2020,0,10,0,10
LIBERTY,3/24/2020,1,10,0,11
LIBERTY,3/25/2020,1,11,0,12
LIBERTY,3/26/2020,2,11,0,13
LIBERTY,3/27/2020,2,12,0,14
LIBERTY,3/28/2020,2,12,0,14
JONES,6/26/2020,56,31,1,88
JONES,6/27/2020,59,36,1,96
JONES,6/28/2020,63,36,1,100
JONES,6/29/2020,69,46,1,116
JONES,6/30/2020,70,50,1,121
JONES,7/1/2020,72,53,1,126
JONES,7/2/2020,73,54,1,128
JONES,7/3/2020,74,56,1,131
JONES,7/4/2020,76,57,1,134
JONES,7/5/2020,81,57,1,139
JONES,7/6/2020,95,60,1,156
JONES,7/7/2020,103,66,1,170
JONES,7/8/2020,107,69,1,177
JONES,7/9/2020,110,73,1,184
JONES,7/10/2020,118,74,1,193
JONES,7/11/2020,119,77,1,197
JONES,7/12/2020,122,77,1,200
JONES,7/13/2020,136,85,1,222
JONES,7/14/2020,138,88,1,227
JONES,7/15/2020,141,93,1,235
JONES,7/16/2020,152,97,1,250
JONES,7/17/2020,159,97,2,258
JONES,7/18/2020,162,97,2,261
JONES,7/19/2020,165,101,2,268
JONES,7/20/2020,169,106,2,277
JONES,7/21/2020,173,108,2,283
JONES,7/22/2020,176,111,2,289
JONES,7/23/2020,176,112,2,290
JONES,7/24/2020,180,113,2,295
JONES,7/25/2020,183,113,2,298
JONES,7/26/2020,187,114,2,303
JONES,7/27/2020,195,115,2,312
JONES,7/28/2020,197,118,2,317
JONES,7/29/2020,200,120,2,322
JONES,7/30/2020,207,121,2,330
JONES,7/31/2020,211,122,2,335
JONES,8/1/2020,214,123,2,339
JONES,8/2/2020,215,124,2,341
JONES,8/3/2020,219,126,2,347
JONES,8/4/2020,223,131,2,356
JONES,8/5/2020,229,136,2,367
JONES,8/6/2020,233,137,2,372
JONES,8/7/2020,236,142,2,380
JONES,8/8/2020,240,144,2,386
JONES,8/9/2020,242,145,2,389
JONES,8/10/2020,247,146,2,395
JONES,8/11/2020,250,146,2,398
JONES,8/12/2020,254,152,2,408
JONES,8/13/2020,259,153,2,414
JONES,8/14/2020,261,157,2,420
JONES,8/15/2020,262,159,2,423
JONES,8/16/2020,264,161,2,427
JONES,8/17/2020,266,163,2,431
JONES,8/18/2020,268,164,2,434
JONES,8/19/2020,274,166,2,442
JONES,8/20/2020,277,167,2,446
JONES,8/21/2020,281,167,2,450
JONES,8/22/2020,283,171,2,456
JONES,8/23/2020,285,172,2,459
JONES,8/24/2020,288,173,2,463
JONES,8/25/2020,292,175,2,469
JONES,8/26/2020,298,178,2,478
JONES,8/27/2020,300,179,2,481
JONES,8/28/2020,302,181,2,485
JONES,8/29/2020,302,181,2,485
JONES,8/30/2020,304,183,2,489
JONES,8/31/2020,306,184,2,492
JONES,9/1/2020,310,187,2,499
JONES,9/2/2020,312,189,2,503
JONES,9/3/2020,317,191,2,510
JONES,9/4/2020,321,192,2,515
JONES,9/5/2020,322,197,2,521
JONES,9/6/2020,324,198,2,524
JONES,9/7/2020,328,201,2,531
JONES,9/8/2020,328,201,2,531
JONES,9/9/2020,330,201,2,533
JONES,9/10/2020,331,202,2,535
JONES,9/11/2020,331,202,2,535
JONES,9/12/2020,331,203,2,536
JONES,9/13/2020,331,203,2,536
JONES,9/14/2020,334,203,2,539
JONES,9/15/2020,335,204,2,541
JONES,9/16/2020,339,205,2,546
JONES,9/17/2020,339,205,2,546
JONES,9/18/2020,343,206,2,551
JONES,9/19/2020,347,208,2,557
JONES,9/20/2020,348,209,2,559
JONES,9/21/2020,350,211,2,563
JONES,9/22/2020,350,214,2,566
JONES,9/23/2020,352,215,2,569
JONES,9/24/2020,353,215,2,570
JONES,9/25/2020,358,216,2,576
JONES,9/26/2020,358,216,2,576
JONES,9/27/2020,359,218,2,579
JONES,9/28/2020,361,220,2,583
JONES,9/29/2020,363,221,2,586
JONES,9/30/2020,363,222,2,587
JONES,10/1/2020,367,225,2,594
JONES,10/2/2020,368,227,2,597
JONES,10/3/2020,369,227,2,598
JONES,10/4/2020,369,228,2,599
JONES,10/5/2020,371,229,2,602
JONES,10/6/2020,372,230,2,604
JONES,10/7/2020,374,231,2,607
JONES,10/8/2020,375,232,2,609
JONES,10/9/2020,376,237,2,615
JONES,10/10/2020,376,239,2,617
JONES,10/11/2020,376,240,2,618
JONES,10/12/2020,377,241,2,620
JONES,10/13/2020,378,241,2,621
JONES,10/14/2020,379,243,2,624
JONES,10/15/2020,383,243,2,628
JONES,10/16/2020,383,243,2,628
JONES,10/17/2020,383,243,2,628
JONES,10/18/2020,384,244,2,630
JONES,10/19/2020,384,244,2,630
JONES,10/20/2020,384,244,2,630
LAMAR,1/1/2020,0,0,0,0
LAMAR,1/2/2020,0,0,0,0
LAMAR,1/3/2020,0,0,0,0
LAMAR,1/4/2020,0,0,0,0
LAMAR,1/5/2020,0,0,0,0
LAMAR,1/6/2020,0,0,0,0
LAMAR,1/7/2020,0,0,0,0
LAMAR,1/8/2020,0,0,0,0
LAMAR,1/9/2020,0,0,0,0
LAMAR,1/10/2020,0,0,0,0
LAMAR,1/11/2020,0,0,0,0
LAMAR,1/12/2020,0,0,0,0
LAMAR,1/13/2020,0,0,0,0
LAMAR,1/14/2020,0,0,0,0
LAMAR,1/15/2020,0,0,0,0
LAMAR,1/16/2020,0,0,0,0
LAMAR,1/17/2020,0,0,0,0
LAMAR,1/18/2020,0,0,0,0
LAMAR,1/19/2020,0,0,0,0
LAMAR,1/20/2020,0,0,0,0
LAMAR,1/21/2020,0,0,0,0
LAMAR,1/22/2020,0,0,0,0
LAMAR,1/23/2020,0,0,0,0
LAMAR,1/24/2020,0,0,0,0
LAMAR,1/25/2020,0,0,0,0
LAMAR,1/26/2020,0,0,0,0
LAMAR,1/27/2020,0,0,0,0
LAMAR,1/28/2020,0,0,0,0
LAMAR,1/29/2020,0,0,0,0
LAMAR,1/30/2020,0,0,0,0
LAMAR,1/31/2020,0,0,0,0
LAMAR,2/1/2020,0,0,0,0
LAMAR,2/2/2020,0,0,0,0
LAMAR,2/3/2020,0,0,0,0
LAMAR,2/4/2020,0,0,0,0
LAMAR,2/5/2020,0,0,0,0
LAMAR,2/6/2020,0,0,0,0
LAMAR,2/7/2020,0,0,0,0
LAMAR,2/8/2020,0,0,0,0
LAMAR,2/9/2020,0,0,0,0
LAMAR,2/10/2020,0,0,0,0
LAMAR,2/11/2020,0,0,0,0
LAMAR,2/12/2020,0,0,0,0
LAMAR,2/13/2020,0,0,0,0
LAMAR,2/14/2020,0,0,0,0
LAMAR,2/15/2020,0,0,0,0
LAMAR,2/16/2020,0,0,0,0
LAMAR,2/17/2020,0,0,0,0
LAMAR,2/18/2020,0,0,0,0
LAMAR,2/19/2020,0,0,0,0
LAMAR,2/20/2020,0,0,0,0
LAMAR,2/21/2020,0,0,0,0
LAMAR,2/22/2020,0,0,0,0
LAMAR,2/23/2020,1,1,0,2
LAMAR,2/24/2020,1,1,0,2
LAMAR,2/25/2020,1,1,0,2
LAMAR,2/26/2020,1,1,0,2
LAMAR,2/27/2020,1,1,0,2
LAMAR,2/28/2020,1,1,0,2
LAMAR,2/29/2020,1,1,0,2
LAMAR,3/1/2020,1,1,0,2
LAMAR,3/2/2020,1,1,0,2
LAMAR,3/3/2020,1,1,0,2
LAMAR,3/4/2020,1,1,0,2
LAMAR,3/5/2020,1,1,0,2
LAMAR,3/6/2020,1,1,0,2
LAMAR,3/7/2020,1,1,0,2
LAMAR,3/8/2020,1,1,0,2
LAMAR,3/9/2020,1,1,0,2
LAMAR,3/10/2020,2,1,0,3
LAMAR,3/11/2020,2,1,0,3
LAMAR,3/12/2020,2,1,0,3
LAMAR,3/13/2020,2,1,0,3
LAMAR,3/14/2020,2,1,0,3
LAMAR,3/15/2020,2,2,0,4
LAMAR,3/16/2020,2,4,0,6
LAMAR,3/17/2020,2,4,0,6
LAMAR,3/18/2020,2,4,0,6
LAMAR,3/19/2020,2,4,0,6
LAMAR,3/20/2020,3,5,0,8
LAMAR,3/21/2020,4,5,0,9
LAMAR,3/22/2020,5,6,0,11
LAMAR,3/23/2020,5,6,0,11
LAMAR,3/24/2020,6,7,0,13
LAMAR,3/25/2020,6,7,0,13
LAMAR,3/26/2020,7,7,0,14
LAMAR,3/27/2020,8,9,0,17
LAMAR,3/28/2020,8,9,0,17
LAMAR,3/29/2020,8,10,0,18
LAMAR,3/30/2020,9,10,0,19
LAMAR,3/31/2020,10,10,0,20
LAMAR,4/1/2020,10,10,0,20
LAMAR,4/2/2020,10,10,0,20
LAMAR,4/3/2020,11,10,0,21
LAMAR,4/4/2020,11,10,0,21
LAMAR,4/5/2020,12,10,0,22
LAMAR,4/6/2020,12,11,0,23
LAMAR,4/7/2020,14,11,0,25
LAMAR,4/8/2020,17,11,0,28
LAMAR,4/9/2020,18,11,0,29
LAMAR,4/10/2020,18,11,0,29
LAMAR,4/11/2020,18,11,0,29
LAMAR,4/12/2020,18,11,0,29
LAMAR,4/13/2020,19,11,0,30
LAMAR,4/14/2020,19,13,0,32
LAMAR,4/15/2020,19,13,0,32
LAMAR,4/16/2020,20,13,0,33
LAMAR,4/17/2020,20,13,0,33
LAMAR,4/18/2020,20,13,0,33
LAMAR,4/19/2020,20,13,0,33
LAMAR,4/20/2020,21,13,0,34
LAMAR,4/21/2020,21,13,0,34
LAMAR,4/22/2020,22,15,0,37
LAMAR,4/23/2020,23,15,0,38
LAMAR,4/24/2020,24,15,0,39
LAMAR,4/25/2020,24,15,0,39
LAMAR,4/26/2020,24,15,0,39
LAMAR,4/27/2020,25,17,0,42
LAMAR,4/28/2020,27,17,0,44
LAMAR,4/29/2020,27,17,0,44
LAMAR,4/30/2020,27,17,0,44
LAMAR,5/1/2020,27,17,0,44
LAMAR,5/2/2020,27,17,0,44
LAMAR,5/3/2020,27,17,0,44
LAMAR,5/4/2020,27,17,0,44
LAMAR,5/5/2020,28,17,0,45
LAMAR,5/6/2020,29,17,0,46
LAMAR,5/7/2020,29,17,0,46
LAMAR,5/8/2020,29,17,0,46
LAMAR,5/9/2020,29,17,0,46
LAMAR,5/10/2020,30,17,0,47
LAMAR,5/11/2020,31,17,0,48
LAMAR,5/12/2020,31,18,0,49
LAMAR,5/13/2020,32,18,0,50
LAMAR,5/14/2020,33,19,0,52
LAMAR,5/15/2020,39,19,0,58
LAMAR,5/16/2020,41,19,0,60
LAMAR,5/17/2020,41,20,0,61
LAMAR,5/18/2020,42,20,0,62
LAMAR,5/19/2020,43,20,0,63
LAMAR,5/20/2020,45,23,0,68
LAMAR,5/21/2020,47,24,0,71
LAMAR,5/22/2020,47,24,0,71
LAMAR,5/23/2020,49,24,0,73
LAMAR,5/24/2020,49,25,0,74
LAMAR,5/25/2020,49,25,0,74
LAMAR,5/26/2020,54,25,0,79
LAMAR,5/27/2020,58,25,0,83
LAMAR,5/28/2020,59,25,0,84
LAMAR,5/29/2020,59,26,0,85
LAMAR,5/30/2020,60,27,0,87
LAMAR,5/31/2020,60,27,0,87
LAMAR,6/1/2020,62,28,0,90
LAMAR,6/2/2020,63,28,0,91
LAMAR,6/3/2020,63,28,0,91
LAMAR,6/4/2020,64,29,0,93
LAMAR,6/5/2020,64,29,0,93
LAMAR,6/6/2020,64,29,0,93
LAMAR,6/7/2020,66,29,0,95
LAMAR,6/8/2020,66,29,0,95
LAMAR,6/9/2020,66,30,0,96
LAMAR,6/10/2020,66,31,0,97
LAMAR,6/11/2020,67,31,0,98
LAMAR,6/12/2020,67,31,0,98
LAMAR,6/13/2020,68,31,0,99
LAMAR,6/14/2020,68,34,0,102
LAMAR,6/15/2020,72,34,0,106
LAMAR,6/16/2020,74,37,0,111
LAMAR,6/17/2020,75,37,0,112
LAMAR,6/18/2020,77,39,0,116
LAMAR,6/19/2020,79,41,0,120
LAMAR,6/20/2020,79,41,0,120
LAMAR,6/21/2020,80,41,0,121
LAMAR,6/22/2020,80,43,0,123
LAMAR,6/23/2020,81,44,0,125
LAMAR,6/24/2020,82,45,0,127
LAMAR,6/25/2020,84,47,0,131
LAMAR,6/26/2020,88,48,0,136
LAMAR,6/27/2020,88,51,1,140
LAMAR,6/28/2020,89,54,1,144
LAMAR,6/29/2020,90,56,1,147
LAMAR,6/30/2020,92,56,1,149
LAMAR,7/1/2020,94,57,2,153
LAMAR,7/2/2020,97,57,2,156
LAMAR,7/3/2020,98,58,2,158
LAMAR,7/4/2020,98,60,2,160
LAMAR,7/5/2020,98,60,2,160
LAMAR,7/6/2020,101,61,2,164
LAMAR,7/7/2020,104,63,2,169
LAMAR,7/8/2020,105,66,2,173
LAMAR,7/9/2020,106,68,2,176
LAMAR,7/10/2020,107,69,2,178
LAMAR,7/11/2020,108,72,2,182
LAMAR,7/12/2020,109,74,2,185
LAMAR,7/13/2020,112,74,2,188
LAMAR,7/14/2020,116,78,2,196
LAMAR,7/15/2020,117,82,2,201
LAMAR,7/16/2020,120,84,2,206
LAMAR,7/17/2020,122,85,2,209
LAMAR,7/18/2020,125,85,2,212
LAMAR,7/19/2020,126,87,2,215
LAMAR,7/20/2020,129,90,2,221
LAMAR,7/21/2020,131,90,2,223
LAMAR,7/22/2020,133,90,2,225
LAMAR,7/23/2020,138,93,2,233
LAMAR,7/24/2020,140,97,2,239
LAMAR,7/25/2020,144,100,2,246
LAMAR,7/26/2020,147,100,2,249
LAMAR,7/27/2020,150,103,2,255
LAMAR,7/28/2020,150,105,2,257
LAMAR,7/29/2020,152,106,2,260
LAMAR,7/30/2020,157,110,2,269
LAMAR,7/31/2020,160,113,2,275
LAMAR,8/1/2020,161,113,2,276
LAMAR,8/2/2020,161,113,2,276
LAMAR,8/3/2020,163,115,2,280
LAMAR,8/4/2020,165,120,2,287
LAMAR,8/5/2020,166,122,2,290
LAMAR,8/6/2020,167,123,2,292
LAMAR,8/7/2020,168,123,2,293
LAMAR,8/8/2020,170,123,2,295
LAMAR,8/9/2020,173,124,2,299
LAMAR,8/10/2020,174,125,2,301
LAMAR,8/11/2020,175,126,2,303
LAMAR,8/12/2020,176,129,2,307
LAMAR,8/13/2020,176,129,2,307
LAMAR,8/14/2020,177,131,2,310
LAMAR,8/15/2020,177,131,2,310
LAMAR,8/16/2020,178,132,2,312
LAMAR,8/17/2020,179,133,2,314
LAMAR,8/18/2020,179,135,2,316
LAMAR,8/19/2020,183,135,2,320
LAMAR,8/20/2020,184,135,2,321
LAMAR,8/21/2020,184,135,2,321
LAMAR,8/22/2020,185,135,2,322
LAMAR,8/23/2020,185,136,2,323
LAMAR,8/24/2020,189,138,2,329
LAMAR,8/25/2020,191,138,2,331
LAMAR,8/26/2020,191,138,2,331
LAMAR,8/27/2020,191,138,2,331
LAMAR,8/28/2020,191,139,2,332
LAMAR,8/29/2020,191,140,2,333
LAMAR,8/30/2020,192,141,2,335
LAMAR,8/31/2020,193,141,2,336
LAMAR,9/1/2020,193,142,2,337
LAMAR,9/2/2020,194,144,2,340
LAMAR,9/3/2020,195,144,2,341
LAMAR,9/4/2020,198,145,2,345
LAMAR,9/5/2020,198,145,2,345
LAMAR,9/6/2020,198,145,2,345
LAMAR,9/7/2020,199,147,2,348
LAMAR,9/8/2020,199,148,2,349
LAMAR,9/9/2020,200,149,2,351
LAMAR,9/10/2020,200,149,2,351
LAMAR,9/11/2020,201,150,2,353
LAMAR,9/12/2020,201,150,2,353
LAMAR,9/13/2020,202,150,2,354
LAMAR,9/14/2020,204,150,2,356
LAMAR,9/15/2020,204,150,2,356
LAMAR,9/16/2020,205,151,2,358
LAMAR,9/17/2020,205,152,2,359
LAMAR,9/18/2020,206,152,2,360
LAMAR,9/19/2020,207,152,2,361
LAMAR,9/20/2020,208,152,2,362
LAMAR,9/21/2020,208,155,2,365
LAMAR,9/22/2020,210,156,2,368
LAMAR,9/23/2020,211,158,2,371
LAMAR,9/24/2020,214,160,2,376
LAMAR,9/25/2020,216,160,2,378
LAMAR,9/26/2020,217,161,2,380
LAMAR,9/27/2020,219,162,2,383
LAMAR,9/28/2020,219,162,2,383
LAMAR,9/29/2020,220,163,2,385
LAMAR,9/30/2020,220,163,2,385
LAMAR,10/1/2020,220,165,2,387
LAMAR,10/2/2020,221,165,2,388
MARION,7/13/2020,83,41,0,124
MARION,7/14/2020,87,42,0,129
MARION,7/15/2020,91,42,0,133
MARION,7/16/2020,91,44,0,135
MARION,7/17/2020,91,44,0,135
MARION,7/18/2020,92,44,0,136
MARION,7/19/2020,92,44,0,136
MARION,7/20/2020,92,46,0,138
MARION,7/21/2020,92,50,0,142
MARION,7/22/2020,93,50,0,143
MARION,7/23/2020,93,51,0,144
MARION,7/24/2020,93,52,0,145
MARION,7/25/2020,94,53,0,147
MARION,7/26/2020,94,55,0,149
MARION,7/27/2020,96,59,0,155
MARION,7/28/2020,97,60,0,157
MARION,7/29/2020,97,62,0,159
MARION,7/30/2020,99,62,0,161
MARION,7/31/2020,99,62,0,161
MARION,8/1/2020,99,64,0,163
MARION,8/2/2020,100,64,0,164
MARION,8/3/2020,101,64,0,165
MARION,8/4/2020,101,64,0,165
MARION,8/5/2020,102,64,0,166
MARION,8/6/2020,102,64,1,167
MARION,8/7/2020,102,64,1,167
MARION,8/8/2020,102,64,1,167
MARION,8/9/2020,102,64,1,167
MARION,8/10/2020,102,64,1,167
MARION,8/11/2020,102,64,1,167
MARION,8/12/2020,102,65,1,168
MARION,8/13/2020,102,65,1,168
MARION,8/14/2020,102,65,1,168
MARION,8/15/2020,102,65,1,168
MARION,8/16/2020,102,65,1,168
MARION,8/17/2020,104,65,1,170
MARION,8/18/2020,104,65,1,170
MARION,8/19/2020,104,66,1,171
MARION,8/20/2020,104,66,1,171
MARION,8/21/2020,104,66,1,171
MARION,8/22/2020,105,66,1,172
MARION,8/23/2020,105,66,1,172
MARION,8/24/2020,105,66,1,172
MARION,8/25/2020,105,66,1,172
MARION,8/26/2020,105,68,1,174
MARION,8/27/2020,105,68,2,175
MARION,8/28/2020,107,68,2,177
MARION,8/29/2020,108,69,2,179
MARION,8/30/2020,108,70,2,180
MARION,8/31/2020,109,70,2,181
MARION,9/1/2020,109,70,2,181
MARION,9/2/2020,109,70,2,181
MARION,9/3/2020,109,70,2,181
MARION,9/4/2020,109,70,2,181
MARION,9/5/2020,110,70,2,182
MARION,9/6/2020,110,70,2,182
MARION,9/7/2020,110,72,2,184
MARION,9/8/2020,110,72,2,184
MARION,9/9/2020,110,73,2,185
MARION,9/10/2020,110,73,2,185
MARION,9/11/2020,112,75,2,189
MARION,9/12/2020,112,75,2,189
MARION,9/13/2020,112,75,2,189
MARION,9/14/2020,112,75,2,189
MARION,9/15/2020,112,75,2,189
MARION,9/16/2020,112,77,2,191
MARION,9/17/2020,113,78,2,193
MARION,9/18/2020,113,78,2,193
MARION,9/19/2020,113,78,2,193
MARION,9/20/2020,113,78,2,193
MARION,9/21/2020,113,78,2,193
MARION,9/22/2020,113,78,2,193
MARION,9/23/2020,113,78,2,193
MARION,9/24/2020,113,78,2,193
MARION,9/25/2020,113,78,2,193
MARION,9/26/2020,113,78,2,193
MARION,9/27/2020,113,78,2,193
MARION,9/28/2020,113,79,2,194
MARION,9/29/2020,113,79,2,194
MARION,9/30/2020,113,79,2,194
MARION,10/1/2020,113,79,2,194
MARION,10/2/2020,113,79,2,194
MARION,10/3/2020,113,79,2,194
MARION,10/4/2020,113,79,2,194
MARION,10/5/2020,113,79,2,194
MARION,10/6/2020,113,79,2,194
MARION,10/7/2020,113,79,2,194
MARION,10/8/2020,113,79,2,194
MARION,10/9/2020,113,79,2,194
MARION,10/10/2020,113,79,2,194
MARION,10/11/2020,113,80,2,195
MARION,10/12/2020,113,80,2,195
MARION,10/13/2020,113,80,2,195
MARION,10/14/2020,113,80,2,195
MARION,10/15/2020,113,80,2,195
MARION,10/16/2020,113,80,2,195
MARION,10/17/2020,113,80,2,195
MARION,10/18/2020,113,80,2,195
MARION,10/19/2020,113,80,2,195
MARION,10/20/2020,113,80,2,195
MITCHELL,1/1/2020,0,0,0,0
MITCHELL,1/2/2020,0,0,0,0
MITCHELL,1/3/2020,0,0,0,0
MITCHELL,1/4/2020,0,0,0,0
MITCHELL,1/5/2020,0,0,0,0
MITCHELL,1/6/2020,0,0,0,0
MITCHELL,1/7/2020,0,0,0,0
MITCHELL,1/8/2020,0,0,0,0
MITCHELL,1/9/2020,0,0,0,0
MITCHELL,1/10/2020,0,0,0,0
MITCHELL,1/11/2020,0,0,0,0
MITCHELL,1/12/2020,0,0,0,0
MITCHELL,1/13/2020,0,0,0,0
MITCHELL,1/14/2020,0,0,0,0
MITCHELL,1/15/2020,0,0,0,0
MITCHELL,1/16/2020,0,0,0,0
MITCHELL,1/17/2020,0,0,0,0
MITCHELL,1/18/2020,0,0,0,0
MITCHELL,1/19/2020,0,0,0,0
MITCHELL,1/20/2020,0,0,0,0
MITCHELL,1/21/2020,0,0,0,0
MITCHELL,1/22/2020,0,0,0,0
MITCHELL,1/23/2020,0,0,0,0
MITCHELL,1/24/2020,0,0,0,0
MITCHELL,1/25/2020,0,0,0,0
MITCHELL,1/26/2020,0,0,0,0
MITCHELL,1/27/2020,0,0,0,0
MITCHELL,1/28/2020,0,0,0,0
MITCHELL,1/29/2020,0,0,0,0
MITCHELL,1/30/2020,0,0,0,0
MITCHELL,1/31/2020,0,0,0,0
MITCHELL,2/1/2020,0,0,0,0
MITCHELL,2/2/2020,0,0,0,0
MITCHELL,2/3/2020,0,0,0,0
MITCHELL,2/4/2020,0,0,0,0
MITCHELL,2/5/2020,0,0,0,0
MITCHELL,2/6/2020,0,0,0,0
MITCHELL,2/7/2020,0,0,0,0
MITCHELL,2/8/2020,0,0,0,0
MITCHELL,2/9/2020,0,0,0,0
MITCHELL,2/10/2020,0,0,0,0
MITCHELL,2/11/2020,0,0,0,0
MITCHELL,2/12/2020,0,0,0,0
MITCHELL,2/13/2020,0,0,0,0
MITCHELL,2/14/2020,0,0,0,0
MITCHELL,2/15/2020,0,0,0,0
MITCHELL,2/16/2020,0,0,0,0
MITCHELL,2/17/2020,0,0,0,0
MITCHELL,2/18/2020,0,0,0,0
MITCHELL,2/19/2020,0,0,0,0
MITCHELL,2/20/2020,0,0,0,0
MITCHELL,2/21/2020,1,0,0,1
MITCHELL,2/22/2020,1,0,0,1
MITCHELL,2/23/2020,1,0,0,1
MITCHELL,2/24/2020,1,0,0,1
MITCHELL,2/25/2020,1,0,0,1
MITCHELL,2/26/2020,1,0,0,1
MITCHELL,2/27/2020,1,0,0,1
MITCHELL,2/28/2020,1,0,0,1
MITCHELL,2/29/2020,1,0,0,1
MITCHELL,3/1/2020,1,0,0,1
MITCHELL,3/2/2020,1,0,0,1
MITCHELL,3/3/2020,1,0,0,1
MITCHELL,3/4/2020,1,0,0,1
MITCHELL,3/5/2020,1,0,0,1
MITCHELL,3/6/2020,2,0,0,2
MITCHELL,3/7/2020,2,0,0,2
MITCHELL,3/8/2020,3,0,0,3
MITCHELL,3/9/2020,3,0,0,3
MITCHELL,3/10/2020,4,0,0,4
MITCHELL,3/11/2020,4,0,0,4
MITCHELL,3/12/2020,5,0,0,5
MITCHELL,3/13/2020,5,0,0,5
MITCHELL,3/14/2020,6,0,0,6
MITCHELL,3/15/2020,7,1,0,8
MITCHELL,3/16/2020,8,2,0,10
MITCHELL,3/17/2020,9,4,0,13
MITCHELL,3/18/2020,10,5,0,15
MITCHELL,3/19/2020,13,6,0,19
MITCHELL,3/20/2020,16,7,0,23
MITCHELL,3/21/2020,18,7,0,25
MITCHELL,3/22/2020,22,9,0,31
MITCHELL,3/23/2020,27,11,0,38
MITCHELL,3/24/2020,32,20,0,52
MITCHELL,3/25/2020,37,25,0,62
MITCHELL,3/26/2020,44,28,0,72
MITCHELL,3/27/2020,46,36,0,82
MITCHELL,3/28/2020,50,40,0,90
MITCHELL,3/29/2020,58,46,0,104
MITCHELL,3/30/2020,65,50,0,115
MITCHELL,3/31/2020,73,51,0,124
MITCHELL,4/1/2020,79,54,0,133
MITCHELL,4/2/2020,83,57,0,140
MITCHELL,4/3/2020,88,61,0,149
MITCHELL,4/4/2020,90,66,0,156
MITCHELL,4/5/2020,90,68,0,158
MITCHELL,4/6/2020,94,72,0,166
MITCHELL,4/7/2020,94,73,0,167
MITCHELL,4/8/2020,100,79,0,179
MITCHELL,4/9/2020,108,81,0,189
MITCHELL,4/10/2020,110,84,0,194
MITCHELL,4/11/2020,111,96,0,207
MITCHELL,4/12/2020,114,130,0,244
MITCHELL,4/13/2020,115,141,0,256
MITCHELL,4/14/2020,118,143,0,261
MITCHELL,4/15/2020,124,148,0,272
MITCHELL,4/16/2020,125,150,1,276
MITCHELL,4/17/2020,128,153,1,282
MITCHELL,4/18/2020,129,155,1,285
MITCHELL,4/19/2020,129,158,1,288
MITCHELL,4/20/2020,132,160,1,293
MITCHELL,4/21/2020,135,167,1,303
MITCHELL,4/22/2020,137,176,1,314
MITCHELL,4/23/2020,140,177,1,318
MITCHELL,4/24/2020,146,179,1,326
MITCHELL,4/25/2020,146,180,1,327
MITCHELL,4/26/2020,146,180,1,327
MITCHELL,4/27/2020,149,180,1,330
MITCHELL,4/28/2020,154,182,1,337
MITCHELL,4/29/2020,155,185,1,341
MITCHELL,4/30/2020,156,195,1,352
MITCHELL,5/1/2020,166,208,2,376
MITCHELL,5/2/2020,166,209,2,377
MITCHELL,5/3/2020,167,209,2,378
MITCHELL,5/4/2020,169,211,2,382
MITCHELL,5/5/2020,169,212,2,383
MITCHELL,5/6/2020,169,212,2,383
MITCHELL,5/7/2020,169,213,2,384
MITCHELL,5/8/2020,172,214,2,388
MITCHELL,5/9/2020,173,214,2,389
MITCHELL,5/10/2020,173,216,2,391
MITCHELL,5/11/2020,175,218,2,395
MITCHELL,5/12/2020,176,219,2,397
MITCHELL,5/13/2020,177,219,2,398
MITCHELL,5/14/2020,178,224,2,404
MITCHELL,5/15/2020,180,230,2,412
MITCHELL,5/16/2020,181,230,2,413
MITCHELL,5/17/2020,181,230,2,413
MITCHELL,5/18/2020,181,232,2,415
MITCHELL,5/19/2020,182,232,2,416
MITCHELL,5/20/2020,183,232,2,417
MITCHELL,5/21/2020,183,233,2,418
MITCHELL,5/22/2020,184,234,2,420
MITCHELL,5/23/2020,184,234,2,420
MITCHELL,5/24/2020,185,235,2,422
MITCHELL,5/25/2020,185,235,2,422
MITCHELL,5/26/2020,186,235,2,423
MITCHELL,5/27/2020,190,237,2,429
MITCHELL,5/28/2020,190,238,2,430
MITCHELL,5/29/2020,191,239,2,432
MITCHELL,5/30/2020,193,239,2,434
MITCHELL,5/31/2020,193,239,2,434
MITCHELL,6/1/2020,194,242,2,438
MITCHELL,6/2/2020,195,242,2,439
MITCHELL,6/3/2020,197,243,2,442
MITCHELL,6/4/2020,197,245,2,444
MITCHELL,6/5/2020,197,246,2,445
MITCHELL,6/6/2020,197,246,2,445
MITCHELL,6/7/2020,197,247,2,446
MITCHELL,6/8/2020,197,247,2,446
MITCHELL,6/9/2020,199,247,2,448
MITCHELL,6/10/2020,199,248,2,449
MITCHELL,6/11/2020,199,250,2,451
MITCHELL,6/12/2020,199,250,2,451
MITCHELL,6/13/2020,199,250,2,451
MITCHELL,6/14/2020,202,250,2,454
MITCHELL,6/15/2020,202,250,2,454
MITCHELL,6/16/2020,204,250,2,456
MITCHELL,6/17/2020,204,251,2,457
MITCHELL,6/18/2020,205,252,2,459
MITCHELL,6/19/2020,206,252,2,460
MITCHELL,6/20/2020,206,253,2,461
MITCHELL,6/21/2020,207,254,2,463
MITCHELL,6/22/2020,208,258,2,468
MITCHELL,6/23/2020,209,258,2,469
MITCHELL,6/24/2020,210,260,2,472
MITCHELL,6/25/2020,210,260,2,472
MITCHELL,6/26/2020,211,261,2,474
MITCHELL,6/27/2020,212,261,2,475
MITCHELL,6/28/2020,217,263,2,482
MITCHELL,6/29/2020,218,268,2,488
MITCHELL,6/30/2020,220,269,2,491
MITCHELL,7/1/2020,221,271,2,494
MITCHELL,7/2/2020,224,271,2,497
MITCHELL,7/3/2020,227,274,2,503
MITCHELL,7/4/2020,227,276,2,505
MITCHELL,7/5/2020,229,278,2,509
MITCHELL,7/6/2020,237,282,2,521
MITCHELL,7/7/2020,238,282,2,522
MITCHELL,7/8/2020,239,282,2,523
MITCHELL,7/9/2020,244,282,2,528
MITCHELL,7/10/2020,245,283,2,530
MITCHELL,7/11/2020,247,283,2,532
MITCHELL,7/12/2020,250,285,2,537
MITCHELL,7/13/2020,255,290,2,547
MITCHELL,7/14/2020,258,291,2,551
MITCHELL,7/15/2020,262,292,2,556
MITCHELL,7/16/2020,266,299,2,567
MITCHELL,7/17/2020,270,299,2,571
MITCHELL,7/18/2020,270,300,2,572
MITCHELL,7/19/2020,271,300,2,573
MITCHELL,7/20/2020,275,302,2,579
MITCHELL,7/21/2020,278,306,2,586
MITCHELL,7/22/2020,279,310,2,591
MITCHELL,7/23/2020,285,314,2,601
MITCHELL,7/24/2020,287,315,2,604
MITCHELL,7/25/2020,291,315,2,608
MITCHELL,7/26/2020,294,316,2,612
MITCHELL,7/27/2020,296,317,2,615
MITCHELL,7/28/2020,300,320,2,622
MITCHELL,7/29/2020,302,325,2,629
MITCHELL,7/30/2020,302,330,2,634
MITCHELL,7/31/2020,305,331,2,638
MITCHELL,8/1/2020,308,335,2,645
MITCHELL,8/2/2020,310,336,2,648
MITCHELL,8/3/2020,312,338,2,652
MITCHELL,8/4/2020,313,338,2,653
MITCHELL,8/5/2020,313,339,2,654
MITCHELL,8/6/2020,315,339,2,656
MITCHELL,8/7/2020,318,339,2,659
MITCHELL,8/8/2020,320,339,2,661
MITCHELL,8/9/2020,320,339,2,661
MITCHELL,8/10/2020,322,341,2,665
MITCHELL,8/11/2020,325,343,2,670
MITCHELL,8/12/2020,325,343,2,670
MITCHELL,8/13/2020,327,343,2,672
MITCHELL,8/14/2020,327,345,2,674
MITCHELL,8/15/2020,329,346,2,677
MITCHELL,8/16/2020,329,347,2,678
MITCHELL,8/17/2020,330,348,2,680
MITCHELL,8/18/2020,330,349,2,681
MITCHELL,8/19/2020,331,350,2,683
MITCHELL,8/20/2020,332,352,2,686
MITCHELL,8/21/2020,332,356,2,690
MITCHELL,8/22/2020,333,357,3,693
MITCHELL,8/23/2020,334,358,3,695
MITCHELL,8/24/2020,337,359,3,699
MITCHELL,8/25/2020,339,360,3,702
MITCHELL,8/26/2020,343,361,3,707
MITCHELL,8/27/2020,350,365,3,718
MITCHELL,8/28/2020,351,368,3,722
MITCHELL,8/29/2020,351,370,3,724
MITCHELL,8/30/2020,353,370,3,726
MITCHELL,8/31/2020,355,374,3,732
MITCHELL,9/1/2020,357,374,3,734
MITCHELL,9/2/2020,359,376,3,738
MITCHELL,9/3/2020,362,376,3,741
MITCHELL,9/4/2020,365,381,3,749
MITCHELL,9/5/2020,369,382,3,754
MITCHELL,9/6/2020,369,382,3,754
MITCHELL,9/7/2020,369,382,3,754
MITCHELL,9/8/2020,371,384,3,758
MITCHELL,9/9/2020,375,386,3,764
MITCHELL,9/10/2020,376,392,3,771
MITCHELL,9/11/2020,379,392,3,774
MITCHELL,9/12/2020,379,393,3,775
MITCHELL,9/13/2020,379,395,3,777
MITCHELL,9/14/2020,381,398,3,782
MITCHELL,9/15/2020,381,401,3,785
MITCHELL,9/16/2020,384,403,3,790
MITCHELL,9/17/2020,385,403,3,791
MITCHELL,9/18/2020,386,404,3,793
MITCHELL,9/19/2020,386,404,3,793
MITCHELL,9/20/2020,388,404,3,795
MITCHELL,9/21/2020,390,404,3,797
MITCHELL,9/22/2020,392,407,3,802
MITCHELL,9/23/2020,396,411,3,810
MITCHELL,9/24/2020,396,411,3,810
MITCHELL,9/25/2020,398,413,3,814
MITCHELL,9/26/2020,399,415,3,817
MITCHELL,9/27/2020,399,416,3,818
MITCHELL,9/28/2020,402,416,3,821
MITCHELL,9/29/2020,403,417,3,823
MITCHELL,9/30/2020,406,418,3,827
MITCHELL,10/1/2020,407,418,3,828
MITCHELL,10/2/2020,408,421,3,832
MITCHELL,10/3/2020,408,421,3,832
MITCHELL,10/4/2020,411,423,3,837
MITCHELL,10/5/2020,411,425,3,839
MITCHELL,10/6/2020,412,425,3,840
MITCHELL,10/7/2020,414,425,3,842
MITCHELL,10/8/2020,414,426,3,843
MITCHELL,10/9/2020,414,426,3,843
MITCHELL,10/10/2020,414,426,3,843
MITCHELL,10/11/2020,414,426,3,843
MITCHELL,10/12/2020,414,427,3,844
MITCHELL,10/13/2020,414,427,3,844
MITCHELL,10/14/2020,414,427,3,844
MITCHELL,10/15/2020,414,427,3,844
MITCHELL,10/16/2020,414,427,3,844
MITCHELL,10/17/2020,414,427,3,844
MITCHELL,10/18/2020,414,427,3,844
MITCHELL,10/19/2020,414,428,3,845
MITCHELL,10/20/2020,414,428,3,845
MONTGOMERY,1/1/2020,0,0,0,0
MONTGOMERY,1/2/2020,0,0,0,0
MONTGOMERY,1/3/2020,0,0,0,0
MONTGOMERY,1/4/2020,0,0,0,0
MONTGOMERY,1/5/2020,0,0,0,0
MONTGOMERY,1/6/2020,0,0,0,0
NEWTON,4/22/2020,97,80,1,178
NEWTON,4/23/2020,100,84,1,185
NEWTON,4/24/2020,102,89,1,192
NEWTON,4/25/2020,105,89,1,195
NEWTON,4/26/2020,107,89,1,197
NEWTON,4/27/2020,108,92,1,201
NEWTON,4/28/2020,110,95,2,207
NEWTON,4/29/2020,113,96,2,211
NEWTON,4/30/2020,117,102,2,221
NEWTON,5/1/2020,120,107,2,229
TAYLOR,1/31/2020,0,0,0,0
NEWTON,5/2/2020,123,107,2,232
NEWTON,5/3/2020,124,107,2,233
TAYLOR,2/1/2020,0,0,0,0
NEWTON,5/4/2020,126,111,2,239
TAYLOR,2/2/2020,0,0,0,0
NEWTON,5/5/2020,131,113,2,246
MONTGOMERY,1/7/2020,0,0,0,0
TAYLOR,2/3/2020,0,0,0,0
TAYLOR,2/4/2020,0,0,0,0
TAYLOR,2/5/2020,0,0,0,0
TAYLOR,2/6/2020,0,0,0,0
TAYLOR,2/7/2020,0,0,0,0
TAYLOR,2/8/2020,0,0,0,0
TAYLOR,2/9/2020,0,0,0,0
TAYLOR,2/10/2020,0,0,0,0
TAYLOR,2/11/2020,0,0,0,0
TAYLOR,2/12/2020,0,0,0,0
TAYLOR,2/13/2020,0,0,0,0
TAYLOR,2/14/2020,0,0,0,0
TAYLOR,2/15/2020,0,0,0,0
TAYLOR,2/16/2020,0,0,0,0
TAYLOR,2/17/2020,0,0,0,0
TAYLOR,2/18/2020,0,0,0,0
TAYLOR,2/19/2020,0,0,0,0
TAYLOR,2/20/2020,0,0,0,0
TAYLOR,2/21/2020,0,0,0,0
TAYLOR,2/22/2020,0,0,0,0
TAYLOR,2/23/2020,0,0,0,0
TAYLOR,2/24/2020,0,0,0,0
TAYLOR,2/25/2020,0,0,0,0
TAYLOR,2/26/2020,0,0,0,0
TAYLOR,2/27/2020,0,0,0,0
TAYLOR,2/28/2020,0,0,0,0
TAYLOR,2/29/2020,0,0,0,0
TAYLOR,3/1/2020,1,0,0,1
TAYLOR,3/2/2020,1,0,0,1
TAYLOR,3/3/2020,1,0,0,1
TAYLOR,3/4/2020,1,0,0,1
TAYLOR,3/5/2020,1,0,0,1
TAYLOR,3/6/2020,1,0,0,1
TAYLOR,3/7/2020,1,0,0,1
TAYLOR,3/8/2020,1,0,0,1
TAYLOR,3/9/2020,1,0,0,1
TAYLOR,3/10/2020,1,0,0,1
TAYLOR,3/11/2020,1,0,0,1
TAYLOR,3/12/2020,1,0,0,1
TAYLOR,3/13/2020,1,0,0,1
TAYLOR,3/14/2020,1,0,0,1
TAYLOR,3/15/2020,2,0,0,2
TAYLOR,3/16/2020,2,0,0,2
TAYLOR,3/17/2020,2,0,0,2
TAYLOR,3/18/2020,2,0,0,2
TAYLOR,3/19/2020,2,0,0,2
TAYLOR,3/20/2020,2,0,0,2
TAYLOR,3/21/2020,2,0,0,2
TAYLOR,3/22/2020,2,0,0,2
TAYLOR,3/23/2020,2,0,0,2
TAYLOR,3/24/2020,2,0,0,2
TAYLOR,3/25/2020,2,0,0,2
TAYLOR,3/26/2020,3,0,0,3
TAYLOR,3/27/2020,4,0,0,4
TAYLOR,3/28/2020,5,0,0,5
TAYLOR,3/29/2020,5,0,0,5
TAYLOR,3/30/2020,5,0,0,5
TAYLOR,3/31/2020,5,0,0,5
TAYLOR,4/1/2020,7,0,0,7
TAYLOR,4/2/2020,7,0,0,7
TAYLOR,4/3/2020,7,0,0,7
TAYLOR,4/4/2020,7,0,0,7
TAYLOR,4/5/2020,8,0,0,8
TAYLOR,4/6/2020,8,0,0,8
TAYLOR,4/7/2020,8,0,0,8
TAYLOR,4/8/2020,8,1,0,9
TAYLOR,4/9/2020,8,4,0,12
TAYLOR,4/10/2020,8,4,0,12
TAYLOR,4/11/2020,9,4,0,13
TAYLOR,4/12/2020,9,5,0,14
TAYLOR,4/13/2020,11,5,0,16
TAYLOR,4/14/2020,11,5,0,16
TAYLOR,4/15/2020,12,5,0,17
TAYLOR,4/16/2020,12,5,0,17
TAYLOR,4/17/2020,12,5,0,17
TAYLOR,4/18/2020,12,5,0,17
TAYLOR,4/19/2020,12,5,0,17
TAYLOR,4/20/2020,12,5,0,17
TAYLOR,4/21/2020,13,5,0,18
TAYLOR,4/22/2020,13,6,0,19
TAYLOR,4/23/2020,13,6,0,19
TAYLOR,4/24/2020,13,6,0,19
TAYLOR,4/25/2020,13,6,0,19
TAYLOR,4/26/2020,13,6,0,19
TAYLOR,4/27/2020,13,6,0,19
TAYLOR,4/28/2020,13,6,0,19
TAYLOR,4/29/2020,14,6,0,20
TAYLOR,4/30/2020,14,6,0,20
TAYLOR,5/1/2020,14,6,0,20
TAYLOR,5/2/2020,16,7,0,23
TAYLOR,5/3/2020,16,7,0,23
TAYLOR,5/4/2020,16,7,0,23
TAYLOR,5/5/2020,16,7,0,23
TAYLOR,5/6/2020,16,7,0,23
TAYLOR,5/7/2020,17,7,0,24
TAYLOR,5/8/2020,17,7,0,24
TAYLOR,5/9/2020,17,7,0,24
TAYLOR,5/10/2020,17,7,0,24
TAYLOR,5/11/2020,17,7,0,24
TAYLOR,5/12/2020,18,7,0,25
TAYLOR,5/13/2020,18,7,0,25
TAYLOR,5/14/2020,18,7,0,25
TAYLOR,5/15/2020,18,7,0,25
TAYLOR,5/16/2020,18,7,0,25
TAYLOR,5/17/2020,18,7,0,25
TAYLOR,5/18/2020,18,7,0,25
TAYLOR,5/19/2020,18,7,0,25
TAYLOR,5/20/2020,18,7,0,25
TAYLOR,5/21/2020,18,7,0,25
TAYLOR,5/22/2020,18,7,0,25
TAYLOR,5/23/2020,18,7,0,25
TAYLOR,5/24/2020,18,7,0,25
TAYLOR,5/25/2020,18,7,0,25
TAYLOR,5/26/2020,18,7,0,25
TAYLOR,5/27/2020,18,7,0,25
TAYLOR,5/28/2020,18,7,0,25
TAYLOR,5/29/2020,18,7,0,25
TAYLOR,5/30/2020,18,7,0,25
TAYLOR,5/31/2020,18,7,0,25
TAYLOR,6/1/2020,18,7,0,25
TAYLOR,6/2/2020,18,7,0,25
TAYLOR,6/3/2020,18,7,0,25
TAYLOR,6/4/2020,19,7,0,26
TAYLOR,6/5/2020,19,7,0,26
TAYLOR,6/6/2020,19,7,0,26
TAYLOR,6/7/2020,19,8,0,27
TAYLOR,6/8/2020,19,8,0,27
TAYLOR,6/9/2020,19,8,0,27
TAYLOR,6/10/2020,19,8,0,27
TAYLOR,6/11/2020,19,8,0,27
TAYLOR,6/12/2020,19,8,0,27
TAYLOR,6/13/2020,19,8,0,27
TAYLOR,6/14/2020,19,8,0,27
TAYLOR,6/15/2020,20,8,0,28
TAYLOR,6/16/2020,20,8,0,28
TAYLOR,6/17/2020,20,8,0,28
TAYLOR,6/18/2020,20,8,0,28
TAYLOR,6/19/2020,20,9,0,29
TAYLOR,6/20/2020,20,9,0,29
TAYLOR,6/21/2020,20,9,0,29
TAYLOR,6/22/2020,21,9,0,30
TAYLOR,6/23/2020,21,9,0,30
TAYLOR,6/24/2020,21,10,0,31
TAYLOR,6/25/2020,21,10,0,31
TAYLOR,6/26/2020,22,10,0,32
TAYLOR,6/27/2020,22,10,0,32
TAYLOR,6/28/2020,22,10,0,32
TAYLOR,6/29/2020,22,11,0,33
TAYLOR,6/30/2020,23,12,0,35
TAYLOR,7/1/2020,23,15,0,38
TAYLOR,7/2/2020,25,16,0,41
TAYLOR,7/3/2020,25,16,0,41
TAYLOR,7/4/2020,26,16,0,42
TAYLOR,7/5/2020,29,16,0,45
TAYLOR,7/6/2020,31,18,0,49
TAYLOR,7/7/2020,33,18,0,51
TAYLOR,7/8/2020,35,22,0,57
TAYLOR,7/9/2020,37,22,0,59
TAYLOR,7/10/2020,37,22,0,59
TAYLOR,7/11/2020,37,22,0,59
TAYLOR,7/12/2020,37,22,0,59
TAYLOR,7/13/2020,39,22,0,61
TAYLOR,7/14/2020,40,22,0,62
TAYLOR,7/15/2020,40,23,0,63
TAYLOR,7/16/2020,40,24,0,64
TAYLOR,7/17/2020,40,25,0,65
TAYLOR,7/18/2020,41,25,0,66
TAYLOR,7/19/2020,42,25,0,67
TAYLOR,7/20/2020,44,25,0,69
TAYLOR,7/21/2020,44,26,0,70
TAYLOR,7/22/2020,45,26,0,71
TAYLOR,7/23/2020,45,26,0,71
TAYLOR,7/24/2020,49,26,0,75
TAYLOR,7/25/2020,49,26,0,75
TAYLOR,7/26/2020,49,26,0,75
TAYLOR,7/27/2020,50,29,0,79
TAYLOR,7/28/2020,51,30,0,81
TAYLOR,7/29/2020,51,30,0,81
TAYLOR,7/30/2020,53,32,0,85
TAYLOR,7/31/2020,53,33,0,86
TAYLOR,8/1/2020,56,34,0,90
TAYLOR,8/2/2020,56,34,0,90
TAYLOR,8/3/2020,57,37,0,94
TAYLOR,8/4/2020,58,39,1,98
TAYLOR,8/5/2020,59,40,1,100
TAYLOR,8/6/2020,60,40,1,101
TAYLOR,8/7/2020,62,41,1,104
TAYLOR,8/8/2020,63,41,1,105
TAYLOR,8/9/2020,65,41,1,107
TAYLOR,8/10/2020,66,41,1,108
TAYLOR,8/11/2020,66,45,1,112
TAYLOR,8/12/2020,66,47,1,114
TAYLOR,8/13/2020,66,47,1,114
TAYLOR,8/14/2020,69,48,1,118
TAYLOR,8/15/2020,69,48,1,118
TAYLOR,8/16/2020,70,49,1,120
TAYLOR,8/17/2020,70,50,1,121
TAYLOR,8/18/2020,72,50,1,123
TAYLOR,8/19/2020,74,51,1,126
TAYLOR,8/20/2020,75,51,1,127
TAYLOR,8/21/2020,76,55,1,132
TAYLOR,8/22/2020,77,55,1,133
TAYLOR,8/23/2020,81,55,1,137
TAYLOR,8/24/2020,84,55,1,140
TAYLOR,8/25/2020,85,58,1,144
TAYLOR,8/26/2020,88,59,1,148
TAYLOR,8/27/2020,93,60,1,154
TAYLOR,8/28/2020,97,61,1,159
TAYLOR,8/29/2020,97,61,1,159
TAYLOR,8/30/2020,97,62,1,160
TAYLOR,8/31/2020,99,63,1,163
TAYLOR,9/1/2020,101,63,1,165
TAYLOR,9/2/2020,102,63,1,166
TAYLOR,9/3/2020,104,64,1,169
TAYLOR,9/4/2020,106,64,1,171
TAYLOR,9/5/2020,106,65,1,172
TAYLOR,9/6/2020,106,66,1,173
TAYLOR,9/7/2020,106,66,1,173
TAYLOR,9/8/2020,109,67,2,178
TAYLOR,9/9/2020,111,67,2,180
TAYLOR,9/10/2020,113,68,2,183
TAYLOR,9/11/2020,113,68,2,183
TAYLOR,9/12/2020,114,68,2,184
TAYLOR,9/13/2020,116,68,2,186
TAYLOR,9/14/2020,119,79,2,200
TAYLOR,9/15/2020,121,81,2,204
TAYLOR,9/16/2020,123,82,2,207
TAYLOR,9/17/2020,123,83,2,208
TAYLOR,9/18/2020,123,84,2,209
TAYLOR,9/19/2020,124,84,2,210
TAYLOR,9/20/2020,124,84,2,210
TAYLOR,9/21/2020,124,84,2,210
TAYLOR,9/22/2020,124,84,2,210
TAYLOR,9/23/2020,124,84,2,210
TAYLOR,9/24/2020,124,86,2,212
TAYLOR,9/25/2020,125,87,2,214
TAYLOR,9/26/2020,127,88,2,217
TAYLOR,9/27/2020,127,88,2,217
TAYLOR,9/28/2020,127,89,2,218
TAYLOR,9/29/2020,128,89,2,219
TAYLOR,9/30/2020,129,89,2,220
TAYLOR,10/1/2020,130,89,2,221
TAYLOR,10/2/2020,130,89,2,221
TAYLOR,10/3/2020,130,89,2,221
TAYLOR,10/4/2020,130,89,2,221
TAYLOR,10/5/2020,130,89,2,221
TAYLOR,10/6/2020,130,89,2,221
TAYLOR,10/7/2020,130,89,2,221
TAYLOR,10/8/2020,132,90,2,224
TAYLOR,10/9/2020,132,90,2,224
TAYLOR,10/10/2020,132,90,2,224
TAYLOR,10/11/2020,133,90,2,225
TAYLOR,10/12/2020,133,90,2,225
TAYLOR,10/13/2020,133,90,2,225
TAYLOR,10/14/2020,133,90,2,225
TAYLOR,10/15/2020,133,90,2,225
TAYLOR,10/16/2020,133,90,2,225
TAYLOR,10/17/2020,133,90,2,225
TAYLOR,10/18/2020,133,90,2,225
TAYLOR,10/19/2020,133,90,2,225
TAYLOR,10/20/2020,133,90,2,225
TERRELL,1/1/2020,0,0,0,0
TERRELL,1/2/2020,0,0,0,0
TERRELL,1/3/2020,0,0,0,0
TERRELL,1/4/2020,0,0,0,0
TERRELL,1/5/2020,0,0,0,0
TERRELL,1/6/2020,0,0,0,0
TERRELL,1/7/2020,0,0,0,0
TERRELL,1/8/2020,0,0,0,0
TERRELL,1/9/2020,0,0,0,0
TERRELL,1/10/2020,0,0,0,0
TERRELL,1/11/2020,0,0,0,0
TERRELL,1/12/2020,0,0,0,0
TERRELL,1/13/2020,0,0,0,0
TERRELL,1/14/2020,0,0,0,0
TERRELL,1/15/2020,0,0,0,0
TERRELL,1/16/2020,0,0,0,0
TERRELL,1/17/2020,0,0,0,0
TERRELL,1/18/2020,0,0,0,0
TERRELL,1/19/2020,0,0,0,0
TERRELL,1/20/2020,0,0,0,0
TERRELL,1/21/2020,0,0,0,0
TERRELL,1/22/2020,0,0,0,0
TERRELL,1/23/2020,0,0,0,0
TERRELL,1/24/2020,0,0,0,0
TERRELL,1/25/2020,0,0,0,0
TERRELL,1/26/2020,0,0,0,0
TERRELL,1/27/2020,0,0,0,0
TERRELL,1/28/2020,0,0,0,0
TERRELL,1/29/2020,0,0,0,0
TERRELL,1/30/2020,0,0,0,0
TERRELL,1/31/2020,0,0,0,0
TERRELL,2/1/2020,0,0,0,0
TERRELL,2/2/2020,0,0,0,0
TERRELL,2/3/2020,0,0,0,0
TERRELL,2/4/2020,0,0,0,0
TERRELL,2/5/2020,0,0,0,0
TERRELL,2/6/2020,0,0,0,0
TERRELL,2/7/2020,0,0,0,0
TERRELL,2/8/2020,0,0,0,0
TERRELL,2/9/2020,0,0,0,0
TERRELL,2/10/2020,0,0,0,0
TERRELL,2/11/2020,0,0,0,0
TERRELL,2/12/2020,0,0,0,0
TERRELL,2/13/2020,0,0,0,0
TERRELL,2/14/2020,0,0,0,0
TERRELL,2/15/2020,0,0,0,0
TERRELL,2/16/2020,0,0,0,0
TERRELL,2/17/2020,0,0,0,0
TERRELL,2/18/2020,0,0,0,0
TERRELL,2/19/2020,0,0,0,0
TERRELL,2/20/2020,0,0,0,0
TERRELL,2/21/2020,0,0,0,0
TERRELL,2/22/2020,0,0,0,0
TERRELL,2/23/2020,0,0,0,0
TERRELL,2/24/2020,0,0,0,0
TERRELL,2/25/2020,0,0,0,0
TERRELL,2/26/2020,0,0,0,0
TERRELL,2/27/2020,0,0,0,0
TERRELL,2/28/2020,0,0,0,0
TERRELL,2/29/2020,0,0,0,0
TERRELL,3/1/2020,0,0,0,0
TERRELL,3/2/2020,0,0,0,0
TERRELL,3/3/2020,0,0,0,0
TERRELL,3/4/2020,0,0,0,0
TERRELL,3/5/2020,0,1,0,1
TERRELL,3/6/2020,0,1,0,1
TERRELL,3/7/2020,0,1,0,1
TERRELL,3/8/2020,0,1,0,1
TERRELL,3/9/2020,0,1,0,1
TERRELL,3/10/2020,0,2,0,2
TERRELL,3/11/2020,0,2,0,2
TERRELL,3/12/2020,0,3,0,3
TERRELL,3/13/2020,0,3,0,3
TERRELL,3/14/2020,2,3,0,5
TERRELL,3/15/2020,3,3,0,6
TERRELL,3/16/2020,5,3,0,8
TERRELL,3/17/2020,5,4,0,9
TERRELL,3/18/2020,7,5,0,12
TERRELL,3/19/2020,9,7,0,16
TERRELL,3/20/2020,13,10,0,23
TERRELL,3/21/2020,19,11,0,30
TERRELL,3/22/2020,20,11,0,31
TERRELL,3/23/2020,23,13,0,36
TERRELL,3/24/2020,34,18,0,52
TERRELL,3/25/2020,38,18,0,56
TERRELL,3/26/2020,43,18,0,61
TERRELL,3/27/2020,46,22,0,68
TERRELL,3/28/2020,50,26,0,76
TERRELL,3/29/2020,51,27,0,78
TERRELL,3/30/2020,54,28,0,82
TERRELL,3/31/2020,56,29,0,85
TERRELL,4/1/2020,63,30,0,93
TERRELL,4/2/2020,66,31,0,97
TERRELL,4/3/2020,68,35,0,103
TERRELL,4/4/2020,75,35,2,112
TERRELL,4/5/2020,77,35,2,114
TERRELL,4/6/2020,83,38,3,124
TERRELL,4/7/2020,86,41,3,130
TERRELL,4/8/2020,87,41,4,132
TERRELL,4/9/2020,89,42,4,135
TERRELL,4/10/2020,89,44,4,137
TERRELL,4/11/2020,90,45,4,139
TERRELL,4/12/2020,90,45,4,139
TERRELL,4/13/2020,92,46,4,142
TERRELL,4/14/2020,97,48,4,149
TERRELL,4/15/2020,98,49,4,151
TERRELL,4/16/2020,101,51,4,156
TERRELL,4/17/2020,104,51,4,159
TERRELL,4/18/2020,105,51,4,160
TERRELL,4/19/2020,105,51,4,160
TERRELL,4/20/2020,106,54,5,165
TERRELL,4/21/2020,106,55,5,166
TERRELL,4/22/2020,108,56,5,169
TERRELL,4/23/2020,109,57,5,171
TERRELL,4/24/2020,114,57,5,176
TERRELL,4/25/2020,117,57,5,179
TERRELL,4/26/2020,117,57,5,179
TERRELL,4/27/2020,121,57,5,183
TERRELL,4/28/2020,122,58,5,185
TERRELL,4/29/2020,123,58,5,186
TERRELL,4/30/2020,126,58,5,189
TERRELL,5/1/2020,128,59,5,192
TERRELL,5/2/2020,129,59,5,193
TERRELL,5/3/2020,129,59,5,193
TERRELL,5/4/2020,130,59,5,194
TERRELL,5/5/2020,130,59,5,194
TERRELL,5/6/2020,130,59,5,194
TERRELL,5/7/2020,130,59,5,194
TERRELL,5/8/2020,130,59,5,194
TERRELL,5/9/2020,131,59,5,195
TERRELL,5/10/2020,131,59,5,195
TERRELL,5/11/2020,131,61,5,197
TERRELL,5/12/2020,132,62,5,199
TERRELL,5/13/2020,133,62,5,200
TERRELL,5/14/2020,133,62,5,200
TERRELL,5/15/2020,133,62,5,200
POLK,8/6/2020,491,451,25,967
NEWTON,5/6/2020,135,115,2,252
NEWTON,5/7/2020,138,116,2,256
MONTGOMERY,1/8/2020,0,0,0,0
NEWTON,5/8/2020,141,118,2,261
NEWTON,5/9/2020,141,118,2,261
NEWTON,5/10/2020,143,120,2,265
NEWTON,5/11/2020,143,123,2,268
NEWTON,5/12/2020,144,126,2,272
NEWTON,5/13/2020,148,131,2,281
NEWTON,5/14/2020,148,136,2,286
NEWTON,5/15/2020,149,140,2,291
NEWTON,5/16/2020,150,140,2,292
NEWTON,5/17/2020,155,142,2,299
NEWTON,5/18/2020,162,144,2,308
NEWTON,5/19/2020,166,150,2,318
NEWTON,5/20/2020,171,155,2,328
NEWTON,5/21/2020,180,162,2,344
NEWTON,5/22/2020,185,164,2,351
NEWTON,5/23/2020,188,164,2,354
NEWTON,5/24/2020,191,165,2,358
NEWTON,5/25/2020,195,165,2,362
NEWTON,5/26/2020,199,166,2,367
NEWTON,5/27/2020,202,174,2,378
NEWTON,5/28/2020,205,175,2,382
NEWTON,5/29/2020,208,178,2,388
NEWTON,5/30/2020,209,180,2,391
NEWTON,5/31/2020,211,181,2,394
NEWTON,6/1/2020,215,184,2,401
NEWTON,6/2/2020,216,186,2,404
NEWTON,6/3/2020,218,189,2,409
NEWTON,6/4/2020,218,190,2,410
NEWTON,6/5/2020,222,194,2,418
NEWTON,6/6/2020,225,198,2,425
NEWTON,6/7/2020,226,200,2,428
NEWTON,6/8/2020,231,202,2,435
NEWTON,6/9/2020,233,207,2,442
NEWTON,6/10/2020,241,210,2,453
NEWTON,6/11/2020,254,213,2,469
NEWTON,6/12/2020,259,218,2,479
NEWTON,6/13/2020,261,220,2,483
NEWTON,6/14/2020,267,223,2,492
NEWTON,6/15/2020,275,234,2,511
NEWTON,6/16/2020,282,244,2,528
NEWTON,6/17/2020,292,246,2,540
NEWTON,6/18/2020,304,252,2,558
NEWTON,6/19/2020,312,256,2,570
NEWTON,6/20/2020,318,260,2,580
NEWTON,6/21/2020,320,269,2,591
NEWTON,6/22/2020,331,288,5,624
NEWTON,6/23/2020,344,295,5,644
NEWTON,6/24/2020,357,303,7,667
NEWTON,6/25/2020,369,314,8,691
NEWTON,6/26/2020,376,330,8,714
NEWTON,6/27/2020,383,337,8,728
NEWTON,6/28/2020,390,339,9,738
NEWTON,6/29/2020,407,348,12,767
NEWTON,6/30/2020,427,369,13,809
NEWTON,7/1/2020,463,390,16,869
NEWTON,7/2/2020,497,403,16,916
NEWTON,7/3/2020,543,424,19,986
NEWTON,7/4/2020,554,434,19,1007
NEWTON,7/5/2020,567,444,19,1030
NEWTON,7/6/2020,595,466,20,1081
NEWTON,7/7/2020,624,481,23,1128
NEWTON,7/8/2020,652,506,26,1184
NEWTON,7/9/2020,691,524,28,1243
NEWTON,7/10/2020,707,542,28,1277
NEWTON,7/11/2020,719,550,30,1299
NEWTON,7/12/2020,735,557,30,1322
NEWTON,7/13/2020,754,574,34,1362
NEWTON,7/14/2020,770,595,38,1403
NEWTON,7/15/2020,794,614,44,1452
NEWTON,7/16/2020,811,629,44,1484
NEWTON,7/17/2020,831,641,45,1517
NEWTON,7/18/2020,846,649,45,1540
NEWTON,7/19/2020,858,651,45,1554
NEWTON,7/20/2020,883,673,45,1601
NEWTON,7/21/2020,901,689,46,1636
NEWTON,7/22/2020,915,701,46,1662
NEWTON,7/23/2020,932,712,47,1691
NEWTON,7/24/2020,951,720,47,1718
NEWTON,7/25/2020,964,729,47,1740
NEWTON,7/26/2020,973,733,48,1754
NEWTON,7/27/2020,987,748,48,1783
NEWTON,7/28/2020,999,761,48,1808
NEWTON,7/29/2020,1019,769,48,1836
NEWTON,7/30/2020,1038,780,48,1866
NEWTON,7/31/2020,1050,792,48,1890
NEWTON,8/1/2020,1059,797,48,1904
NEWTON,8/2/2020,1065,804,48,1917
NEWTON,8/3/2020,1078,819,48,1945
NEWTON,8/4/2020,1102,834,50,1986
NEWTON,8/5/2020,1118,845,50,2013
NEWTON,8/6/2020,1138,853,51,2042
NEWTON,8/7/2020,1150,864,51,2065
NEWTON,8/8/2020,1156,867,51,2074
NEWTON,8/9/2020,1161,869,51,2081
NEWTON,8/10/2020,1176,877,51,2104
NEWTON,8/11/2020,1185,885,51,2121
NEWTON,8/12/2020,1197,896,51,2144
NEWTON,8/13/2020,1212,907,51,2170
NEWTON,8/14/2020,1223,919,51,2193
NEWTON,8/15/2020,1230,921,51,2202
NEWTON,8/16/2020,1241,921,51,2213
NEWTON,8/17/2020,1255,930,51,2236
NEWTON,8/18/2020,1265,937,52,2254
NEWTON,8/19/2020,1275,941,52,2268
NEWTON,8/20/2020,1279,950,54,2283
NEWTON,8/21/2020,1288,963,54,2305
NEWTON,8/22/2020,1293,970,54,2317
NEWTON,8/23/2020,1303,972,54,2329
NEWTON,8/24/2020,1315,987,54,2356
NEWTON,8/25/2020,1327,994,54,2375
NEWTON,8/26/2020,1334,1002,54,2390
NEWTON,8/27/2020,1340,1005,54,2399
NEWTON,8/28/2020,1349,1013,54,2416
NEWTON,8/29/2020,1355,1016,54,2425
NEWTON,8/30/2020,1362,1021,54,2437
NEWTON,8/31/2020,1368,1028,54,2450
NEWTON,9/1/2020,1373,1032,54,2459
NEWTON,9/2/2020,1380,1037,54,2471
NEWTON,9/3/2020,1382,1039,54,2475
NEWTON,9/4/2020,1389,1044,54,2487
NEWTON,9/5/2020,1391,1048,54,2493
NEWTON,9/6/2020,1396,1051,54,2501
NEWTON,9/7/2020,1401,1053,54,2508
NEWTON,9/8/2020,1411,1064,54,2529
NEWTON,9/9/2020,1419,1071,54,2544
NEWTON,9/10/2020,1426,1075,54,2555
NEWTON,9/11/2020,1428,1076,54,2558
NEWTON,9/12/2020,1428,1081,54,2563
NEWTON,9/13/2020,1431,1082,54,2567
NEWTON,9/14/2020,1433,1086,54,2573
NEWTON,9/15/2020,1440,1093,54,2587
NEWTON,9/16/2020,1445,1096,54,2595
NEWTON,9/17/2020,1449,1099,54,2602
NEWTON,9/18/2020,1450,1102,54,2606
NEWTON,9/19/2020,1451,1107,54,2612
NEWTON,9/20/2020,1452,1107,54,2613
NEWTON,9/21/2020,1463,1112,55,2630
NEWTON,9/22/2020,1464,1113,55,2632
NEWTON,9/23/2020,1470,1117,55,2642
NEWTON,9/24/2020,1474,1121,55,2650
NEWTON,9/25/2020,1480,1125,55,2660
NEWTON,9/26/2020,1485,1128,55,2668
NEWTON,9/27/2020,1489,1131,56,2676
NEWTON,9/28/2020,1496,1134,56,2686
NEWTON,9/29/2020,1497,1139,56,2692
NEWTON,9/30/2020,1500,1142,56,2698
NEWTON,10/1/2020,1503,1145,56,2704
NEWTON,10/2/2020,1507,1148,56,2711
NEWTON,10/3/2020,1508,1152,56,2716
NEWTON,10/4/2020,1512,1152,56,2720
NEWTON,10/5/2020,1518,1155,56,2729
NEWTON,10/6/2020,1524,1156,56,2736
NEWTON,10/7/2020,1526,1158,56,2740
NEWTON,10/8/2020,1534,1164,56,2754
NEWTON,10/9/2020,1538,1168,56,2762
NEWTON,10/10/2020,1539,1169,56,2764
NEWTON,10/11/2020,1540,1169,56,2765
NEWTON,10/12/2020,1541,1174,56,2771
NEWTON,10/13/2020,1548,1177,56,2781
NEWTON,10/14/2020,1553,1180,56,2789
NEWTON,10/15/2020,1556,1181,56,2793
NEWTON,10/16/2020,1559,1181,56,2796
NEWTON,10/17/2020,1559,1181,56,2796
NEWTON,10/18/2020,1559,1181,56,2796
NEWTON,10/19/2020,1560,1181,56,2797
NEWTON,10/20/2020,1560,1181,56,2797
POLK,1/1/2020,0,0,0,0
POLK,1/2/2020,0,0,0,0
POLK,1/3/2020,0,0,0,0
POLK,1/4/2020,0,0,0,0
POLK,1/5/2020,0,0,0,0
POLK,1/6/2020,0,0,0,0
POLK,1/7/2020,0,0,0,0
POLK,1/8/2020,0,0,0,0
POLK,1/9/2020,0,0,0,0
POLK,1/10/2020,0,0,0,0
POLK,1/11/2020,0,0,0,0
POLK,1/12/2020,0,0,0,0
POLK,1/13/2020,0,0,0,0
POLK,1/14/2020,0,0,0,0
POLK,1/15/2020,0,0,0,0
POLK,1/16/2020,0,0,0,0
POLK,1/17/2020,0,0,0,0
POLK,1/18/2020,0,0,0,0
POLK,1/19/2020,0,0,0,0
POLK,1/20/2020,0,0,0,0
POLK,1/21/2020,0,0,0,0
POLK,1/22/2020,0,0,0,0
POLK,1/23/2020,0,0,0,0
POLK,1/24/2020,0,0,0,0
POLK,1/25/2020,0,0,0,0
POLK,1/26/2020,0,0,0,0
POLK,1/27/2020,0,0,0,0
POLK,1/28/2020,0,0,0,0
POLK,1/29/2020,0,0,0,0
POLK,1/30/2020,0,0,0,0
POLK,1/31/2020,0,0,0,0
POLK,2/1/2020,0,0,0,0
POLK,2/2/2020,0,0,0,0
POLK,2/3/2020,0,0,0,0
POLK,2/4/2020,0,0,0,0
POLK,2/5/2020,0,0,0,0
POLK,2/6/2020,0,0,0,0
POLK,2/7/2020,0,0,0,0
POLK,2/8/2020,0,0,0,0
POLK,2/9/2020,0,0,0,0
POLK,2/10/2020,0,0,0,0
POLK,2/11/2020,1,0,0,1
POLK,2/12/2020,1,0,0,1
POLK,2/13/2020,1,0,0,1
POLK,2/14/2020,1,0,0,1
POLK,2/15/2020,1,0,0,1
POLK,2/16/2020,1,0,0,1
POLK,2/17/2020,1,0,0,1
POLK,2/18/2020,1,0,0,1
POLK,2/19/2020,1,0,0,1
POLK,2/20/2020,1,0,0,1
POLK,2/21/2020,1,0,0,1
POLK,2/22/2020,1,0,0,1
POLK,2/23/2020,2,0,0,2
POLK,2/24/2020,2,0,0,2
POLK,2/25/2020,2,0,0,2
POLK,2/26/2020,2,0,0,2
POLK,2/27/2020,2,0,0,2
POLK,2/28/2020,2,0,0,2
POLK,2/29/2020,2,0,0,2
POLK,3/1/2020,2,1,0,3
POLK,3/2/2020,2,1,0,3
POLK,3/3/2020,2,1,0,3
POLK,3/4/2020,2,1,0,3
POLK,3/5/2020,2,1,0,3
POLK,3/6/2020,2,1,0,3
POLK,3/7/2020,2,1,0,3
POLK,3/8/2020,2,1,0,3
POLK,3/9/2020,2,1,0,3
POLK,3/10/2020,2,1,0,3
POLK,3/11/2020,2,1,0,3
POLK,3/12/2020,3,2,0,5
POLK,3/13/2020,3,2,0,5
POLK,3/14/2020,3,2,0,5
POLK,3/15/2020,3,4,0,7
POLK,3/16/2020,5,5,0,10
POLK,3/17/2020,6,6,0,12
POLK,3/18/2020,6,6,0,12
POLK,3/19/2020,6,6,0,12
POLK,3/20/2020,8,7,0,15
POLK,3/21/2020,8,7,0,15
POLK,3/22/2020,9,7,0,16
POLK,3/23/2020,10,8,0,18
POLK,3/24/2020,10,8,0,18
POLK,3/25/2020,10,10,0,20
POLK,3/26/2020,10,10,0,20
POLK,3/27/2020,10,10,0,20
POLK,3/28/2020,10,10,0,20
POLK,3/29/2020,11,10,0,21
POLK,3/30/2020,12,11,0,23
POLK,3/31/2020,12,12,0,24
POLK,4/1/2020,12,12,0,24
POLK,4/2/2020,12,12,0,24
POLK,4/3/2020,12,12,0,24
POLK,4/4/2020,12,14,0,26
POLK,4/5/2020,13,15,0,28
POLK,4/6/2020,15,17,0,32
POLK,4/7/2020,17,19,0,36
POLK,4/8/2020,17,19,0,36
POLK,4/9/2020,19,19,0,38
POLK,4/10/2020,20,19,0,39
POLK,4/11/2020,20,21,0,41
POLK,4/12/2020,21,21,0,42
POLK,4/13/2020,21,21,0,42
POLK,4/14/2020,23,22,0,45
POLK,4/15/2020,25,23,0,48
POLK,4/16/2020,27,25,0,52
POLK,4/17/2020,30,25,0,55
POLK,4/18/2020,31,25,0,56
POLK,4/19/2020,32,25,0,57
POLK,4/20/2020,32,25,0,57
POLK,4/21/2020,33,27,0,60
POLK,4/22/2020,33,28,0,61
POLK,4/23/2020,33,32,0,65
POLK,4/24/2020,33,33,0,66
POLK,4/25/2020,33,34,0,67
POLK,4/26/2020,33,35,0,68
POLK,4/27/2020,34,36,0,70
POLK,4/28/2020,35,37,0,72
POLK,4/29/2020,36,37,0,73
POLK,4/30/2020,36,39,0,75
POLK,5/1/2020,36,41,0,77
POLK,5/2/2020,36,41,0,77
POLK,5/3/2020,36,41,0,77
POLK,5/4/2020,36,41,0,77
POLK,5/5/2020,36,42,0,78
POLK,5/6/2020,38,42,0,80
POLK,5/7/2020,38,42,0,80
POLK,5/8/2020,39,44,0,83
POLK,5/9/2020,40,44,0,84
POLK,5/10/2020,41,44,0,85
POLK,5/11/2020,41,46,0,87
POLK,5/12/2020,41,47,0,88
POLK,5/13/2020,42,49,0,91
POLK,5/14/2020,42,51,0,93
POLK,5/15/2020,43,52,0,95
POLK,5/16/2020,43,57,0,100
POLK,5/17/2020,44,59,0,103
POLK,5/18/2020,45,63,0,108
POLK,5/19/2020,47,63,0,110
POLK,5/20/2020,50,64,0,114
POLK,5/21/2020,51,65,0,116
POLK,5/22/2020,53,65,0,118
POLK,5/23/2020,54,67,0,121
POLK,5/24/2020,56,69,0,125
POLK,5/25/2020,57,69,0,126
POLK,5/26/2020,60,71,0,131
POLK,5/27/2020,60,71,0,131
POLK,5/28/2020,62,71,0,133
POLK,5/29/2020,66,74,0,140
POLK,5/30/2020,67,76,0,143
POLK,5/31/2020,69,77,0,146
POLK,6/1/2020,70,78,0,148
POLK,6/2/2020,71,80,0,151
POLK,6/3/2020,72,81,0,153
POLK,6/4/2020,76,83,1,160
POLK,6/5/2020,77,85,1,163
POLK,6/6/2020,78,86,1,165
POLK,6/7/2020,78,87,1,166
POLK,6/8/2020,79,89,1,169
POLK,6/9/2020,80,90,1,171
POLK,6/10/2020,82,92,1,175
POLK,6/11/2020,82,92,1,175
POLK,6/12/2020,86,93,1,180
POLK,6/13/2020,88,93,1,182
POLK,6/14/2020,91,93,1,185
POLK,6/15/2020,92,97,1,190
POLK,6/16/2020,93,99,1,193
POLK,6/17/2020,94,101,1,196
POLK,6/18/2020,97,102,1,200
POLK,6/19/2020,101,102,1,204
POLK,6/20/2020,102,102,1,205
POLK,6/21/2020,103,102,1,206
POLK,6/22/2020,106,106,1,213
POLK,6/23/2020,106,108,1,215
POLK,6/24/2020,107,114,1,222
POLK,6/25/2020,109,117,1,227
POLK,6/26/2020,111,122,2,235
POLK,6/27/2020,112,125,2,239
POLK,6/28/2020,114,127,2,243
POLK,6/29/2020,125,138,2,265
POLK,6/30/2020,131,141,3,275
POLK,7/1/2020,148,153,4,305
POLK,7/2/2020,157,157,5,319
POLK,7/3/2020,167,170,5,342
POLK,7/4/2020,176,177,6,359
POLK,7/5/2020,180,179,7,366
POLK,7/6/2020,198,203,10,411
POLK,7/7/2020,212,214,12,438
POLK,7/8/2020,222,222,14,458
POLK,7/9/2020,233,236,14,483
POLK,7/10/2020,242,243,15,500
POLK,7/11/2020,256,254,15,525
POLK,7/12/2020,261,260,15,536
POLK,7/13/2020,280,268,16,564
POLK,7/14/2020,300,275,17,592
POLK,7/15/2020,306,284,18,608
POLK,7/16/2020,314,289,19,622
POLK,7/17/2020,321,302,20,643
POLK,7/18/2020,325,311,20,656
POLK,7/19/2020,327,312,21,660
POLK,7/20/2020,333,318,21,672
POLK,7/21/2020,353,326,21,700
POLK,7/22/2020,373,338,23,734
POLK,7/23/2020,386,343,23,752
POLK,7/24/2020,392,348,23,763
POLK,7/25/2020,397,354,23,774
POLK,7/26/2020,400,356,23,779
POLK,7/27/2020,406,365,23,794
POLK,7/28/2020,415,375,23,813
POLK,7/29/2020,424,386,23,833
POLK,7/30/2020,430,394,23,847
POLK,7/31/2020,434,403,23,860
POLK,8/1/2020,443,407,23,873
POLK,8/2/2020,445,415,23,883
POLK,8/3/2020,455,425,23,903
POLK,8/4/2020,475,437,25,937
POLK,8/5/2020,483,442,25,950
POLK,8/7/2020,498,464,26,988
POLK,8/8/2020,502,472,26,1000
POLK,8/9/2020,506,477,26,1009
POLK,8/10/2020,515,487,26,1028
POLK,8/11/2020,533,498,26,1057
POLK,8/12/2020,539,507,26,1072
POLK,8/13/2020,547,513,26,1086
POLK,8/14/2020,557,522,26,1105
POLK,8/15/2020,562,530,26,1118
POLK,8/16/2020,563,533,26,1122
POLK,8/17/2020,571,538,26,1135
POLK,8/18/2020,580,550,26,1156
POLK,8/19/2020,591,559,27,1177
POLK,8/20/2020,601,571,28,1200
POLK,8/21/2020,609,573,28,1210
POLK,8/22/2020,618,584,28,1230
POLK,8/23/2020,620,586,28,1234
POLK,8/24/2020,628,594,30,1252
POLK,8/25/2020,637,601,32,1270
POLK,8/26/2020,644,607,33,1284
POLK,8/27/2020,649,613,33,1295
POLK,8/28/2020,653,615,33,1301
POLK,8/29/2020,656,617,33,1306
POLK,8/30/2020,657,621,33,1311
POLK,8/31/2020,665,629,33,1327
POLK,9/1/2020,668,633,33,1334
POLK,9/2/2020,669,639,34,1342
POLK,9/3/2020,671,643,34,1348
POLK,9/4/2020,675,646,34,1355
POLK,9/5/2020,678,649,34,1361
POLK,9/6/2020,682,650,34,1366
POLK,9/7/2020,684,652,34,1370
POLK,9/8/2020,693,655,34,1382
POLK,9/9/2020,694,661,34,1389
MONTGOMERY,1/9/2020,0,0,0,0
POLK,9/10/2020,696,668,34,1398
POLK,9/11/2020,702,671,34,1407
POLK,9/12/2020,704,674,34,1412
POLK,9/13/2020,707,675,34,1416
POLK,9/14/2020,714,678,34,1426
POLK,9/15/2020,723,679,35,1437
POLK,9/16/2020,727,682,35,1444
POLK,9/17/2020,734,684,35,1453
POLK,9/18/2020,746,688,35,1469
POLK,9/19/2020,750,692,35,1477
POLK,9/20/2020,754,692,35,1481
POLK,9/21/2020,756,696,35,1487
POLK,9/22/2020,761,702,35,1498
POLK,9/23/2020,762,706,35,1503
POLK,9/24/2020,766,709,35,1510
POLK,9/25/2020,767,713,35,1515
POLK,9/26/2020,769,715,35,1519
POLK,9/27/2020,772,717,35,1524
POLK,9/28/2020,776,717,35,1528
POLK,9/29/2020,781,717,35,1533
POLK,9/30/2020,782,719,35,1536
POLK,10/1/2020,783,724,35,1542
POLK,10/2/2020,787,728,36,1551
POLK,10/3/2020,791,728,36,1555
POLK,10/4/2020,791,731,36,1558
POLK,10/5/2020,793,737,36,1566
POLK,10/6/2020,798,741,36,1575
POLK,10/7/2020,800,742,36,1578
POLK,10/8/2020,806,744,36,1586
POLK,10/9/2020,812,745,36,1593
POLK,10/10/2020,813,747,36,1596
POLK,10/11/2020,814,747,36,1597
POLK,10/12/2020,815,751,36,1602
POLK,10/13/2020,822,757,36,1615
POLK,10/14/2020,825,760,36,1621
POLK,10/15/2020,831,763,36,1630
POLK,10/16/2020,833,765,36,1634
POLK,10/17/2020,836,766,36,1638
POLK,10/18/2020,836,766,36,1638
POLK,10/19/2020,836,767,36,1639
POLK,10/20/2020,836,768,36,1640
STEPHENS,1/1/2020,0,0,0,0
STEPHENS,1/2/2020,0,0,0,0
STEPHENS,1/3/2020,0,0,0,0
STEPHENS,1/4/2020,0,0,0,0
STEPHENS,1/5/2020,0,0,0,0
STEPHENS,1/6/2020,0,0,0,0
STEPHENS,1/7/2020,0,0,0,0
STEPHENS,1/8/2020,0,0,0,0
STEPHENS,1/9/2020,0,0,0,0
STEPHENS,1/10/2020,0,0,0,0
STEPHENS,1/11/2020,0,0,0,0
STEPHENS,1/12/2020,0,0,0,0
STEPHENS,1/13/2020,0,0,0,0
STEPHENS,1/14/2020,0,0,0,0
STEPHENS,1/15/2020,0,0,0,0
STEPHENS,1/16/2020,0,0,0,0
STEPHENS,1/17/2020,0,0,0,0
STEPHENS,1/18/2020,0,0,0,0
STEPHENS,1/19/2020,0,0,0,0
STEPHENS,1/20/2020,0,0,0,0
STEPHENS,1/21/2020,0,0,0,0
STEPHENS,1/22/2020,0,0,0,0
STEPHENS,1/23/2020,0,0,0,0
STEPHENS,1/24/2020,0,0,0,0
STEPHENS,1/25/2020,0,0,0,0
STEPHENS,1/26/2020,0,0,0,0
STEPHENS,1/27/2020,0,0,0,0
STEPHENS,1/28/2020,0,0,0,0
STEPHENS,1/29/2020,0,0,0,0
STEPHENS,1/30/2020,0,0,0,0
STEPHENS,1/31/2020,0,0,0,0
STEPHENS,2/1/2020,0,0,0,0
STEPHENS,2/2/2020,0,0,0,0
STEPHENS,2/3/2020,0,0,0,0
STEPHENS,2/4/2020,0,0,0,0
STEPHENS,2/5/2020,0,0,0,0
STEPHENS,2/6/2020,0,0,0,0
STEPHENS,2/7/2020,0,0,0,0
STEPHENS,2/8/2020,0,0,0,0
STEPHENS,2/9/2020,0,0,0,0
STEPHENS,2/10/2020,0,0,0,0
STEPHENS,2/11/2020,0,0,0,0
STEPHENS,2/12/2020,0,0,0,0
STEPHENS,2/13/2020,0,0,0,0
STEPHENS,2/14/2020,0,0,0,0
STEPHENS,2/15/2020,0,0,0,0
STEPHENS,2/16/2020,0,0,0,0
STEPHENS,2/17/2020,0,0,0,0
STEPHENS,2/18/2020,0,0,0,0
STEPHENS,2/19/2020,0,0,0,0
STEPHENS,2/20/2020,0,0,0,0
STEPHENS,2/21/2020,0,0,0,0
STEPHENS,2/22/2020,0,0,0,0
STEPHENS,2/23/2020,0,0,0,0
STEPHENS,2/24/2020,0,0,0,0
STEPHENS,2/25/2020,0,0,0,0
STEPHENS,2/26/2020,0,0,0,0
STEPHENS,2/27/2020,0,0,0,0
STEPHENS,2/28/2020,0,0,0,0
STEPHENS,2/29/2020,0,0,0,0
STEPHENS,3/1/2020,0,0,0,0
STEPHENS,3/2/2020,0,0,0,0
STEPHENS,3/3/2020,0,0,0,0
STEPHENS,3/4/2020,0,0,0,0
STEPHENS,3/5/2020,0,0,0,0
STEPHENS,3/6/2020,0,0,0,0
STEPHENS,3/7/2020,0,0,0,0
STEPHENS,3/8/2020,0,1,0,1
STEPHENS,3/9/2020,0,1,0,1
STEPHENS,3/10/2020,0,1,0,1
STEPHENS,3/11/2020,0,1,0,1
STEPHENS,3/12/2020,1,1,0,2
STEPHENS,3/13/2020,1,1,0,2
STEPHENS,3/14/2020,1,1,0,2
STEPHENS,3/15/2020,1,1,0,2
STEPHENS,3/16/2020,1,1,0,2
STEPHENS,3/17/2020,1,1,0,2
STEPHENS,3/18/2020,1,2,0,3
STEPHENS,3/19/2020,1,2,0,3
STEPHENS,3/20/2020,1,2,0,3
STEPHENS,3/21/2020,2,2,0,4
STEPHENS,3/22/2020,4,2,0,6
STEPHENS,3/23/2020,5,2,0,7
STEPHENS,3/24/2020,5,3,0,8
STEPHENS,3/25/2020,5,3,0,8
STEPHENS,3/26/2020,5,3,0,8
STEPHENS,3/27/2020,5,3,0,8
STEPHENS,3/28/2020,7,4,0,11
STEPHENS,3/29/2020,8,4,0,12
STEPHENS,3/30/2020,9,4,0,13
STEPHENS,3/31/2020,9,4,0,13
STEPHENS,4/1/2020,10,8,0,18
STEPHENS,4/2/2020,12,10,0,22
STEPHENS,4/3/2020,14,11,0,25
STEPHENS,4/4/2020,14,12,0,26
STEPHENS,4/5/2020,15,12,0,27
STEPHENS,4/6/2020,17,12,0,29
STEPHENS,4/7/2020,18,14,0,32
STEPHENS,4/8/2020,21,15,0,36
STEPHENS,4/9/2020,21,16,0,37
STEPHENS,4/10/2020,27,16,0,43
STEPHENS,4/11/2020,28,16,0,44
STEPHENS,4/12/2020,28,16,0,44
STEPHENS,4/13/2020,28,17,0,45
STEPHENS,4/14/2020,28,19,0,47
STEPHENS,4/15/2020,30,20,0,50
STEPHENS,4/16/2020,32,23,0,55
STEPHENS,4/17/2020,36,24,0,60
STEPHENS,4/18/2020,37,24,0,61
STEPHENS,4/19/2020,38,24,0,62
STEPHENS,4/20/2020,38,24,0,62
STEPHENS,4/21/2020,40,26,0,66
STEPHENS,4/22/2020,42,29,0,71
STEPHENS,4/23/2020,43,31,0,74
STEPHENS,4/24/2020,58,33,0,91
STEPHENS,4/25/2020,58,35,0,93
STEPHENS,4/26/2020,58,35,0,93
STEPHENS,4/27/2020,64,36,0,100
STEPHENS,4/28/2020,64,37,0,101
STEPHENS,4/29/2020,65,39,0,104
STEPHENS,4/30/2020,66,39,0,105
STEPHENS,5/1/2020,67,39,0,106
STEPHENS,5/2/2020,67,39,0,106
STEPHENS,5/3/2020,67,41,0,108
STEPHENS,5/4/2020,68,43,0,111
STEPHENS,5/5/2020,68,43,0,111
STEPHENS,5/6/2020,68,43,0,111
STEPHENS,5/7/2020,69,43,0,112
STEPHENS,5/8/2020,69,44,0,113
STEPHENS,5/9/2020,70,44,0,114
STEPHENS,5/10/2020,70,44,0,114
STEPHENS,5/11/2020,70,45,0,115
STEPHENS,5/12/2020,70,46,0,116
STEPHENS,5/13/2020,81,48,0,129
STEPHENS,5/14/2020,82,50,0,132
STEPHENS,5/15/2020,85,50,0,135
STEPHENS,5/16/2020,87,51,0,138
STEPHENS,5/17/2020,88,51,0,139
STEPHENS,5/18/2020,91,51,0,142
STEPHENS,5/19/2020,92,51,0,143
STEPHENS,5/20/2020,95,51,0,146
STEPHENS,5/21/2020,96,53,0,149
STEPHENS,5/22/2020,96,53,0,149
STEPHENS,5/23/2020,97,53,0,150
STEPHENS,5/24/2020,97,54,0,151
STEPHENS,5/25/2020,97,54,0,151
STEPHENS,5/26/2020,98,55,0,153
STEPHENS,5/27/2020,99,57,0,156
STEPHENS,5/28/2020,101,58,0,159
STEPHENS,5/29/2020,102,60,0,162
STEPHENS,5/30/2020,102,61,0,163
STEPHENS,5/31/2020,102,62,0,164
STEPHENS,6/1/2020,105,65,0,170
STEPHENS,6/2/2020,105,66,0,171
STEPHENS,6/3/2020,106,66,0,172
STEPHENS,6/4/2020,106,66,0,172
STEPHENS,6/5/2020,109,66,0,175
STEPHENS,6/6/2020,109,66,0,175
STEPHENS,6/7/2020,109,66,0,175
STEPHENS,6/8/2020,110,66,0,176
STEPHENS,6/9/2020,113,66,0,179
STEPHENS,6/10/2020,115,67,0,182
STEPHENS,6/11/2020,115,67,0,182
STEPHENS,6/12/2020,120,69,0,189
STEPHENS,6/13/2020,121,69,0,190
STEPHENS,6/14/2020,122,70,0,192
STEPHENS,6/15/2020,122,71,0,193
STEPHENS,6/16/2020,126,73,0,199
STEPHENS,6/17/2020,126,73,0,199
STEPHENS,6/18/2020,132,77,0,209
STEPHENS,6/19/2020,135,79,0,214
STEPHENS,6/20/2020,138,81,0,219
STEPHENS,6/21/2020,140,82,0,222
STEPHENS,6/22/2020,144,83,0,227
STEPHENS,6/23/2020,150,88,0,238
STEPHENS,6/24/2020,156,95,0,251
STEPHENS,6/25/2020,160,99,0,259
STEPHENS,6/26/2020,167,103,0,270
STEPHENS,6/27/2020,171,106,0,277
STEPHENS,6/28/2020,173,108,0,281
STEPHENS,6/29/2020,179,111,0,290
STEPHENS,6/30/2020,182,114,0,296
STEPHENS,7/1/2020,188,121,0,309
STEPHENS,7/2/2020,191,125,0,316
STEPHENS,7/3/2020,197,126,0,323
STEPHENS,7/4/2020,203,127,0,330
STEPHENS,7/5/2020,207,128,0,335
STEPHENS,7/6/2020,217,136,0,353
STEPHENS,7/7/2020,224,143,0,367
STEPHENS,7/8/2020,237,155,0,392
STEPHENS,7/9/2020,241,161,0,402
STEPHENS,7/10/2020,245,166,0,411
STEPHENS,7/11/2020,247,170,0,417
STEPHENS,7/12/2020,250,171,0,421
STEPHENS,7/13/2020,267,187,0,454
STEPHENS,7/14/2020,274,195,1,470
STEPHENS,7/15/2020,284,199,1,484
STEPHENS,7/16/2020,298,207,1,506
STEPHENS,7/17/2020,303,214,1,518
STEPHENS,7/18/2020,311,217,2,530
STEPHENS,7/19/2020,315,226,3,544
STEPHENS,7/20/2020,331,229,3,563
STEPHENS,7/21/2020,344,233,3,580
STEPHENS,7/22/2020,351,237,3,591
STEPHENS,7/23/2020,356,240,3,599
STEPHENS,7/24/2020,364,244,3,611
STEPHENS,7/25/2020,367,247,3,617
STEPHENS,7/26/2020,368,249,3,620
STEPHENS,7/27/2020,372,252,4,628
STEPHENS,7/28/2020,378,258,7,643
STEPHENS,7/29/2020,382,260,7,649
STEPHENS,7/30/2020,391,263,7,661
STEPHENS,7/31/2020,393,264,7,664
STEPHENS,8/1/2020,401,267,7,675
STEPHENS,8/2/2020,413,274,7,694
STEPHENS,8/3/2020,418,276,7,701
STEPHENS,8/4/2020,428,281,8,717
STEPHENS,8/5/2020,452,294,8,754
STEPHENS,8/6/2020,457,298,8,763
STEPHENS,8/7/2020,461,302,8,771
STEPHENS,8/8/2020,468,304,8,780
STEPHENS,8/9/2020,470,306,8,784
STEPHENS,8/10/2020,479,312,8,799
STEPHENS,8/11/2020,481,317,8,806
STEPHENS,8/12/2020,487,319,8,814
STEPHENS,8/13/2020,491,322,8,821
STEPHENS,8/14/2020,492,327,8,827
STEPHENS,8/15/2020,496,328,8,832
STEPHENS,8/16/2020,497,330,8,835
STEPHENS,8/17/2020,500,341,8,849
STEPHENS,8/18/2020,505,343,8,856
STEPHENS,8/19/2020,508,347,8,863
STEPHENS,8/20/2020,512,350,8,870
STEPHENS,8/21/2020,518,353,8,879
STEPHENS,8/22/2020,522,356,8,886
STEPHENS,8/23/2020,524,358,8,890
STEPHENS,8/24/2020,533,360,8,901
STEPHENS,8/25/2020,537,366,8,911
STEPHENS,8/26/2020,542,367,8,917
STEPHENS,8/27/2020,547,371,8,926
STEPHENS,8/28/2020,549,376,8,933
STEPHENS,8/29/2020,552,377,8,937
STEPHENS,8/30/2020,554,379,8,941
STEPHENS,8/31/2020,557,384,8,949
STEPHENS,9/1/2020,559,385,8,952
STEPHENS,9/2/2020,563,387,8,958
STEPHENS,9/3/2020,565,393,8,966
STEPHENS,9/4/2020,570,393,8,971
STEPHENS,9/5/2020,572,394,8,974
STEPHENS,9/6/2020,573,395,8,976
STEPHENS,9/7/2020,573,397,8,978
STEPHENS,9/8/2020,575,397,8,980
STEPHENS,9/9/2020,578,398,8,984
STEPHENS,9/10/2020,580,400,8,988
STEPHENS,9/11/2020,581,401,8,990
STEPHENS,9/12/2020,583,403,8,994
STEPHENS,9/13/2020,589,405,8,1002
STEPHENS,9/14/2020,594,411,8,1013
STEPHENS,9/15/2020,597,416,8,1021
STEPHENS,9/16/2020,599,417,8,1024
STEPHENS,9/17/2020,603,417,8,1028
STEPHENS,9/18/2020,606,422,8,1036
STEPHENS,9/19/2020,607,424,8,1039
STEPHENS,9/20/2020,609,427,8,1044
STEPHENS,9/21/2020,614,429,8,1051
STEPHENS,9/22/2020,617,433,8,1058
STEPHENS,9/23/2020,620,437,8,1065
STEPHENS,9/24/2020,627,441,8,1076
STEPHENS,9/25/2020,631,446,8,1085
STEPHENS,9/26/2020,636,448,8,1092
STEPHENS,9/27/2020,642,449,8,1099
STEPHENS,9/28/2020,648,456,8,1112
STEPHENS,9/29/2020,651,460,8,1119
STEPHENS,9/30/2020,653,466,9,1128
STEPHENS,10/1/2020,666,474,9,1149
STEPHENS,10/2/2020,673,477,9,1159
STEPHENS,10/3/2020,677,479,9,1165
STEPHENS,10/4/2020,680,483,9,1172
STEPHENS,10/5/2020,689,489,9,1187
STEPHENS,10/6/2020,696,497,9,1202
STEPHENS,10/7/2020,699,500,9,1208
STEPHENS,10/8/2020,703,501,9,1213
STEPHENS,10/9/2020,708,507,9,1224
STEPHENS,10/10/2020,711,509,9,1229
STEPHENS,10/11/2020,713,510,9,1232
STEPHENS,10/12/2020,715,512,9,1236
STEPHENS,10/13/2020,717,516,9,1242
STEPHENS,10/14/2020,718,517,9,1244
STEPHENS,10/15/2020,720,517,9,1246
STEPHENS,10/16/2020,723,520,9,1252
STEPHENS,10/17/2020,723,520,9,1252
STEPHENS,10/18/2020,723,520,9,1252
STEPHENS,10/19/2020,723,520,9,1252
STEPHENS,10/20/2020,723,520,9,1252
TAYLOR,1/1/2020,0,0,0,0
TAYLOR,1/2/2020,0,0,0,0
TAYLOR,1/3/2020,0,0,0,0
TAYLOR,1/4/2020,0,0,0,0
TAYLOR,1/5/2020,0,0,0,0
TAYLOR,1/6/2020,0,0,0,0
TAYLOR,1/7/2020,0,0,0,0
TAYLOR,1/8/2020,0,0,0,0
TAYLOR,1/9/2020,0,0,0,0
TAYLOR,1/10/2020,0,0,0,0
TAYLOR,1/11/2020,0,0,0,0
TAYLOR,1/12/2020,0,0,0,0
TAYLOR,1/13/2020,0,0,0,0
TAYLOR,1/14/2020,0,0,0,0
TAYLOR,1/15/2020,0,0,0,0
TAYLOR,1/16/2020,0,0,0,0
TAYLOR,1/17/2020,0,0,0,0
TAYLOR,1/18/2020,0,0,0,0
TAYLOR,1/19/2020,0,0,0,0
TAYLOR,1/20/2020,0,0,0,0
TAYLOR,1/21/2020,0,0,0,0
TAYLOR,1/22/2020,0,0,0,0
TAYLOR,1/23/2020,0,0,0,0
TAYLOR,1/24/2020,0,0,0,0
TAYLOR,1/25/2020,0,0,0,0
TAYLOR,1/26/2020,0,0,0,0
TAYLOR,1/27/2020,0,0,0,0
TAYLOR,1/28/2020,0,0,0,0
TAYLOR,1/29/2020,0,0,0,0
TAYLOR,1/30/2020,0,0,0,0
MONTGOMERY,1/10/2020,0,0,0,0
MONTGOMERY,1/11/2020,0,0,0,0
MONTGOMERY,1/12/2020,0,0,0,0
MONTGOMERY,1/13/2020,0,0,0,0
MONTGOMERY,1/14/2020,0,0,0,0
MONTGOMERY,1/15/2020,0,0,0,0
MONTGOMERY,1/16/2020,0,0,0,0
MONTGOMERY,1/17/2020,0,0,0,0
MONTGOMERY,1/18/2020,0,0,0,0
MONTGOMERY,1/19/2020,0,0,0,0
MONTGOMERY,1/20/2020,0,0,0,0
MONTGOMERY,1/21/2020,0,0,0,0
MONTGOMERY,1/22/2020,0,0,0,0
MONTGOMERY,1/23/2020,0,0,0,0
MONTGOMERY,1/24/2020,0,0,0,0
MONTGOMERY,1/25/2020,0,0,0,0
MONTGOMERY,1/26/2020,0,0,0,0
MONTGOMERY,1/27/2020,0,0,0,0
MONTGOMERY,1/28/2020,0,0,0,0
MONTGOMERY,1/29/2020,0,0,0,0
MONTGOMERY,1/30/2020,0,0,0,0
MONTGOMERY,1/31/2020,0,0,0,0
MONTGOMERY,2/1/2020,0,0,0,0
MONTGOMERY,2/2/2020,0,0,0,0
MONTGOMERY,2/3/2020,0,0,0,0
MONTGOMERY,2/4/2020,0,0,0,0
MONTGOMERY,2/5/2020,0,0,0,0
MONTGOMERY,2/6/2020,0,0,0,0
MONTGOMERY,2/7/2020,0,0,0,0
MONTGOMERY,2/8/2020,0,0,0,0
MONTGOMERY,2/9/2020,0,0,0,0
MONTGOMERY,2/10/2020,0,0,0,0
MONTGOMERY,2/11/2020,0,0,0,0
MONTGOMERY,2/12/2020,0,0,0,0
MONTGOMERY,2/13/2020,0,0,0,0
MONTGOMERY,2/14/2020,0,0,0,0
MONTGOMERY,2/15/2020,0,0,0,0
MONTGOMERY,2/16/2020,0,0,0,0
MONTGOMERY,2/17/2020,0,0,0,0
MONTGOMERY,2/18/2020,0,0,0,0
MONTGOMERY,2/19/2020,0,0,0,0
MONTGOMERY,2/20/2020,0,0,0,0
MONTGOMERY,2/21/2020,0,0,0,0
MONTGOMERY,2/22/2020,0,0,0,0
MONTGOMERY,2/23/2020,0,0,0,0
MONTGOMERY,2/24/2020,0,0,0,0
MONTGOMERY,2/25/2020,0,0,0,0
MONTGOMERY,2/26/2020,0,0,0,0
MONTGOMERY,2/27/2020,0,0,0,0
MONTGOMERY,2/28/2020,0,0,0,0
MONTGOMERY,2/29/2020,0,0,0,0
MONTGOMERY,3/1/2020,0,0,0,0
MONTGOMERY,3/2/2020,0,0,0,0
MONTGOMERY,3/3/2020,0,0,0,0
MONTGOMERY,3/4/2020,0,0,0,0
MONTGOMERY,3/5/2020,0,0,0,0
MONTGOMERY,3/6/2020,0,0,0,0
MONTGOMERY,3/7/2020,0,0,0,0
MONTGOMERY,3/8/2020,0,0,0,0
MONTGOMERY,3/9/2020,0,0,0,0
MONTGOMERY,3/10/2020,0,0,0,0
MONTGOMERY,3/11/2020,0,0,0,0
MONTGOMERY,3/12/2020,0,0,0,0
MONTGOMERY,3/13/2020,0,0,0,0
MONTGOMERY,3/14/2020,0,0,0,0
MONTGOMERY,3/15/2020,0,0,0,0
MONTGOMERY,3/16/2020,0,0,0,0
MONTGOMERY,3/17/2020,0,0,0,0
MONTGOMERY,3/18/2020,0,0,0,0
MONTGOMERY,3/19/2020,0,0,0,0
MONTGOMERY,3/20/2020,0,0,0,0
MONTGOMERY,3/21/2020,0,0,0,0
MONTGOMERY,3/22/2020,0,0,0,0
MONTGOMERY,3/23/2020,0,1,0,1
MONTGOMERY,3/24/2020,0,1,0,1
MONTGOMERY,3/25/2020,0,1,0,1
MONTGOMERY,3/26/2020,0,1,0,1
MONTGOMERY,3/27/2020,0,1,0,1
MONTGOMERY,3/28/2020,0,1,0,1
MONTGOMERY,3/29/2020,0,1,0,1
MONTGOMERY,3/30/2020,1,1,0,2
MONTGOMERY,3/31/2020,1,1,0,2
MONTGOMERY,4/1/2020,1,1,0,2
MONTGOMERY,4/2/2020,1,1,0,2
MONTGOMERY,4/3/2020,1,1,0,2
MONTGOMERY,4/4/2020,1,1,0,2
MONTGOMERY,4/5/2020,1,1,0,2
MONTGOMERY,4/6/2020,2,1,0,3
MONTGOMERY,4/7/2020,2,1,0,3
MONTGOMERY,4/8/2020,2,1,0,3
MONTGOMERY,4/9/2020,2,1,0,3
MONTGOMERY,4/10/2020,2,1,0,3
MONTGOMERY,4/11/2020,2,1,0,3
MONTGOMERY,4/12/2020,2,1,0,3
MONTGOMERY,4/13/2020,2,1,0,3
MONTGOMERY,4/14/2020,2,1,0,3
MONTGOMERY,4/15/2020,2,1,0,3
MONTGOMERY,4/16/2020,2,1,0,3
MONTGOMERY,4/17/2020,2,1,0,3
MONTGOMERY,4/18/2020,2,1,0,3
MONTGOMERY,4/19/2020,2,1,0,3
MONTGOMERY,4/20/2020,2,1,0,3
MONTGOMERY,4/21/2020,2,1,0,3
MONTGOMERY,4/22/2020,2,1,0,3
MONTGOMERY,4/23/2020,2,1,0,3
MONTGOMERY,4/24/2020,2,1,0,3
MONTGOMERY,4/25/2020,2,1,0,3
MONTGOMERY,4/26/2020,2,1,0,3
MONTGOMERY,4/27/2020,3,1,0,4
MONTGOMERY,4/28/2020,3,1,0,4
MONTGOMERY,4/29/2020,4,1,0,5
MONTGOMERY,4/30/2020,4,1,0,5
MONTGOMERY,5/1/2020,5,1,0,6
MONTGOMERY,5/2/2020,5,3,0,8
MONTGOMERY,5/3/2020,5,3,0,8
MONTGOMERY,5/4/2020,5,3,0,8
MONTGOMERY,5/5/2020,5,3,0,8
MONTGOMERY,5/6/2020,6,4,0,10
MONTGOMERY,5/7/2020,7,5,0,12
MONTGOMERY,5/8/2020,7,5,0,12
MONTGOMERY,5/9/2020,7,5,0,12
MONTGOMERY,5/10/2020,7,5,0,12
MONTGOMERY,5/11/2020,7,5,0,12
MONTGOMERY,5/12/2020,7,5,0,12
MONTGOMERY,5/13/2020,7,5,0,12
MONTGOMERY,5/14/2020,7,5,0,12
MONTGOMERY,5/15/2020,8,5,0,13
MONTGOMERY,5/16/2020,8,5,0,13
MONTGOMERY,5/17/2020,8,5,0,13
MONTGOMERY,5/18/2020,8,5,0,13
MONTGOMERY,5/19/2020,8,5,0,13
MONTGOMERY,5/20/2020,8,5,0,13
MONTGOMERY,5/21/2020,8,5,0,13
MONTGOMERY,5/22/2020,8,5,0,13
MONTGOMERY,5/23/2020,8,5,0,13
MONTGOMERY,5/24/2020,8,5,0,13
MONTGOMERY,5/25/2020,8,5,0,13
MONTGOMERY,5/26/2020,9,6,0,15
MONTGOMERY,5/27/2020,9,7,0,16
MONTGOMERY,5/28/2020,10,7,0,17
MONTGOMERY,5/29/2020,11,8,0,19
MONTGOMERY,5/30/2020,11,8,0,19
MONTGOMERY,5/31/2020,11,9,0,20
MONTGOMERY,6/1/2020,11,10,0,21
MONTGOMERY,6/2/2020,11,10,0,21
MONTGOMERY,6/3/2020,12,10,0,22
MONTGOMERY,6/4/2020,12,10,0,22
MONTGOMERY,6/5/2020,12,11,0,23
MONTGOMERY,6/6/2020,12,11,0,23
MONTGOMERY,6/7/2020,12,11,0,23
MONTGOMERY,6/8/2020,12,13,0,25
MONTGOMERY,6/9/2020,14,13,0,27
MONTGOMERY,6/10/2020,14,13,0,27
MONTGOMERY,6/11/2020,14,14,0,28
MONTGOMERY,6/12/2020,14,14,0,28
MONTGOMERY,6/13/2020,16,15,0,31
MONTGOMERY,6/14/2020,16,15,0,31
MONTGOMERY,6/15/2020,17,15,0,32
MONTGOMERY,6/16/2020,18,16,0,34
MONTGOMERY,6/17/2020,18,16,0,34
MONTGOMERY,6/18/2020,18,16,0,34
MONTGOMERY,6/19/2020,18,16,0,34
MONTGOMERY,6/20/2020,18,16,0,34
MONTGOMERY,6/21/2020,19,16,0,35
MONTGOMERY,6/22/2020,20,16,0,36
MONTGOMERY,6/23/2020,20,17,0,37
MONTGOMERY,6/24/2020,21,18,0,39
MONTGOMERY,6/25/2020,21,18,0,39
MONTGOMERY,6/26/2020,21,18,0,39
MONTGOMERY,6/27/2020,22,18,0,40
MONTGOMERY,6/28/2020,23,18,0,41
MONTGOMERY,6/29/2020,23,21,0,44
MONTGOMERY,6/30/2020,25,25,0,50
MONTGOMERY,7/1/2020,26,32,0,58
MONTGOMERY,7/2/2020,27,36,0,63
MONTGOMERY,7/3/2020,27,36,0,63
MONTGOMERY,7/4/2020,27,36,0,63
MONTGOMERY,7/5/2020,28,37,0,65
MONTGOMERY,7/6/2020,31,39,0,70
MONTGOMERY,7/7/2020,32,42,0,74
MONTGOMERY,7/8/2020,34,44,0,78
MONTGOMERY,7/9/2020,36,47,0,83
MONTGOMERY,7/10/2020,37,48,0,85
MONTGOMERY,7/11/2020,40,49,0,89
MONTGOMERY,7/12/2020,40,50,0,90
MONTGOMERY,7/13/2020,40,51,0,91
MONTGOMERY,7/14/2020,44,55,0,99
MONTGOMERY,7/15/2020,48,56,0,104
MONTGOMERY,7/16/2020,49,58,0,107
MONTGOMERY,7/17/2020,50,59,0,109
MONTGOMERY,7/18/2020,52,62,0,114
MONTGOMERY,7/19/2020,52,64,0,116
MONTGOMERY,7/20/2020,53,66,0,119
MONTGOMERY,7/21/2020,54,71,0,125
MONTGOMERY,7/22/2020,55,72,0,127
MONTGOMERY,7/23/2020,56,73,0,129
MONTGOMERY,7/24/2020,57,74,0,131
MONTGOMERY,7/25/2020,58,75,0,133
MONTGOMERY,7/26/2020,59,75,0,134
MONTGOMERY,7/27/2020,64,77,1,142
MONTGOMERY,7/28/2020,64,78,1,143
MONTGOMERY,7/29/2020,65,78,1,144
MONTGOMERY,7/30/2020,65,79,1,145
MONTGOMERY,7/31/2020,66,80,1,147
MONTGOMERY,8/1/2020,68,82,1,151
MONTGOMERY,8/2/2020,71,83,1,155
MONTGOMERY,8/3/2020,73,85,1,159
MONTGOMERY,8/4/2020,74,86,1,161
MONTGOMERY,8/5/2020,75,90,1,166
MONTGOMERY,8/6/2020,76,93,1,170
MONTGOMERY,8/7/2020,78,94,1,173
MONTGOMERY,8/8/2020,80,94,1,175
MONTGOMERY,8/9/2020,81,96,1,178
MONTGOMERY,8/10/2020,83,96,2,181
MONTGOMERY,8/11/2020,84,99,2,185
MONTGOMERY,8/12/2020,85,101,2,188
MONTGOMERY,8/13/2020,89,103,2,194
MONTGOMERY,8/14/2020,89,106,2,197
MONTGOMERY,8/15/2020,91,107,2,200
MONTGOMERY,8/16/2020,92,108,2,202
MONTGOMERY,8/17/2020,95,109,2,206
MONTGOMERY,8/18/2020,99,110,2,211
MONTGOMERY,8/19/2020,101,111,2,214
MONTGOMERY,8/20/2020,101,111,2,214
MONTGOMERY,8/21/2020,104,113,2,219
MONTGOMERY,8/22/2020,105,113,2,220
MONTGOMERY,8/23/2020,107,116,2,225
MONTGOMERY,8/24/2020,107,118,2,227
MONTGOMERY,8/25/2020,108,119,2,229
MONTGOMERY,8/26/2020,109,122,2,233
MONTGOMERY,8/27/2020,110,123,2,235
MONTGOMERY,8/28/2020,111,123,2,236
MONTGOMERY,8/29/2020,114,124,2,240
MONTGOMERY,8/30/2020,116,125,2,243
MONTGOMERY,8/31/2020,117,126,2,245
MONTGOMERY,9/1/2020,117,126,2,245
MONTGOMERY,9/2/2020,121,128,2,251
MONTGOMERY,9/3/2020,122,130,2,254
MONTGOMERY,9/4/2020,122,131,2,255
MONTGOMERY,9/5/2020,123,133,2,258
MONTGOMERY,9/6/2020,128,134,2,264
MONTGOMERY,9/7/2020,129,136,2,267
MONTGOMERY,9/8/2020,132,141,2,275
MONTGOMERY,9/9/2020,136,141,2,279
MONTGOMERY,9/10/2020,137,144,2,283
MONTGOMERY,9/11/2020,142,144,2,288
MONTGOMERY,9/12/2020,145,145,2,292
MONTGOMERY,9/13/2020,145,146,2,293
MONTGOMERY,9/14/2020,146,147,2,295
MONTGOMERY,9/15/2020,146,148,2,296
MONTGOMERY,9/16/2020,147,150,2,299
MONTGOMERY,9/17/2020,149,150,2,301
MONTGOMERY,9/18/2020,150,150,2,302
MONTGOMERY,9/19/2020,150,151,2,303
MONTGOMERY,9/20/2020,151,151,2,304
MONTGOMERY,9/21/2020,152,153,2,307
MONTGOMERY,9/22/2020,155,154,2,311
MONTGOMERY,9/23/2020,158,154,2,314
MONTGOMERY,9/24/2020,159,156,2,317
MONTGOMERY,9/25/2020,162,156,2,320
MONTGOMERY,9/26/2020,163,157,2,322
MONTGOMERY,9/27/2020,165,157,2,324
MONTGOMERY,9/28/2020,165,161,2,328
MONTGOMERY,9/29/2020,170,161,2,333
MONTGOMERY,9/30/2020,170,162,2,334
MONTGOMERY,10/1/2020,171,163,2,336
MONTGOMERY,10/2/2020,172,165,2,339
MONTGOMERY,10/3/2020,172,166,2,340
MONTGOMERY,10/4/2020,172,166,2,340
MONTGOMERY,10/5/2020,174,166,2,342
MONTGOMERY,10/6/2020,174,166,2,342
MONTGOMERY,10/7/2020,175,170,2,347
MONTGOMERY,10/8/2020,176,171,2,349
MONTGOMERY,10/9/2020,176,172,2,350
MONTGOMERY,10/10/2020,177,173,2,352
MONTGOMERY,10/11/2020,177,173,2,352
MONTGOMERY,10/12/2020,177,174,2,353
MONTGOMERY,10/13/2020,178,176,2,356
MONTGOMERY,10/14/2020,178,176,2,356
MONTGOMERY,10/15/2020,179,177,2,358
MONTGOMERY,10/16/2020,179,177,2,358
MONTGOMERY,10/17/2020,180,177,2,359
MONTGOMERY,10/18/2020,180,177,2,359
MONTGOMERY,10/19/2020,180,177,2,359
MONTGOMERY,10/20/2020,180,177,2,359
NEWTON,1/1/2020,0,0,0,0
NEWTON,1/2/2020,0,0,0,0
NEWTON,1/3/2020,0,0,0,0
NEWTON,1/4/2020,0,0,0,0
NEWTON,1/5/2020,0,0,0,0
NEWTON,1/6/2020,0,0,0,0
NEWTON,1/7/2020,0,0,0,0
NEWTON,1/8/2020,0,0,0,0
NEWTON,1/9/2020,0,0,0,0
NEWTON,1/10/2020,0,0,0,0
NEWTON,1/11/2020,0,0,0,0
NEWTON,1/12/2020,0,0,0,0
NEWTON,1/13/2020,0,0,0,0
NEWTON,1/14/2020,0,0,0,0
NEWTON,1/15/2020,0,0,0,0
NEWTON,1/16/2020,0,0,0,0
NEWTON,1/17/2020,0,0,0,0
NEWTON,1/18/2020,0,0,0,0
NEWTON,1/19/2020,0,0,0,0
NEWTON,1/20/2020,0,0,0,0
NEWTON,1/21/2020,0,0,0,0
NEWTON,1/22/2020,0,0,0,0
NEWTON,1/23/2020,0,0,0,0
NEWTON,1/24/2020,0,0,0,0
NEWTON,1/25/2020,0,0,0,0
NEWTON,1/26/2020,0,0,0,0
NEWTON,1/27/2020,0,0,0,0
NEWTON,1/28/2020,0,0,0,0
NEWTON,1/29/2020,0,0,0,0
NEWTON,1/30/2020,0,0,0,0
NEWTON,1/31/2020,0,0,0,0
NEWTON,2/1/2020,0,0,0,0
NEWTON,2/2/2020,0,0,0,0
NEWTON,2/3/2020,0,0,0,0
NEWTON,2/4/2020,0,0,0,0
NEWTON,2/5/2020,0,0,0,0
NEWTON,2/6/2020,0,0,0,0
NEWTON,2/7/2020,0,0,0,0
NEWTON,2/8/2020,0,0,0,0
NEWTON,2/9/2020,0,0,0,0
NEWTON,2/10/2020,0,0,0,0
NEWTON,2/11/2020,0,0,0,0
NEWTON,2/12/2020,0,0,0,0
NEWTON,2/13/2020,0,0,0,0
NEWTON,2/14/2020,0,0,0,0
NEWTON,2/15/2020,0,0,0,0
NEWTON,2/16/2020,0,0,0,0
NEWTON,2/17/2020,0,0,0,0
NEWTON,2/18/2020,0,0,0,0
NEWTON,2/19/2020,0,0,0,0
NEWTON,2/20/2020,0,0,0,0
NEWTON,2/21/2020,0,0,0,0
NEWTON,2/22/2020,0,0,0,0
NEWTON,2/23/2020,0,0,0,0
NEWTON,2/24/2020,0,0,0,0
NEWTON,2/25/2020,0,0,0,0
NEWTON,2/26/2020,0,0,0,0
NEWTON,2/27/2020,0,0,0,0
NEWTON,2/28/2020,0,0,0,0
NEWTON,2/29/2020,0,0,0,0
NEWTON,3/1/2020,0,1,0,1
NEWTON,3/2/2020,0,1,0,1
NEWTON,3/3/2020,0,1,0,1
NEWTON,3/4/2020,0,2,0,2
NEWTON,3/5/2020,0,2,0,2
NEWTON,3/6/2020,0,2,0,2
NEWTON,3/7/2020,1,3,0,4
NEWTON,3/8/2020,2,3,0,5
NEWTON,3/9/2020,3,3,0,6
NEWTON,3/10/2020,3,4,0,7
NEWTON,3/11/2020,4,5,0,9
NEWTON,3/12/2020,4,5,0,9
NEWTON,3/13/2020,8,7,0,15
NEWTON,3/14/2020,9,7,0,16
NEWTON,3/15/2020,10,11,0,21
NEWTON,3/16/2020,11,13,0,24
NEWTON,3/17/2020,12,13,0,25
NEWTON,3/18/2020,12,17,0,29
NEWTON,3/19/2020,14,18,0,32
NEWTON,3/20/2020,14,19,0,33
NEWTON,3/21/2020,18,22,0,40
NEWTON,3/22/2020,19,25,0,44
NEWTON,3/23/2020,22,27,1,50
NEWTON,3/24/2020,29,29,1,59
NEWTON,3/25/2020,32,30,1,63
NEWTON,3/26/2020,34,30,1,65
NEWTON,3/27/2020,36,32,1,69
NEWTON,3/28/2020,37,34,1,72
NEWTON,3/29/2020,37,35,1,73
NEWTON,3/30/2020,42,36,1,79
NEWTON,3/31/2020,43,36,1,80
NEWTON,4/1/2020,46,38,1,85
NEWTON,4/2/2020,46,38,1,85
NEWTON,4/3/2020,48,38,1,87
NEWTON,4/4/2020,52,40,1,93
NEWTON,4/5/2020,57,41,1,99
NEWTON,4/6/2020,58,42,1,101
NEWTON,4/7/2020,59,44,1,104
NEWTON,4/8/2020,64,49,1,114
NEWTON,4/9/2020,70,51,1,122
NEWTON,4/10/2020,73,53,1,127
NEWTON,4/11/2020,74,53,1,128
NEWTON,4/12/2020,75,55,1,131
NEWTON,4/13/2020,78,62,1,141
NEWTON,4/14/2020,79,64,1,144
NEWTON,4/15/2020,80,66,1,147
NEWTON,4/16/2020,84,69,1,154
NEWTON,4/17/2020,86,70,1,157
NEWTON,4/18/2020,89,73,1,163
NEWTON,4/19/2020,89,73,1,163
NEWTON,4/20/2020,93,74,1,168
NEWTON,4/21/2020,94,74,1,169
WALKER,9/6/2020,662,639,23,1324
WALKER,9/7/2020,674,644,23,1341
MORGAN,3/9/2020,0,0,0,0
WALKER,9/8/2020,683,653,24,1360
MORGAN,3/10/2020,0,0,0,0
WALKER,9/9/2020,693,665,24,1382
MORGAN,3/11/2020,0,0,0,0
WALKER,9/10/2020,719,677,24,1420
MORGAN,3/12/2020,0,0,0,0
WALKER,9/11/2020,732,689,24,1445
MORGAN,3/13/2020,0,1,0,1
WALKER,9/12/2020,736,694,24,1454
MORGAN,3/14/2020,0,1,0,1
WALKER,9/13/2020,744,694,24,1462
MORGAN,3/15/2020,0,1,0,1
WALKER,9/14/2020,745,697,24,1466
MORGAN,3/16/2020,1,1,0,2
WALKER,9/15/2020,758,700,24,1482
WALKER,9/16/2020,765,701,24,1490
WALKER,9/17/2020,773,705,24,1502
WALKER,9/18/2020,802,717,24,1543
WALKER,9/19/2020,809,721,25,1555
WALKER,9/20/2020,810,724,25,1559
WALKER,9/21/2020,815,728,25,1568
WALKER,9/22/2020,821,732,25,1578
WALKER,9/23/2020,828,738,25,1591
WALKER,9/24/2020,831,745,25,1601
WALKER,9/25/2020,835,746,25,1606
WALKER,9/26/2020,838,749,25,1612
WALKER,9/27/2020,844,758,25,1627
WALKER,9/28/2020,850,760,25,1635
WALKER,9/29/2020,855,765,26,1646
WALKER,9/30/2020,859,768,26,1653
WALKER,10/1/2020,864,770,26,1660
WALKER,10/2/2020,872,776,26,1674
WALKER,10/3/2020,875,779,26,1680
WALKER,10/4/2020,879,780,26,1685
WALKER,10/5/2020,882,782,26,1690
WALKER,10/6/2020,886,784,26,1696
WALKER,10/7/2020,894,787,26,1707
WALKER,10/8/2020,900,790,26,1716
WALKER,10/9/2020,906,794,26,1726
WALKER,10/10/2020,910,795,26,1731
WALKER,10/11/2020,912,796,27,1735
WALKER,10/12/2020,918,799,27,1744
WALKER,10/13/2020,920,802,27,1749
WALKER,10/14/2020,922,803,27,1752
WALKER,10/15/2020,930,808,27,1765
WALKER,10/16/2020,939,815,27,1781
WALKER,10/17/2020,939,815,27,1781
WALKER,10/18/2020,939,815,27,1781
WALKER,10/19/2020,939,815,27,1781
WALKER,10/20/2020,939,815,27,1781
WHEELER,1/1/2020,0,0,0,0
WHEELER,1/2/2020,0,0,0,0
WHEELER,1/3/2020,0,0,0,0
WHEELER,1/4/2020,0,0,0,0
WHEELER,1/5/2020,0,0,0,0
WHEELER,1/6/2020,0,0,0,0
WHEELER,1/7/2020,0,0,0,0
WHEELER,1/8/2020,0,0,0,0
WHEELER,1/9/2020,0,0,0,0
WHEELER,1/10/2020,0,0,0,0
WHEELER,1/11/2020,0,0,0,0
WHEELER,1/12/2020,0,0,0,0
WHEELER,1/13/2020,0,0,0,0
WHEELER,1/14/2020,0,0,0,0
WHEELER,1/15/2020,0,0,0,0
WHEELER,1/16/2020,0,0,0,0
WHEELER,1/17/2020,0,0,0,0
WHEELER,1/18/2020,0,0,0,0
WHEELER,1/19/2020,0,0,0,0
WHEELER,1/20/2020,0,0,0,0
WHEELER,1/21/2020,0,0,0,0
WHEELER,1/22/2020,0,0,0,0
WHEELER,1/23/2020,0,0,0,0
WHEELER,1/24/2020,0,0,0,0
WHEELER,1/25/2020,0,0,0,0
WHEELER,1/26/2020,0,0,0,0
WHEELER,1/27/2020,0,0,0,0
WHEELER,1/28/2020,0,0,0,0
WHEELER,1/29/2020,0,0,0,0
WHEELER,1/30/2020,0,0,0,0
WHEELER,1/31/2020,0,0,0,0
WHEELER,2/1/2020,0,0,0,0
WHEELER,2/2/2020,0,0,0,0
WHEELER,2/3/2020,0,0,0,0
WHEELER,2/4/2020,0,0,0,0
WHEELER,2/5/2020,0,0,0,0
WHEELER,2/6/2020,0,0,0,0
WHEELER,2/7/2020,0,0,0,0
WHEELER,2/8/2020,0,0,0,0
WHEELER,2/9/2020,0,0,0,0
WHEELER,2/10/2020,0,0,0,0
WHEELER,2/11/2020,0,0,0,0
WHEELER,2/12/2020,0,0,0,0
WHEELER,2/13/2020,0,0,0,0
WHEELER,2/14/2020,0,0,0,0
WHEELER,2/15/2020,0,0,0,0
WHEELER,2/16/2020,0,0,0,0
WHEELER,2/17/2020,0,0,0,0
WHEELER,2/18/2020,0,0,0,0
WHEELER,2/19/2020,0,0,0,0
WHEELER,2/20/2020,0,0,0,0
WHEELER,2/21/2020,0,0,0,0
WHEELER,2/22/2020,0,0,0,0
WHEELER,2/23/2020,0,0,0,0
WHEELER,2/24/2020,0,0,0,0
WHEELER,2/25/2020,0,0,0,0
WHEELER,2/26/2020,0,0,0,0
WHEELER,2/27/2020,0,0,0,0
WHEELER,2/28/2020,0,0,0,0
WHEELER,2/29/2020,0,0,0,0
WHEELER,3/1/2020,0,0,0,0
WHEELER,3/2/2020,0,0,0,0
WHEELER,3/3/2020,0,0,0,0
WHEELER,3/4/2020,0,0,0,0
WHEELER,3/5/2020,0,0,0,0
WHEELER,3/6/2020,0,0,0,0
WHEELER,3/7/2020,0,0,0,0
WHEELER,3/8/2020,0,0,0,0
WHEELER,3/9/2020,0,0,0,0
WHEELER,3/10/2020,0,0,0,0
WHEELER,3/11/2020,0,0,0,0
WHEELER,3/12/2020,0,0,0,0
WHEELER,3/13/2020,0,0,0,0
WHEELER,3/14/2020,0,0,0,0
WHEELER,3/15/2020,0,0,0,0
WHEELER,3/16/2020,0,0,0,0
WHEELER,3/17/2020,0,0,0,0
WHEELER,3/18/2020,0,0,0,0
WHEELER,3/19/2020,0,0,0,0
WHEELER,3/20/2020,0,1,0,1
WHEELER,3/21/2020,0,1,0,1
WHEELER,3/22/2020,0,1,0,1
WHEELER,3/23/2020,0,1,0,1
WHEELER,3/24/2020,0,2,0,2
WHEELER,3/25/2020,1,2,0,3
WHEELER,3/26/2020,1,2,0,3
WHEELER,3/27/2020,1,2,0,3
WHEELER,3/28/2020,1,2,0,3
WHEELER,3/29/2020,1,2,0,3
WHEELER,3/30/2020,1,2,0,3
WHEELER,3/31/2020,1,2,0,3
WHEELER,4/1/2020,1,2,0,3
WHEELER,4/2/2020,1,2,0,3
WHEELER,4/3/2020,1,2,0,3
WHEELER,4/4/2020,1,2,0,3
WHEELER,4/5/2020,1,2,0,3
WHEELER,4/6/2020,2,2,0,4
WHEELER,4/7/2020,2,2,0,4
WHEELER,4/8/2020,2,2,0,4
WHEELER,4/9/2020,2,3,0,5
WHEELER,4/10/2020,2,3,0,5
WHEELER,4/11/2020,2,3,0,5
WHEELER,4/12/2020,2,3,0,5
WHEELER,4/13/2020,3,3,0,6
WHEELER,4/14/2020,3,3,0,6
WHEELER,4/15/2020,3,3,0,6
WHEELER,4/16/2020,3,3,0,6
WHEELER,4/17/2020,3,3,0,6
WHEELER,4/18/2020,3,3,0,6
WHEELER,4/19/2020,3,3,0,6
WHEELER,4/20/2020,3,3,0,6
WHEELER,4/21/2020,3,3,0,6
WHEELER,4/22/2020,3,3,0,6
WHEELER,4/23/2020,3,3,0,6
WHEELER,4/24/2020,3,3,0,6
WHEELER,4/25/2020,4,3,0,7
WHEELER,4/26/2020,4,3,0,7
WHEELER,4/27/2020,4,3,0,7
WHEELER,4/28/2020,4,3,0,7
WHEELER,4/29/2020,4,3,0,7
WHEELER,4/30/2020,4,3,0,7
WHEELER,5/1/2020,4,3,0,7
WHEELER,5/2/2020,4,3,0,7
WHEELER,5/3/2020,4,3,0,7
WHEELER,5/4/2020,4,3,0,7
WHEELER,5/5/2020,4,3,0,7
WHEELER,5/6/2020,5,3,0,8
WHEELER,5/7/2020,5,3,0,8
WHEELER,5/8/2020,5,3,0,8
WHEELER,5/9/2020,5,3,0,8
WHEELER,5/10/2020,5,3,0,8
WHEELER,5/11/2020,6,3,0,9
WHEELER,5/12/2020,6,3,0,9
WHEELER,5/13/2020,6,4,0,10
WHEELER,5/14/2020,6,4,0,10
WHEELER,5/15/2020,6,4,0,10
WHEELER,5/16/2020,6,4,0,10
WHEELER,5/17/2020,6,4,0,10
WHEELER,5/18/2020,6,4,0,10
WHEELER,5/19/2020,6,4,0,10
WHEELER,5/20/2020,6,4,0,10
WHEELER,5/21/2020,6,4,0,10
WHEELER,5/22/2020,6,6,0,12
WHEELER,5/23/2020,6,6,0,12
WHEELER,5/24/2020,6,6,0,12
WHEELER,5/25/2020,7,6,0,13
WHEELER,5/26/2020,8,6,0,14
WHEELER,5/27/2020,8,6,0,14
WHEELER,5/28/2020,8,7,0,15
WHEELER,5/29/2020,8,7,0,15
WHEELER,5/30/2020,8,8,0,16
WHEELER,5/31/2020,8,8,0,16
WHEELER,6/1/2020,8,8,0,16
WHEELER,6/2/2020,8,8,0,16
WHEELER,6/3/2020,8,8,0,16
WHEELER,6/4/2020,9,8,0,17
WHEELER,6/5/2020,9,8,0,17
WHEELER,6/6/2020,10,8,0,18
WHEELER,6/7/2020,11,8,0,19
WHEELER,6/8/2020,12,8,0,20
WHEELER,6/9/2020,13,10,0,23
WHEELER,6/10/2020,15,12,0,27
WHEELER,6/11/2020,15,13,0,28
WHEELER,6/12/2020,17,15,0,32
WHEELER,6/13/2020,17,17,0,34
WHEELER,6/14/2020,17,17,0,34
WHEELER,6/15/2020,17,18,0,35
WHEELER,6/16/2020,17,19,0,36
WHEELER,6/17/2020,18,20,0,38
WHEELER,6/18/2020,18,21,0,39
WHEELER,6/19/2020,20,21,0,41
WHEELER,6/20/2020,21,21,0,42
WHEELER,6/21/2020,21,21,0,42
WHEELER,6/22/2020,22,21,0,43
WHEELER,6/23/2020,24,21,0,45
WHEELER,6/24/2020,24,22,0,46
WHEELER,6/25/2020,26,23,0,49
WHEELER,6/26/2020,29,23,0,52
WHEELER,6/27/2020,31,23,0,54
WHEELER,6/28/2020,31,24,0,55
WHEELER,6/29/2020,31,24,0,55
WHEELER,6/30/2020,31,24,0,55
WHEELER,7/1/2020,32,26,0,58
WHEELER,7/2/2020,33,26,0,59
WHEELER,7/3/2020,35,26,0,61
WHEELER,7/4/2020,35,26,0,61
WHEELER,7/5/2020,35,26,0,61
WHEELER,7/6/2020,36,27,0,63
WHEELER,7/7/2020,36,28,0,64
WHEELER,7/8/2020,38,29,0,67
WHEELER,7/9/2020,38,29,0,67
WHEELER,7/10/2020,38,31,0,69
WHEELER,7/11/2020,41,31,0,72
WHEELER,7/12/2020,41,31,0,72
WHEELER,7/13/2020,41,32,0,73
WHEELER,7/14/2020,42,32,0,74
WHEELER,7/15/2020,43,32,0,75
WHEELER,7/16/2020,43,32,0,75
WHEELER,7/17/2020,43,34,0,77
WHEELER,7/18/2020,43,34,0,77
WHEELER,7/19/2020,43,34,0,77
WHEELER,7/20/2020,43,34,0,77
WHEELER,7/21/2020,44,34,0,78
WHEELER,7/22/2020,44,35,0,79
WHEELER,7/23/2020,44,35,0,79
WHEELER,7/24/2020,44,36,0,80
WHEELER,7/25/2020,44,36,0,80
WHEELER,7/26/2020,44,36,0,80
WHEELER,7/27/2020,45,37,0,82
WHEELER,7/28/2020,46,37,0,83
WHEELER,7/29/2020,47,39,0,86
WHEELER,7/30/2020,47,40,0,87
WHEELER,7/31/2020,49,40,0,89
WHEELER,8/1/2020,50,40,0,90
WHEELER,8/2/2020,50,42,0,92
WHEELER,8/3/2020,51,61,1,113
WHEELER,8/4/2020,51,67,1,119
WHEELER,8/5/2020,52,69,2,123
WHEELER,8/6/2020,53,74,2,129
WHEELER,8/7/2020,53,74,2,129
WHEELER,8/8/2020,54,74,2,130
WHEELER,8/9/2020,54,75,2,131
WHEELER,8/10/2020,56,95,6,157
WHEELER,8/11/2020,57,99,6,162
WHEELER,8/12/2020,58,105,6,169
WHEELER,8/13/2020,61,114,6,181
WHEELER,8/14/2020,62,121,8,191
WHEELER,8/15/2020,64,125,10,199
WHEELER,8/16/2020,64,128,10,202
WHEELER,8/17/2020,66,142,11,219
WHEELER,8/18/2020,67,158,14,239
WHEELER,8/19/2020,67,163,14,244
WHEELER,8/20/2020,68,170,17,255
WHEELER,8/21/2020,68,180,17,265
WHEELER,8/22/2020,68,183,17,268
WHEELER,8/23/2020,69,183,17,269
WHEELER,8/24/2020,69,184,17,270
WHEELER,8/25/2020,72,186,19,277
WHEELER,8/26/2020,72,190,19,281
WHEELER,8/27/2020,72,190,19,281
WHEELER,8/28/2020,73,190,19,282
WHEELER,8/29/2020,73,192,19,284
WHEELER,8/30/2020,73,193,19,285
WHEELER,8/31/2020,73,194,19,286
WHEELER,9/1/2020,74,197,19,290
WHEELER,9/2/2020,75,199,19,293
WHEELER,9/3/2020,76,201,19,296
WHEELER,9/4/2020,76,203,19,298
WHEELER,9/5/2020,76,205,19,300
WHEELER,9/6/2020,76,205,19,300
WHEELER,9/7/2020,77,205,19,301
WHEELER,9/8/2020,77,206,19,302
WHEELER,9/9/2020,77,208,19,304
WHEELER,9/10/2020,80,210,19,309
WHEELER,9/11/2020,80,211,19,310
WHEELER,9/12/2020,80,212,19,311
WHEELER,9/13/2020,80,212,19,311
WHEELER,9/14/2020,81,216,19,316
WHEELER,9/15/2020,81,216,19,316
WHEELER,9/16/2020,81,216,19,316
WHEELER,9/17/2020,81,216,19,316
WHEELER,9/18/2020,82,220,19,321
WHEELER,9/19/2020,82,220,19,321
WHEELER,9/20/2020,82,220,19,321
WHEELER,9/21/2020,83,220,19,322
WHEELER,9/22/2020,83,220,19,322
WHEELER,9/23/2020,83,221,19,323
WHEELER,9/24/2020,83,221,19,323
WHEELER,9/25/2020,84,223,19,326
WHEELER,9/26/2020,85,224,19,328
WHEELER,9/27/2020,86,224,19,329
WHEELER,9/28/2020,91,226,19,336
WHEELER,9/29/2020,91,227,19,337
WHEELER,9/30/2020,91,227,19,337
WHEELER,10/1/2020,92,228,20,340
WHEELER,10/2/2020,93,228,20,341
WHEELER,10/3/2020,93,230,20,343
WHEELER,10/4/2020,94,230,20,344
WHEELER,10/5/2020,94,230,20,344
WHEELER,10/6/2020,96,231,20,347
WHEELER,10/7/2020,96,232,20,348
WHEELER,10/8/2020,96,232,20,348
WHEELER,10/9/2020,96,232,20,348
WHEELER,10/10/2020,96,232,20,348
WHEELER,10/11/2020,96,232,20,348
WHEELER,10/12/2020,96,233,20,349
WHEELER,10/13/2020,97,234,20,351
WHEELER,10/14/2020,97,234,20,351
WHEELER,10/15/2020,98,235,20,353
WHEELER,10/16/2020,99,236,20,355
WHEELER,10/17/2020,99,236,20,355
WHEELER,10/18/2020,99,236,20,355
WHEELER,10/19/2020,99,236,20,355
WHEELER,10/20/2020,99,236,20,355
MORGAN,1/1/2020,0,0,0,0
MORGAN,1/2/2020,0,0,0,0
MORGAN,1/3/2020,0,0,0,0
MORGAN,1/4/2020,0,0,0,0
MORGAN,1/5/2020,0,0,0,0
MORGAN,1/6/2020,0,0,0,0
MORGAN,1/7/2020,0,0,0,0
MORGAN,1/8/2020,0,0,0,0
MORGAN,1/9/2020,0,0,0,0
MORGAN,1/10/2020,0,0,0,0
MORGAN,1/11/2020,0,0,0,0
MORGAN,1/12/2020,0,0,0,0
MORGAN,1/13/2020,0,0,0,0
MORGAN,1/14/2020,0,0,0,0
MORGAN,1/15/2020,0,0,0,0
MORGAN,1/16/2020,0,0,0,0
MORGAN,1/17/2020,0,0,0,0
MORGAN,1/18/2020,0,0,0,0
MORGAN,1/19/2020,0,0,0,0
MORGAN,1/20/2020,0,0,0,0
MORGAN,1/21/2020,0,0,0,0
MORGAN,1/22/2020,0,0,0,0
MORGAN,1/23/2020,0,0,0,0
MORGAN,1/24/2020,0,0,0,0
MORGAN,1/25/2020,0,0,0,0
MORGAN,1/26/2020,0,0,0,0
MORGAN,1/27/2020,0,0,0,0
MORGAN,1/28/2020,0,0,0,0
MORGAN,1/29/2020,0,0,0,0
MORGAN,1/30/2020,0,0,0,0
MORGAN,1/31/2020,0,0,0,0
MORGAN,2/1/2020,0,0,0,0
MORGAN,2/2/2020,0,0,0,0
MORGAN,2/3/2020,0,0,0,0
MORGAN,2/4/2020,0,0,0,0
MORGAN,2/5/2020,0,0,0,0
MORGAN,2/6/2020,0,0,0,0
MORGAN,2/7/2020,0,0,0,0
MORGAN,2/8/2020,0,0,0,0
MORGAN,2/9/2020,0,0,0,0
MORGAN,2/10/2020,0,0,0,0
MORGAN,2/11/2020,0,0,0,0
MORGAN,2/12/2020,0,0,0,0
MORGAN,2/13/2020,0,0,0,0
MORGAN,2/14/2020,0,0,0,0
MORGAN,2/15/2020,0,0,0,0
MORGAN,2/16/2020,0,0,0,0
MORGAN,2/17/2020,0,0,0,0
MORGAN,2/18/2020,0,0,0,0
MORGAN,2/19/2020,0,0,0,0
MORGAN,2/20/2020,0,0,0,0
MORGAN,2/21/2020,0,0,0,0
MORGAN,2/22/2020,0,0,0,0
MORGAN,2/23/2020,0,0,0,0
MORGAN,2/24/2020,0,0,0,0
MORGAN,2/25/2020,0,0,0,0
MORGAN,2/26/2020,0,0,0,0
MORGAN,2/27/2020,0,0,0,0
MORGAN,2/28/2020,0,0,0,0
MORGAN,2/29/2020,0,0,0,0
MORGAN,3/1/2020,0,0,0,0
MORGAN,3/2/2020,0,0,0,0
MORGAN,3/3/2020,0,0,0,0
MORGAN,3/4/2020,0,0,0,0
MORGAN,3/5/2020,0,0,0,0
MORGAN,3/6/2020,0,0,0,0
MORGAN,3/7/2020,0,0,0,0
MORGAN,3/8/2020,0,0,0,0
WASHINGTON,6/30/2020,100,52,0,152
TERRELL,5/16/2020,136,63,5,204
MORGAN,3/17/2020,1,1,0,2
WASHINGTON,7/1/2020,108,56,0,164
WASHINGTON,7/2/2020,111,63,1,175
WASHINGTON,7/3/2020,115,65,1,181
WASHINGTON,7/4/2020,121,68,1,190
WASHINGTON,7/5/2020,123,68,1,192
WASHINGTON,7/6/2020,133,76,1,210
WASHINGTON,7/7/2020,138,84,1,223
WASHINGTON,7/8/2020,146,89,1,236
WASHINGTON,7/9/2020,151,92,1,244
WASHINGTON,7/10/2020,160,98,1,259
WASHINGTON,7/11/2020,167,101,1,269
WASHINGTON,7/12/2020,169,105,1,275
WASHINGTON,7/13/2020,181,111,1,293
WASHINGTON,7/14/2020,183,118,1,302
WASHINGTON,7/15/2020,190,125,1,316
WASHINGTON,7/16/2020,196,128,1,325
WASHINGTON,7/17/2020,200,133,1,334
WASHINGTON,7/18/2020,203,134,1,338
WASHINGTON,7/19/2020,206,137,1,344
WASHINGTON,7/20/2020,218,140,1,359
WASHINGTON,7/21/2020,225,151,1,377
WASHINGTON,7/22/2020,229,157,2,388
WASHINGTON,7/23/2020,231,164,2,397
WASHINGTON,7/24/2020,238,168,2,408
WASHINGTON,7/25/2020,245,173,2,420
WASHINGTON,7/26/2020,249,176,2,427
WASHINGTON,7/27/2020,255,181,2,438
WASHINGTON,7/28/2020,263,188,2,453
WASHINGTON,7/29/2020,266,199,2,467
WASHINGTON,7/30/2020,271,202,2,475
WASHINGTON,7/31/2020,275,205,2,482
WASHINGTON,8/1/2020,278,208,2,488
WASHINGTON,8/2/2020,280,211,2,493
WASHINGTON,8/3/2020,287,219,2,508
WASHINGTON,8/4/2020,292,223,2,517
WASHINGTON,8/5/2020,300,224,2,526
WASHINGTON,8/6/2020,303,228,2,533
WASHINGTON,8/7/2020,307,228,2,537
WASHINGTON,8/8/2020,312,232,2,546
WASHINGTON,8/9/2020,316,234,2,552
WASHINGTON,8/10/2020,320,239,2,561
WASHINGTON,8/11/2020,324,239,2,565
WASHINGTON,8/12/2020,326,240,2,568
WASHINGTON,8/13/2020,327,243,2,572
WASHINGTON,8/14/2020,331,247,2,580
WASHINGTON,8/15/2020,337,251,2,590
WASHINGTON,8/16/2020,338,252,2,592
WASHINGTON,8/17/2020,341,255,2,598
WASHINGTON,8/18/2020,342,258,2,602
WASHINGTON,8/19/2020,342,259,3,604
WASHINGTON,8/20/2020,342,259,3,604
WASHINGTON,8/21/2020,343,260,3,606
WASHINGTON,8/22/2020,344,260,3,607
WASHINGTON,8/23/2020,348,260,3,611
WASHINGTON,8/24/2020,351,263,3,617
WASHINGTON,8/25/2020,356,265,3,624
WASHINGTON,8/26/2020,356,266,3,625
WASHINGTON,8/27/2020,358,268,3,629
WASHINGTON,8/28/2020,360,272,3,635
WASHINGTON,8/29/2020,362,273,3,638
WASHINGTON,8/30/2020,363,274,3,640
WASHINGTON,8/31/2020,366,274,3,643
WASHINGTON,9/1/2020,367,278,3,648
WASHINGTON,9/2/2020,369,279,3,651
WASHINGTON,9/3/2020,370,281,3,654
WASHINGTON,9/4/2020,373,282,3,658
WASHINGTON,9/5/2020,373,283,3,659
WASHINGTON,9/6/2020,373,284,3,660
WASHINGTON,9/7/2020,374,287,3,664
WASHINGTON,9/8/2020,374,287,3,664
WASHINGTON,9/9/2020,375,288,4,667
WASHINGTON,9/10/2020,375,289,4,668
WASHINGTON,9/11/2020,375,290,4,669
WASHINGTON,9/12/2020,375,290,4,669
WASHINGTON,9/13/2020,375,291,4,670
WASHINGTON,9/14/2020,377,291,4,672
WASHINGTON,9/15/2020,377,292,4,673
WASHINGTON,9/16/2020,377,293,4,674
WASHINGTON,9/17/2020,377,294,4,675
WASHINGTON,9/18/2020,377,295,4,676
WASHINGTON,9/19/2020,380,296,4,680
WASHINGTON,9/20/2020,381,297,4,682
WASHINGTON,9/21/2020,382,299,4,685
WASHINGTON,9/22/2020,384,300,4,688
WASHINGTON,9/23/2020,385,300,4,689
WASHINGTON,9/24/2020,386,300,4,690
WASHINGTON,9/25/2020,386,301,4,691
WASHINGTON,9/26/2020,387,302,4,693
WASHINGTON,9/27/2020,387,305,4,696
WASHINGTON,9/28/2020,389,305,4,698
WASHINGTON,9/29/2020,390,307,4,701
WASHINGTON,9/30/2020,391,309,4,704
WASHINGTON,10/1/2020,391,310,4,705
WASHINGTON,10/2/2020,391,311,4,706
WASHINGTON,10/3/2020,391,312,4,707
WASHINGTON,10/4/2020,391,312,4,707
WASHINGTON,10/5/2020,393,315,4,712
WASHINGTON,10/6/2020,394,316,4,714
WASHINGTON,10/7/2020,396,317,4,717
WASHINGTON,10/8/2020,397,317,4,718
WASHINGTON,10/9/2020,398,317,4,719
WASHINGTON,10/10/2020,399,317,4,720
WASHINGTON,10/11/2020,400,318,4,722
WASHINGTON,10/12/2020,400,318,4,722
WASHINGTON,10/13/2020,402,320,4,726
WASHINGTON,10/14/2020,402,320,4,726
WASHINGTON,10/15/2020,405,320,5,730
WASHINGTON,10/16/2020,406,320,5,731
WASHINGTON,10/17/2020,406,320,5,731
WASHINGTON,10/18/2020,406,320,5,731
WASHINGTON,10/19/2020,406,320,5,731
WASHINGTON,10/20/2020,406,320,5,731
WAYNE,1/1/2020,0,0,0,0
WAYNE,1/2/2020,0,0,0,0
WAYNE,1/3/2020,0,0,0,0
WAYNE,1/4/2020,0,0,0,0
WAYNE,1/5/2020,0,0,0,0
WAYNE,1/6/2020,0,0,0,0
WAYNE,1/7/2020,0,0,0,0
WAYNE,1/8/2020,0,0,0,0
WAYNE,1/9/2020,0,0,0,0
WAYNE,1/10/2020,0,0,0,0
WAYNE,1/11/2020,0,0,0,0
WAYNE,1/12/2020,0,0,0,0
WAYNE,1/13/2020,0,0,0,0
WAYNE,1/14/2020,0,0,0,0
WAYNE,1/15/2020,0,0,0,0
WAYNE,1/16/2020,0,0,0,0
WAYNE,1/17/2020,0,0,0,0
WAYNE,1/18/2020,0,0,0,0
WAYNE,1/19/2020,0,0,0,0
WAYNE,1/20/2020,0,0,0,0
WAYNE,1/21/2020,0,0,0,0
WAYNE,1/22/2020,0,0,0,0
WAYNE,1/23/2020,0,0,0,0
WAYNE,1/24/2020,0,0,0,0
WAYNE,1/25/2020,0,0,0,0
WAYNE,1/26/2020,0,0,0,0
WAYNE,1/27/2020,0,0,0,0
WAYNE,1/28/2020,0,0,0,0
WAYNE,1/29/2020,0,0,0,0
WAYNE,1/30/2020,0,0,0,0
WAYNE,1/31/2020,0,0,0,0
WAYNE,2/1/2020,0,0,0,0
WAYNE,2/2/2020,1,0,0,1
WAYNE,2/3/2020,1,0,0,1
WAYNE,2/4/2020,1,0,0,1
WAYNE,2/5/2020,1,0,0,1
WAYNE,2/6/2020,1,0,0,1
WAYNE,2/7/2020,1,0,0,1
WAYNE,2/8/2020,1,0,0,1
WAYNE,2/9/2020,1,0,0,1
WAYNE,2/10/2020,1,0,0,1
WAYNE,2/11/2020,1,0,0,1
WAYNE,2/12/2020,1,0,0,1
WAYNE,2/13/2020,1,0,0,1
WAYNE,2/14/2020,1,0,0,1
WAYNE,2/15/2020,1,0,0,1
WAYNE,2/16/2020,1,0,0,1
WAYNE,2/17/2020,1,0,0,1
WAYNE,2/18/2020,1,0,0,1
WAYNE,2/19/2020,1,0,0,1
WAYNE,2/20/2020,1,0,0,1
WAYNE,2/21/2020,1,0,0,1
WAYNE,2/22/2020,1,0,0,1
WAYNE,2/23/2020,1,0,0,1
WAYNE,2/24/2020,1,0,0,1
WAYNE,2/25/2020,1,0,0,1
WAYNE,2/26/2020,1,0,0,1
WAYNE,2/27/2020,1,0,0,1
WAYNE,2/28/2020,1,0,0,1
WAYNE,2/29/2020,1,1,0,2
WAYNE,3/1/2020,1,1,0,2
WAYNE,3/2/2020,1,1,0,2
WAYNE,3/3/2020,1,1,0,2
WAYNE,3/4/2020,1,1,0,2
WAYNE,3/5/2020,1,1,0,2
WAYNE,3/6/2020,1,1,0,2
WAYNE,3/7/2020,1,1,0,2
WAYNE,3/8/2020,1,1,0,2
WAYNE,3/9/2020,1,1,0,2
WAYNE,3/10/2020,1,1,0,2
WAYNE,3/11/2020,1,1,0,2
WAYNE,3/12/2020,1,1,0,2
WAYNE,3/13/2020,1,1,0,2
WAYNE,3/14/2020,1,1,0,2
WAYNE,3/15/2020,1,1,0,2
WAYNE,3/16/2020,1,1,0,2
WAYNE,3/17/2020,1,1,0,2
WAYNE,3/18/2020,1,1,0,2
WAYNE,3/19/2020,1,1,0,2
WAYNE,3/20/2020,1,1,0,2
WAYNE,3/21/2020,1,1,0,2
WAYNE,3/22/2020,1,1,0,2
WAYNE,3/23/2020,2,1,0,3
WAYNE,3/24/2020,3,1,0,4
WAYNE,3/25/2020,3,1,0,4
WAYNE,3/26/2020,4,1,0,5
WAYNE,3/27/2020,4,1,0,5
WAYNE,3/28/2020,4,1,0,5
WAYNE,3/29/2020,5,1,0,6
WAYNE,3/30/2020,5,1,0,6
WAYNE,3/31/2020,5,1,0,6
WAYNE,4/1/2020,5,1,0,6
WAYNE,4/2/2020,5,1,0,6
WAYNE,4/3/2020,5,2,0,7
WAYNE,4/4/2020,5,2,0,7
WAYNE,4/5/2020,5,2,0,7
WAYNE,4/6/2020,5,2,0,7
WAYNE,4/7/2020,5,2,0,7
WAYNE,4/8/2020,5,2,0,7
WAYNE,4/9/2020,5,2,0,7
WAYNE,4/10/2020,5,3,0,8
WAYNE,4/11/2020,5,3,0,8
WAYNE,4/12/2020,5,3,0,8
WAYNE,4/13/2020,6,3,0,9
WAYNE,4/14/2020,9,3,0,12
WAYNE,4/15/2020,9,3,0,12
WAYNE,4/16/2020,9,3,0,12
WAYNE,4/17/2020,10,3,0,13
WAYNE,4/18/2020,10,4,0,14
WAYNE,4/19/2020,10,4,0,14
WAYNE,4/20/2020,10,4,0,14
WAYNE,4/21/2020,11,4,0,15
WAYNE,4/22/2020,11,4,0,15
WAYNE,4/23/2020,11,4,0,15
WAYNE,4/24/2020,11,4,0,15
WAYNE,4/25/2020,11,4,0,15
WAYNE,4/26/2020,11,4,0,15
WAYNE,4/27/2020,12,4,0,16
WAYNE,4/28/2020,12,4,0,16
WAYNE,4/29/2020,12,4,0,16
WAYNE,4/30/2020,12,4,0,16
WAYNE,5/1/2020,12,4,0,16
WAYNE,5/2/2020,12,5,0,17
WAYNE,5/3/2020,12,5,0,17
WAYNE,5/4/2020,12,5,0,17
WAYNE,5/5/2020,12,5,0,17
WAYNE,5/6/2020,12,5,0,17
WAYNE,5/7/2020,12,5,0,17
WAYNE,5/8/2020,12,5,0,17
WAYNE,5/9/2020,12,5,0,17
WAYNE,5/10/2020,12,5,0,17
WAYNE,5/11/2020,12,5,0,17
WAYNE,5/12/2020,13,6,0,19
WAYNE,5/13/2020,13,6,0,19
WAYNE,5/14/2020,14,6,0,20
WAYNE,5/15/2020,14,6,0,20
WAYNE,5/16/2020,15,6,0,21
WAYNE,5/17/2020,15,6,0,21
WAYNE,5/18/2020,16,6,0,22
WAYNE,5/19/2020,16,6,0,22
WAYNE,5/20/2020,16,6,0,22
WAYNE,5/21/2020,16,6,0,22
WAYNE,5/22/2020,16,6,0,22
WAYNE,5/23/2020,16,6,0,22
WAYNE,5/24/2020,18,6,0,24
WAYNE,5/25/2020,18,6,0,24
WAYNE,5/26/2020,18,6,0,24
WAYNE,5/27/2020,19,6,0,25
WAYNE,5/28/2020,19,7,0,26
WAYNE,5/29/2020,20,7,0,27
WAYNE,5/30/2020,20,9,0,29
WAYNE,5/31/2020,21,9,0,30
WAYNE,6/1/2020,21,11,0,32
WAYNE,6/2/2020,22,13,0,35
WAYNE,6/3/2020,24,14,0,38
WAYNE,6/4/2020,26,16,0,42
WAYNE,6/5/2020,26,17,0,43
WAYNE,6/6/2020,26,17,0,43
WAYNE,6/7/2020,26,17,0,43
WAYNE,6/8/2020,26,17,0,43
WAYNE,6/9/2020,26,18,0,44
WAYNE,6/10/2020,27,18,0,45
WAYNE,6/11/2020,27,19,0,46
WAYNE,6/12/2020,29,22,0,51
WAYNE,6/13/2020,29,22,0,51
WAYNE,6/14/2020,29,22,0,51
WAYNE,6/15/2020,40,27,0,67
WAYNE,6/16/2020,42,30,0,72
WAYNE,6/17/2020,54,32,0,86
WAYNE,6/18/2020,57,32,0,89
WAYNE,6/19/2020,60,34,0,94
WAYNE,6/20/2020,61,35,0,96
WAYNE,6/21/2020,68,36,0,104
WAYNE,6/22/2020,72,38,0,110
WAYNE,6/23/2020,72,42,0,114
WAYNE,6/24/2020,77,47,0,124
WAYNE,6/25/2020,81,49,0,130
WAYNE,6/26/2020,83,50,0,133
WAYNE,6/27/2020,85,52,0,137
WAYNE,6/28/2020,87,52,0,139
WAYNE,6/29/2020,93,59,0,152
WAYNE,6/30/2020,98,60,0,158
WAYNE,7/1/2020,103,65,0,168
WAYNE,7/2/2020,109,68,0,177
WAYNE,7/3/2020,113,73,1,187
WAYNE,7/4/2020,116,77,1,194
WAYNE,7/5/2020,119,81,1,201
WAYNE,7/6/2020,125,95,1,221
WAYNE,7/7/2020,131,105,2,238
WAYNE,7/8/2020,137,114,6,257
WAYNE,7/9/2020,143,120,6,269
WAYNE,7/10/2020,148,132,6,286
WAYNE,7/11/2020,154,135,6,295
WAYNE,7/12/2020,160,138,6,304
WAYNE,7/13/2020,183,148,6,337
WAYNE,7/14/2020,189,174,6,369
WAYNE,7/15/2020,195,239,6,440
WAYNE,7/16/2020,200,306,6,512
WAYNE,7/17/2020,204,345,6,555
WAYNE,7/18/2020,211,347,7,565
WAYNE,7/19/2020,216,348,7,571
WAYNE,7/20/2020,221,360,7,588
WAYNE,7/21/2020,226,362,7,595
WAYNE,7/22/2020,232,368,7,607
WAYNE,7/23/2020,235,377,7,619
WAYNE,7/24/2020,239,380,7,626
WAYNE,7/25/2020,241,385,7,633
WAYNE,7/26/2020,243,386,7,636
WAYNE,7/27/2020,252,389,7,648
WAYNE,7/28/2020,260,393,8,661
WAYNE,7/29/2020,265,400,8,673
WAYNE,7/30/2020,287,412,9,708
WAYNE,7/31/2020,306,416,9,731
WAYNE,8/1/2020,324,422,10,756
WAYNE,8/2/2020,326,425,10,761
WAYNE,8/3/2020,337,434,10,781
WAYNE,8/4/2020,344,439,10,793
WAYNE,8/5/2020,348,442,10,800
WAYNE,8/6/2020,355,448,10,813
WAYNE,8/7/2020,370,452,10,832
WAYNE,8/8/2020,375,455,10,840
WAYNE,8/9/2020,378,456,10,844
WAYNE,8/10/2020,397,466,10,873
WAYNE,8/11/2020,406,468,10,884
WAYNE,8/12/2020,412,470,10,892
WAYNE,8/13/2020,415,474,10,899
WAYNE,8/14/2020,420,478,10,908
WAYNE,8/15/2020,423,480,10,913
WAYNE,8/16/2020,424,483,10,917
WAYNE,8/17/2020,428,484,10,922
WAYNE,8/18/2020,430,486,10,926
WAYNE,8/19/2020,439,489,10,938
WAYNE,8/20/2020,442,493,10,945
WAYNE,8/21/2020,444,494,10,948
WAYNE,8/22/2020,447,495,10,952
WAYNE,8/23/2020,447,497,10,954
WAYNE,8/24/2020,454,498,10,962
WAYNE,8/25/2020,458,499,10,967
WAYNE,8/26/2020,464,503,10,977
WAYNE,8/27/2020,468,508,10,986
WAYNE,8/28/2020,474,511,10,995
WAYNE,8/29/2020,476,512,10,998
WAYNE,8/30/2020,477,515,10,1002
WAYNE,8/31/2020,484,520,11,1015
WAYNE,9/1/2020,486,526,11,1023
WAYNE,9/2/2020,490,529,11,1030
WAYNE,9/3/2020,494,530,11,1035
WAYNE,9/4/2020,498,535,11,1044
WAYNE,9/5/2020,499,539,11,1049
WAYNE,9/6/2020,502,539,11,1052
WAYNE,9/7/2020,505,543,11,1059
WAYNE,9/8/2020,508,548,11,1067
WAYNE,9/9/2020,511,549,11,1071
WAYNE,9/10/2020,512,552,11,1075
WAYNE,9/11/2020,516,553,11,1080
WAYNE,9/12/2020,516,554,12,1082
WAYNE,9/13/2020,520,556,12,1088
WAYNE,9/14/2020,523,557,12,1092
WAYNE,9/15/2020,532,563,12,1107
WAYNE,9/16/2020,532,564,12,1108
WAYNE,9/17/2020,533,565,12,1110
WAYNE,9/18/2020,535,565,12,1112
WAYNE,9/19/2020,535,566,12,1113
WAYNE,9/20/2020,537,567,12,1116
WAYNE,9/21/2020,540,571,12,1123
WAYNE,9/22/2020,543,574,12,1129
WAYNE,9/23/2020,545,578,12,1135
WAYNE,9/24/2020,548,580,12,1140
WAYNE,9/25/2020,554,581,12,1147
WAYNE,9/26/2020,556,583,12,1151
WAYNE,9/27/2020,556,587,12,1155
WAYNE,9/28/2020,556,588,12,1156
WAYNE,9/29/2020,558,588,12,1158
WAYNE,9/30/2020,559,589,12,1160
WAYNE,10/1/2020,563,591,12,1166
WAYNE,10/2/2020,565,593,12,1170
WAYNE,10/3/2020,567,593,12,1172
WAYNE,10/4/2020,569,594,12,1175
WAYNE,10/5/2020,570,596,12,1178
WAYNE,10/6/2020,572,599,12,1183
WAYNE,10/7/2020,574,601,12,1187
WAYNE,10/8/2020,575,601,12,1188
WAYNE,10/9/2020,575,601,12,1188
WAYNE,10/10/2020,578,603,12,1193
WAYNE,10/11/2020,578,603,12,1193
WAYNE,10/12/2020,578,603,12,1193
WAYNE,10/13/2020,579,604,12,1195
WAYNE,10/14/2020,581,604,12,1197
WAYNE,10/15/2020,582,605,12,1199
WAYNE,10/16/2020,583,606,12,1201
WAYNE,10/17/2020,583,607,12,1202
WAYNE,10/18/2020,583,608,12,1203
WAYNE,10/19/2020,583,608,12,1203
WAYNE,10/20/2020,583,608,12,1203
MORGAN,3/18/2020,1,1,0,2
MORGAN,3/19/2020,2,1,0,3
MORGAN,3/20/2020,2,2,0,4
MORGAN,3/21/2020,2,2,0,4
MORGAN,3/22/2020,2,2,0,4
MORGAN,3/23/2020,3,2,0,5
MORGAN,3/24/2020,3,2,0,5
MORGAN,3/25/2020,3,2,0,5
MORGAN,3/26/2020,3,2,0,5
MORGAN,3/27/2020,4,3,0,7
MORGAN,3/28/2020,4,3,0,7
MORGAN,3/29/2020,4,3,0,7
MORGAN,3/30/2020,4,4,0,8
MORGAN,3/31/2020,4,4,0,8
MORGAN,4/1/2020,4,4,0,8
MORGAN,4/2/2020,5,4,0,9
MORGAN,4/3/2020,5,4,0,9
MORGAN,4/4/2020,5,4,0,9
MORGAN,4/5/2020,6,6,0,12
MORGAN,4/6/2020,7,6,0,13
MORGAN,4/7/2020,7,7,1,15
MORGAN,4/8/2020,7,7,1,15
MORGAN,4/9/2020,7,7,1,15
MORGAN,4/10/2020,7,7,1,15
MORGAN,4/11/2020,7,7,1,15
MORGAN,4/12/2020,7,7,1,15
MORGAN,4/13/2020,8,8,1,17
MORGAN,4/14/2020,8,8,1,17
MORGAN,4/15/2020,9,8,1,18
MORGAN,4/16/2020,10,10,1,21
MORGAN,4/17/2020,10,10,1,21
MORGAN,4/18/2020,10,10,1,21
MORGAN,4/19/2020,11,10,1,22
MORGAN,4/20/2020,11,10,1,22
MORGAN,4/21/2020,11,10,1,22
MORGAN,4/22/2020,13,10,2,25
MORGAN,4/23/2020,13,10,2,25
MORGAN,4/24/2020,14,10,2,26
MORGAN,4/25/2020,16,10,2,28
MORGAN,4/26/2020,16,10,2,28
MORGAN,4/27/2020,16,11,2,29
MORGAN,4/28/2020,16,11,2,29
MORGAN,4/29/2020,16,11,2,29
MORGAN,4/30/2020,17,11,2,30
MORGAN,5/1/2020,18,11,2,31
MORGAN,5/2/2020,19,13,2,34
MORGAN,5/3/2020,20,13,2,35
MORGAN,5/4/2020,20,13,2,35
MORGAN,5/5/2020,20,13,2,35
MORGAN,5/6/2020,20,13,2,35
MORGAN,5/7/2020,21,13,2,36
MORGAN,5/8/2020,21,14,2,37
MORGAN,5/9/2020,21,14,2,37
MORGAN,5/10/2020,21,14,2,37
MORGAN,5/11/2020,21,14,2,37
MORGAN,5/12/2020,21,14,2,37
MORGAN,5/13/2020,21,14,2,37
MORGAN,5/14/2020,21,14,2,37
MORGAN,5/15/2020,21,14,2,37
MORGAN,5/16/2020,21,14,2,37
MORGAN,5/17/2020,21,14,2,37
MORGAN,5/18/2020,22,15,2,39
MORGAN,5/19/2020,23,15,2,40
MORGAN,5/20/2020,23,15,2,40
MORGAN,5/21/2020,23,15,2,40
MORGAN,5/22/2020,23,15,2,40
MORGAN,5/23/2020,23,15,2,40
MORGAN,5/24/2020,23,15,2,40
MORGAN,5/25/2020,23,15,2,40
MORGAN,5/26/2020,23,15,2,40
MORGAN,5/27/2020,23,16,2,41
MORGAN,5/28/2020,24,16,2,42
MORGAN,5/29/2020,25,16,2,43
MORGAN,5/30/2020,25,16,2,43
MORGAN,5/31/2020,25,16,2,43
MORGAN,6/1/2020,25,16,2,43
MORGAN,6/2/2020,25,16,2,43
MORGAN,6/3/2020,25,16,2,43
MORGAN,6/4/2020,25,16,2,43
MORGAN,6/5/2020,25,16,2,43
MORGAN,6/6/2020,25,16,2,43
MORGAN,6/7/2020,25,16,2,43
MORGAN,6/8/2020,26,16,2,44
MORGAN,6/9/2020,26,19,2,47
MORGAN,6/10/2020,27,20,2,49
MORGAN,6/11/2020,27,20,2,49
MORGAN,6/12/2020,27,20,2,49
MORGAN,6/13/2020,27,20,2,49
MORGAN,6/14/2020,27,20,2,49
MORGAN,6/15/2020,27,20,2,49
MORGAN,6/16/2020,27,20,2,49
MORGAN,6/17/2020,27,20,2,49
MORGAN,6/18/2020,27,20,2,49
MORGAN,6/19/2020,27,20,2,49
MORGAN,6/20/2020,27,21,2,50
MORGAN,6/21/2020,27,22,2,51
MORGAN,6/22/2020,29,24,2,55
MORGAN,6/23/2020,29,26,2,57
MORGAN,6/24/2020,29,26,2,57
MORGAN,6/25/2020,29,27,2,58
MORGAN,6/26/2020,30,27,2,59
MORGAN,6/27/2020,30,28,2,60
MORGAN,6/28/2020,33,29,2,64
MORGAN,6/29/2020,35,29,2,66
MORGAN,6/30/2020,39,31,2,72
MORGAN,7/1/2020,42,35,2,79
MORGAN,7/2/2020,43,37,2,82
MORGAN,7/3/2020,44,38,2,84
MORGAN,7/4/2020,45,40,2,87
MORGAN,7/5/2020,45,41,2,88
MORGAN,7/6/2020,49,42,3,94
MORGAN,7/7/2020,50,43,3,96
MORGAN,7/8/2020,55,44,3,102
MORGAN,7/9/2020,60,50,3,113
MORGAN,7/10/2020,61,53,3,117
MORGAN,7/11/2020,66,55,3,124
MORGAN,7/12/2020,67,55,3,125
MORGAN,7/13/2020,73,57,3,133
MORGAN,7/14/2020,76,57,3,136
MORGAN,7/15/2020,82,61,3,146
MORGAN,7/16/2020,83,64,3,150
MORGAN,7/17/2020,84,70,3,157
MORGAN,7/18/2020,84,70,3,157
MORGAN,7/19/2020,85,73,3,161
MORGAN,7/20/2020,90,79,3,172
MORGAN,7/21/2020,96,88,3,187
MORGAN,7/22/2020,98,90,3,191
MORGAN,7/23/2020,105,95,3,203
MORGAN,7/24/2020,110,102,3,215
MORGAN,7/25/2020,112,107,3,222
MORGAN,7/26/2020,113,107,3,223
MORGAN,7/27/2020,121,110,3,234
MORGAN,7/28/2020,126,113,3,242
MORGAN,7/29/2020,133,117,3,253
MORGAN,7/30/2020,136,122,3,261
MORGAN,7/31/2020,142,125,3,270
MORGAN,8/1/2020,143,126,3,272
MORGAN,8/2/2020,147,126,3,276
MORGAN,8/3/2020,149,130,3,282
MORGAN,8/4/2020,151,133,3,287
MORGAN,8/5/2020,154,138,3,295
MORGAN,8/6/2020,157,140,3,300
MORGAN,8/7/2020,163,142,3,308
MORGAN,8/8/2020,166,144,3,313
MORGAN,8/9/2020,172,147,3,322
MORGAN,8/10/2020,181,156,3,340
MORGAN,8/11/2020,187,157,3,347
MORGAN,8/12/2020,192,161,3,356
MORGAN,8/13/2020,196,165,3,364
MORGAN,8/14/2020,198,169,3,370
MORGAN,8/15/2020,200,172,3,375
MORGAN,8/16/2020,202,176,4,382
MORGAN,8/17/2020,204,180,4,388
MORGAN,8/18/2020,207,181,4,392
MORGAN,8/19/2020,214,184,4,402
MORGAN,8/20/2020,217,186,4,407
MORGAN,8/21/2020,222,186,4,412
MORGAN,8/22/2020,224,187,4,415
MORGAN,8/23/2020,225,187,4,416
MORGAN,8/24/2020,229,189,4,422
MORGAN,8/25/2020,231,191,4,426
MORGAN,8/26/2020,232,193,4,429
MORGAN,8/27/2020,234,193,4,431
MORGAN,8/28/2020,235,196,4,435
MORGAN,8/29/2020,238,197,4,439
MORGAN,8/30/2020,239,197,4,440
MORGAN,8/31/2020,241,201,4,446
MORGAN,9/1/2020,246,202,4,452
MORGAN,9/2/2020,248,203,4,455
MORGAN,9/3/2020,249,203,4,456
MORGAN,9/4/2020,250,204,4,458
MORGAN,9/5/2020,250,205,4,459
MORGAN,9/6/2020,251,205,4,460
MORGAN,9/7/2020,252,205,4,461
MORGAN,9/8/2020,253,206,4,463
MORGAN,9/9/2020,254,206,4,464
MORGAN,9/10/2020,255,207,4,466
MORGAN,9/11/2020,256,208,4,468
MORGAN,9/12/2020,256,209,4,469
MORGAN,9/13/2020,257,210,4,471
MORGAN,9/14/2020,259,211,4,474
MORGAN,9/15/2020,260,214,4,478
MORGAN,9/16/2020,261,216,4,481
MORGAN,9/17/2020,262,217,4,483
MORGAN,9/18/2020,262,217,4,483
MORGAN,9/19/2020,262,217,4,483
MORGAN,9/20/2020,262,217,4,483
MORGAN,9/21/2020,262,217,4,483
MORGAN,9/22/2020,263,217,4,484
MORGAN,9/23/2020,263,219,4,486
MORGAN,9/24/2020,263,220,4,487
MORGAN,9/25/2020,264,221,4,489
MORGAN,9/26/2020,265,222,4,491
MORGAN,9/27/2020,265,222,4,491
MORGAN,9/28/2020,266,222,4,492
MORGAN,9/29/2020,266,223,4,493
MORGAN,9/30/2020,268,224,4,496
MORGAN,10/1/2020,268,224,4,496
MORGAN,10/2/2020,270,225,4,499
MORGAN,10/3/2020,271,225,4,500
MORGAN,10/4/2020,274,225,4,503
MORGAN,10/5/2020,275,226,4,505
MORGAN,10/6/2020,277,226,4,507
MORGAN,10/7/2020,277,228,4,509
MORGAN,10/8/2020,277,228,4,509
MORGAN,10/9/2020,277,229,4,510
MORGAN,10/10/2020,277,229,4,510
MORGAN,10/11/2020,278,230,4,512
MORGAN,10/12/2020,278,232,4,514
MORGAN,10/13/2020,278,232,4,514
MORGAN,10/14/2020,278,232,4,514
MORGAN,10/15/2020,279,233,4,516
MORGAN,10/16/2020,279,233,4,516
MORGAN,10/17/2020,279,233,4,516
MORGAN,10/18/2020,279,233,4,516
MORGAN,10/19/2020,279,233,4,516
MORGAN,10/20/2020,279,233,4,516
WASHINGTON,1/1/2020,0,0,0,0
WASHINGTON,1/2/2020,0,0,0,0
WASHINGTON,1/3/2020,0,0,0,0
WASHINGTON,1/4/2020,0,0,0,0
WASHINGTON,1/5/2020,0,0,0,0
WASHINGTON,1/6/2020,0,0,0,0
WASHINGTON,1/7/2020,0,0,0,0
WASHINGTON,1/8/2020,0,0,0,0
WASHINGTON,1/9/2020,0,0,0,0
WASHINGTON,1/10/2020,0,0,0,0
WASHINGTON,1/11/2020,0,0,0,0
WASHINGTON,1/12/2020,0,0,0,0
WASHINGTON,1/13/2020,0,0,0,0
WASHINGTON,1/14/2020,0,0,0,0
WASHINGTON,1/15/2020,0,0,0,0
WASHINGTON,1/16/2020,0,0,0,0
TERRELL,5/17/2020,136,63,5,204
WASHINGTON,1/17/2020,0,0,0,0
WASHINGTON,1/18/2020,0,0,0,0
WASHINGTON,1/19/2020,0,0,0,0
WASHINGTON,1/20/2020,0,0,0,0
WASHINGTON,1/21/2020,0,0,0,0
WASHINGTON,1/22/2020,0,0,0,0
WASHINGTON,1/23/2020,0,0,0,0
WASHINGTON,1/24/2020,0,0,0,0
WASHINGTON,1/25/2020,0,0,0,0
WASHINGTON,1/26/2020,0,0,0,0
WASHINGTON,1/27/2020,0,0,0,0
WASHINGTON,1/28/2020,0,0,0,0
WASHINGTON,1/29/2020,0,0,0,0
WASHINGTON,1/30/2020,0,0,0,0
WASHINGTON,1/31/2020,0,0,0,0
WASHINGTON,2/1/2020,0,0,0,0
WASHINGTON,2/2/2020,0,0,0,0
WASHINGTON,2/3/2020,0,0,0,0
WASHINGTON,2/4/2020,0,0,0,0
WASHINGTON,2/5/2020,0,0,0,0
WASHINGTON,2/6/2020,0,0,0,0
WASHINGTON,2/7/2020,0,0,0,0
WASHINGTON,2/8/2020,0,0,0,0
WASHINGTON,2/9/2020,0,0,0,0
WASHINGTON,2/10/2020,0,0,0,0
WASHINGTON,2/11/2020,0,0,0,0
WASHINGTON,2/12/2020,0,0,0,0
WASHINGTON,2/13/2020,0,0,0,0
WASHINGTON,2/14/2020,0,0,0,0
WASHINGTON,2/15/2020,0,0,0,0
WASHINGTON,2/16/2020,0,0,0,0
WASHINGTON,2/17/2020,0,0,0,0
WASHINGTON,2/18/2020,0,0,0,0
WASHINGTON,2/19/2020,0,0,0,0
WASHINGTON,2/20/2020,0,0,0,0
WASHINGTON,2/21/2020,0,0,0,0
WASHINGTON,2/22/2020,0,0,0,0
WASHINGTON,2/23/2020,0,0,0,0
WASHINGTON,2/24/2020,0,0,0,0
WASHINGTON,2/25/2020,0,0,0,0
WASHINGTON,2/26/2020,0,0,0,0
WASHINGTON,2/27/2020,0,0,0,0
WASHINGTON,2/28/2020,0,0,0,0
WASHINGTON,2/29/2020,0,0,0,0
WASHINGTON,3/1/2020,0,0,0,0
WASHINGTON,3/2/2020,0,0,0,0
WASHINGTON,3/3/2020,0,0,0,0
WASHINGTON,3/4/2020,0,0,0,0
WASHINGTON,3/5/2020,0,0,0,0
WASHINGTON,3/6/2020,0,0,0,0
WASHINGTON,3/7/2020,0,0,0,0
WASHINGTON,3/8/2020,0,0,0,0
WASHINGTON,3/9/2020,0,0,0,0
WASHINGTON,3/10/2020,0,0,0,0
WASHINGTON,3/11/2020,0,0,0,0
WASHINGTON,3/12/2020,0,0,0,0
WASHINGTON,3/13/2020,0,0,0,0
WASHINGTON,3/14/2020,0,0,0,0
WASHINGTON,3/15/2020,0,0,0,0
WASHINGTON,3/16/2020,1,1,0,2
WASHINGTON,3/17/2020,1,1,0,2
WASHINGTON,3/18/2020,1,1,0,2
WASHINGTON,3/19/2020,1,1,0,2
WASHINGTON,3/20/2020,2,1,0,3
WASHINGTON,3/21/2020,2,1,0,3
WASHINGTON,3/22/2020,2,1,0,3
WASHINGTON,3/23/2020,3,1,0,4
WASHINGTON,3/24/2020,3,1,0,4
WASHINGTON,3/25/2020,3,3,0,6
WASHINGTON,3/26/2020,3,3,0,6
WASHINGTON,3/27/2020,4,3,0,7
WASHINGTON,3/28/2020,4,4,0,8
WASHINGTON,3/29/2020,4,4,0,8
WASHINGTON,3/30/2020,5,4,0,9
WASHINGTON,3/31/2020,7,4,0,11
WASHINGTON,4/1/2020,7,4,0,11
WASHINGTON,4/2/2020,10,6,0,16
WASHINGTON,4/3/2020,11,6,0,17
WASHINGTON,4/4/2020,13,6,0,19
WASHINGTON,4/5/2020,15,6,0,21
WASHINGTON,4/6/2020,18,7,0,25
WASHINGTON,4/7/2020,20,7,0,27
WASHINGTON,4/8/2020,20,7,0,27
WASHINGTON,4/9/2020,21,7,0,28
WASHINGTON,4/10/2020,21,7,0,28
WASHINGTON,4/11/2020,22,8,0,30
WASHINGTON,4/12/2020,22,8,0,30
WASHINGTON,4/13/2020,24,8,0,32
WASHINGTON,4/14/2020,25,8,0,33
WASHINGTON,4/15/2020,25,9,0,34
WASHINGTON,4/16/2020,25,9,0,34
WASHINGTON,4/17/2020,26,9,0,35
WASHINGTON,4/18/2020,27,9,0,36
WASHINGTON,4/19/2020,28,9,0,37
WASHINGTON,4/20/2020,30,10,0,40
WASHINGTON,4/21/2020,33,10,0,43
WASHINGTON,4/22/2020,36,11,0,47
WASHINGTON,4/23/2020,36,11,0,47
WASHINGTON,4/24/2020,36,11,0,47
WASHINGTON,4/25/2020,37,11,0,48
WASHINGTON,4/26/2020,37,11,0,48
WASHINGTON,4/27/2020,39,13,0,52
WASHINGTON,4/28/2020,39,13,0,52
WASHINGTON,4/29/2020,40,13,0,53
WASHINGTON,4/30/2020,40,13,0,53
WASHINGTON,5/1/2020,41,14,0,55
WASHINGTON,5/2/2020,43,16,0,59
WASHINGTON,5/3/2020,43,16,0,59
WASHINGTON,5/4/2020,46,16,0,62
WASHINGTON,5/5/2020,47,16,0,63
WASHINGTON,5/6/2020,47,16,0,63
WASHINGTON,5/7/2020,47,16,0,63
WASHINGTON,5/8/2020,52,16,0,68
WASHINGTON,5/9/2020,52,16,0,68
WASHINGTON,5/10/2020,53,17,0,70
WASHINGTON,5/11/2020,54,18,0,72
WASHINGTON,5/12/2020,54,18,0,72
WASHINGTON,5/13/2020,54,19,0,73
WASHINGTON,5/14/2020,54,19,0,73
WASHINGTON,5/15/2020,54,19,0,73
WASHINGTON,5/16/2020,54,19,0,73
WASHINGTON,5/17/2020,54,19,0,73
WASHINGTON,5/18/2020,54,20,0,74
WASHINGTON,5/19/2020,54,20,0,74
WASHINGTON,5/20/2020,54,20,0,74
WASHINGTON,5/21/2020,54,20,0,74
WASHINGTON,5/22/2020,54,20,0,74
WASHINGTON,5/23/2020,54,20,0,74
WASHINGTON,5/24/2020,54,20,0,74
WASHINGTON,5/25/2020,55,20,0,75
WASHINGTON,5/26/2020,55,20,0,75
WASHINGTON,5/27/2020,55,20,0,75
WASHINGTON,5/28/2020,55,20,0,75
WASHINGTON,5/29/2020,55,20,0,75
WASHINGTON,5/30/2020,55,20,0,75
WASHINGTON,5/31/2020,55,20,0,75
WASHINGTON,6/1/2020,55,20,0,75
WASHINGTON,6/2/2020,55,20,0,75
WASHINGTON,6/3/2020,55,20,0,75
WASHINGTON,6/4/2020,55,20,0,75
WASHINGTON,6/5/2020,55,20,0,75
WASHINGTON,6/6/2020,56,20,0,76
WASHINGTON,6/7/2020,56,20,0,76
WASHINGTON,6/8/2020,56,20,0,76
WASHINGTON,6/9/2020,56,20,0,76
WASHINGTON,6/10/2020,57,20,0,77
WASHINGTON,6/11/2020,57,20,0,77
WASHINGTON,6/12/2020,57,21,0,78
WASHINGTON,6/13/2020,58,21,0,79
WASHINGTON,6/14/2020,58,21,0,79
WASHINGTON,6/15/2020,60,22,0,82
WASHINGTON,6/16/2020,61,22,0,83
WASHINGTON,6/17/2020,62,22,0,84
WASHINGTON,6/18/2020,65,26,0,91
WASHINGTON,6/19/2020,66,27,0,93
WASHINGTON,6/20/2020,67,27,0,94
WASHINGTON,6/21/2020,67,29,0,96
WASHINGTON,6/22/2020,70,33,0,103
WASHINGTON,6/23/2020,72,35,0,107
WASHINGTON,6/24/2020,75,36,0,111
WASHINGTON,6/25/2020,77,36,0,113
WASHINGTON,6/26/2020,82,37,0,119
WASHINGTON,6/27/2020,87,39,0,126
WASHINGTON,6/28/2020,91,41,0,132
WASHINGTON,6/29/2020,97,48,0,145
TERRELL,5/18/2020,136,63,5,204
TERRELL,5/19/2020,136,64,5,205
TERRELL,5/20/2020,137,65,5,207
TERRELL,5/21/2020,137,65,5,207
TERRELL,5/22/2020,137,66,5,208
TERRELL,5/23/2020,137,67,5,209
TERRELL,5/24/2020,137,67,5,209
TERRELL,5/25/2020,137,67,5,209
TERRELL,5/26/2020,138,68,5,211
TERRELL,5/27/2020,138,68,5,211
TERRELL,5/28/2020,138,69,5,212
TERRELL,5/29/2020,138,69,5,212
TERRELL,5/30/2020,140,69,5,214
TERRELL,5/31/2020,140,70,5,215
TERRELL,6/1/2020,140,70,5,215
TERRELL,6/2/2020,140,70,5,215
TERRELL,6/3/2020,140,70,5,215
TERRELL,6/4/2020,140,70,5,215
TERRELL,6/5/2020,140,70,5,215
TERRELL,6/6/2020,140,70,5,215
TERRELL,6/7/2020,140,70,5,215
TERRELL,6/8/2020,141,70,5,216
TERRELL,6/9/2020,141,70,5,216
TERRELL,6/10/2020,141,70,5,216
TERRELL,6/11/2020,143,70,5,218
TERRELL,6/12/2020,143,70,5,218
TERRELL,6/13/2020,144,70,5,219
TERRELL,6/14/2020,144,71,5,220
TERRELL,6/15/2020,144,71,5,220
TERRELL,6/16/2020,144,72,5,221
TERRELL,6/17/2020,144,72,5,221
TERRELL,6/18/2020,144,72,5,221
TERRELL,6/19/2020,145,72,5,222
TERRELL,6/20/2020,145,72,5,222
TERRELL,6/21/2020,145,72,5,222
TERRELL,6/22/2020,145,72,5,222
TERRELL,6/23/2020,146,73,5,224
TERRELL,6/24/2020,147,74,5,226
TERRELL,6/25/2020,147,75,5,227
TERRELL,6/26/2020,148,75,5,228
TERRELL,6/27/2020,148,77,5,230
TERRELL,6/28/2020,148,78,5,231
TERRELL,6/29/2020,151,79,5,235
TERRELL,6/30/2020,152,79,5,236
TERRELL,7/1/2020,152,79,5,236
TERRELL,7/2/2020,155,85,5,245
TERRELL,7/3/2020,155,86,5,246
TERRELL,7/4/2020,156,88,5,249
TERRELL,7/5/2020,157,90,5,252
TERRELL,7/6/2020,159,90,5,254
TERRELL,7/7/2020,160,93,5,258
TERRELL,7/8/2020,161,94,5,260
TERRELL,7/9/2020,162,95,5,262
TERRELL,7/10/2020,163,95,5,263
TERRELL,7/11/2020,163,95,5,263
TERRELL,7/12/2020,163,96,5,264
TERRELL,7/13/2020,165,96,5,266
TERRELL,7/14/2020,166,97,5,268
TERRELL,7/15/2020,166,99,5,270
TERRELL,7/16/2020,167,99,5,271
TERRELL,7/17/2020,168,99,5,272
TERRELL,7/18/2020,168,99,5,272
TERRELL,7/19/2020,168,99,5,272
TERRELL,7/20/2020,168,100,5,273
TERRELL,7/21/2020,169,101,5,275
TERRELL,7/22/2020,171,101,5,277
TERRELL,7/23/2020,173,103,5,281
TERRELL,7/24/2020,174,104,5,283
TERRELL,7/25/2020,174,105,5,284
TERRELL,7/26/2020,175,106,5,286
TERRELL,7/27/2020,175,107,5,287
TERRELL,7/28/2020,177,108,5,290
TERRELL,7/29/2020,177,108,5,290
TERRELL,7/30/2020,178,110,5,293
TERRELL,7/31/2020,178,110,5,293
TERRELL,8/1/2020,180,110,5,295
TERRELL,8/2/2020,181,111,5,297
TERRELL,8/3/2020,182,113,5,300
TERRELL,8/4/2020,183,113,5,301
TERRELL,8/5/2020,183,113,5,301
TERRELL,8/6/2020,185,113,5,303
TERRELL,8/7/2020,186,115,5,306
TERRELL,8/8/2020,187,115,5,307
TERRELL,8/9/2020,188,115,5,308
TERRELL,8/10/2020,189,116,5,310
TERRELL,8/11/2020,189,117,5,311
TERRELL,8/12/2020,189,119,5,313
TERRELL,8/13/2020,190,119,5,314
TERRELL,8/14/2020,190,119,5,314
TERRELL,8/15/2020,190,119,5,314
TERRELL,8/16/2020,190,120,5,315
TERRELL,8/17/2020,190,120,5,315
TERRELL,8/18/2020,190,120,5,315
TERRELL,8/19/2020,190,121,5,316
TERRELL,8/20/2020,190,122,5,317
TERRELL,8/21/2020,191,123,5,319
TERRELL,8/22/2020,191,123,5,319
TERRELL,8/23/2020,191,125,5,321
TERRELL,8/24/2020,192,126,5,323
TERRELL,8/25/2020,193,126,5,324
TERRELL,8/26/2020,194,126,5,325
TERRELL,8/27/2020,196,126,5,327
TERRELL,8/28/2020,196,126,5,327
TERRELL,8/29/2020,196,126,5,327
TERRELL,8/30/2020,196,126,5,327
TERRELL,8/31/2020,196,127,5,328
TERRELL,9/1/2020,196,128,5,329
TERRELL,9/2/2020,196,129,5,330
TERRELL,9/3/2020,196,129,5,330
TERRELL,9/4/2020,196,129,5,330
TERRELL,9/5/2020,196,129,5,330
TERRELL,9/6/2020,196,129,5,330
TERRELL,9/7/2020,196,129,5,330
TERRELL,9/8/2020,196,129,5,330
TERRELL,9/9/2020,196,130,5,331
TERRELL,9/10/2020,197,130,5,332
TERRELL,9/11/2020,197,130,5,332
TERRELL,9/12/2020,197,130,5,332
TERRELL,9/13/2020,197,130,5,332
TERRELL,9/14/2020,197,130,5,332
TERRELL,9/15/2020,197,130,5,332
TERRELL,9/16/2020,197,130,5,332
TERRELL,9/17/2020,197,131,5,333
TERRELL,9/18/2020,197,131,5,333
TERRELL,9/19/2020,197,131,5,333
TERRELL,9/20/2020,197,131,5,333
TERRELL,9/21/2020,197,131,5,333
TERRELL,9/22/2020,198,131,5,334
TERRELL,9/23/2020,198,131,5,334
TERRELL,9/24/2020,198,131,5,334
TERRELL,9/25/2020,199,131,5,335
TERRELL,9/26/2020,199,131,5,335
TERRELL,9/27/2020,199,131,5,335
TERRELL,9/28/2020,199,131,5,335
TERRELL,9/29/2020,199,131,5,335
TERRELL,9/30/2020,199,131,5,335
TERRELL,10/1/2020,199,131,5,335
TERRELL,10/2/2020,199,131,5,335
TERRELL,10/3/2020,199,131,5,335
TERRELL,10/4/2020,199,131,5,335
TERRELL,10/5/2020,199,131,5,335
TERRELL,10/6/2020,199,131,5,335
TERRELL,10/7/2020,199,131,5,335
TERRELL,10/8/2020,199,131,5,335
TERRELL,10/9/2020,199,131,5,335
TERRELL,10/10/2020,199,131,5,335
TERRELL,10/11/2020,199,131,5,335
TERRELL,10/12/2020,199,131,5,335
TERRELL,10/13/2020,199,131,5,335
TERRELL,10/14/2020,201,131,5,337
TERRELL,10/15/2020,201,131,5,337
TERRELL,10/16/2020,202,131,5,338
TERRELL,10/17/2020,202,131,5,338
TERRELL,10/18/2020,202,131,5,338
TERRELL,10/19/2020,202,131,5,338
TERRELL,10/20/2020,202,131,5,338
WALKER,1/1/2020,0,0,0,0
WALKER,1/2/2020,0,0,0,0
WALKER,1/3/2020,0,0,0,0
WALKER,1/4/2020,0,0,0,0
WALKER,1/5/2020,0,0,0,0
WALKER,1/6/2020,0,0,0,0
WALKER,1/7/2020,0,0,0,0
WALKER,1/8/2020,0,0,0,0
WALKER,1/9/2020,0,0,0,0
WALKER,1/10/2020,0,0,0,0
WALKER,1/11/2020,0,0,0,0
WALKER,1/12/2020,0,0,0,0
WALKER,1/13/2020,0,0,0,0
WALKER,1/14/2020,0,0,0,0
WALKER,1/15/2020,0,0,0,0
WALKER,1/16/2020,0,0,0,0
WALKER,1/17/2020,0,0,0,0
WALKER,1/18/2020,0,0,0,0
WALKER,1/19/2020,0,0,0,0
WALKER,1/20/2020,0,0,0,0
WALKER,1/21/2020,0,0,0,0
WALKER,1/22/2020,0,0,0,0
WALKER,1/23/2020,0,0,0,0
WALKER,1/24/2020,0,0,0,0
WALKER,1/25/2020,0,0,0,0
WALKER,1/26/2020,0,0,0,0
WALKER,1/27/2020,0,0,0,0
WALKER,1/28/2020,0,0,0,0
WALKER,1/29/2020,0,0,0,0
WALKER,1/30/2020,0,0,0,0
WALKER,1/31/2020,0,0,0,0
WALKER,2/1/2020,0,0,0,0
WALKER,2/2/2020,1,0,0,1
WALKER,2/3/2020,1,0,0,1
WALKER,2/4/2020,1,0,0,1
WALKER,2/5/2020,1,0,0,1
WALKER,2/6/2020,1,0,0,1
WALKER,2/7/2020,1,0,0,1
WALKER,2/8/2020,1,0,0,1
WALKER,2/9/2020,1,0,0,1
WALKER,2/10/2020,1,0,0,1
WALKER,2/11/2020,1,0,0,1
WALKER,2/12/2020,1,0,0,1
WALKER,2/13/2020,1,0,0,1
WALKER,2/14/2020,1,0,0,1
WALKER,2/15/2020,1,0,0,1
WALKER,2/16/2020,1,0,0,1
WALKER,2/17/2020,1,0,0,1
WALKER,2/18/2020,1,0,0,1
WALKER,2/19/2020,1,0,0,1
WALKER,2/20/2020,1,0,0,1
WALKER,2/21/2020,1,0,0,1
WALKER,2/22/2020,1,0,0,1
WALKER,2/23/2020,1,0,0,1
WALKER,2/24/2020,1,0,0,1
WALKER,2/25/2020,1,0,0,1
WALKER,2/26/2020,1,0,0,1
WALKER,2/27/2020,1,0,0,1
WALKER,2/28/2020,1,0,0,1
WALKER,2/29/2020,1,1,0,2
WALKER,3/1/2020,1,1,0,2
WALKER,3/2/2020,1,1,0,2
WALKER,3/3/2020,1,1,0,2
WALKER,3/4/2020,1,1,0,2
WALKER,3/5/2020,1,1,0,2
WALKER,3/6/2020,1,1,0,2
WALKER,3/7/2020,1,1,0,2
WALKER,3/8/2020,1,1,0,2
WALKER,3/9/2020,1,1,0,2
WALKER,3/10/2020,1,1,0,2
WALKER,3/11/2020,1,1,0,2
WALKER,3/12/2020,1,1,0,2
WALKER,3/13/2020,1,2,0,3
WALKER,3/14/2020,1,3,0,4
WALKER,3/15/2020,1,4,0,5
WALKER,3/16/2020,1,4,0,5
WALKER,3/17/2020,1,4,0,5
WALKER,3/18/2020,1,4,0,5
WALKER,3/19/2020,1,4,0,5
WALKER,3/20/2020,1,4,0,5
WALKER,3/21/2020,1,4,0,5
WALKER,3/22/2020,1,4,0,5
WALKER,3/23/2020,1,4,0,5
WALKER,3/24/2020,1,4,0,5
WALKER,3/25/2020,2,4,0,6
WALKER,3/26/2020,3,5,0,8
WALKER,3/27/2020,3,6,0,9
WALKER,3/28/2020,3,6,0,9
WALKER,3/29/2020,4,6,0,10
WALKER,3/30/2020,4,6,0,10
WALKER,3/31/2020,4,6,0,10
WALKER,4/1/2020,5,6,0,11
WALKER,4/2/2020,5,6,0,11
WALKER,4/3/2020,5,6,0,11
WALKER,4/4/2020,5,6,0,11
WALKER,4/5/2020,5,6,0,11
WALKER,4/6/2020,5,7,0,12
WALKER,4/7/2020,7,7,0,14
WALKER,4/8/2020,7,7,0,14
WALKER,4/9/2020,7,8,0,15
WALKER,4/10/2020,8,11,0,19
WALKER,4/11/2020,8,11,0,19
WALKER,4/12/2020,9,11,0,20
WALKER,4/13/2020,9,11,0,20
WALKER,4/14/2020,10,11,0,21
WALKER,4/15/2020,11,11,0,22
WALKER,4/16/2020,11,11,0,22
WALKER,4/17/2020,16,14,0,30
WALKER,4/18/2020,16,14,0,30
WALKER,4/19/2020,16,14,0,30
WALKER,4/20/2020,16,14,0,30
WALKER,4/21/2020,27,23,0,50
WALKER,4/22/2020,28,24,0,52
WALKER,4/23/2020,29,24,0,53
WALKER,4/24/2020,30,24,0,54
WALKER,4/25/2020,31,24,0,55
WALKER,4/26/2020,31,24,0,55
WALKER,4/27/2020,31,24,0,55
WALKER,4/28/2020,31,25,0,56
WALKER,4/29/2020,31,25,0,56
WALKER,4/30/2020,31,25,0,56
WALKER,5/1/2020,32,28,0,60
WALKER,5/2/2020,32,28,0,60
WALKER,5/3/2020,33,29,0,62
WALKER,5/4/2020,33,30,0,63
WALKER,5/5/2020,35,31,0,66
WALKER,5/6/2020,38,32,0,70
WALKER,5/7/2020,38,33,0,71
WALKER,5/8/2020,38,33,0,71
WALKER,5/9/2020,38,35,0,73
WALKER,5/10/2020,38,35,0,73
WALKER,5/11/2020,40,35,0,75
WALKER,5/12/2020,40,35,1,76
WALKER,5/13/2020,41,37,1,79
WALKER,5/14/2020,41,38,1,80
WALKER,5/15/2020,44,43,1,88
WALKER,5/16/2020,46,47,1,94
WALKER,5/17/2020,48,48,1,97
WALKER,5/18/2020,48,50,1,99
WALKER,5/19/2020,49,50,1,100
WALKER,5/20/2020,52,51,1,104
WALKER,5/21/2020,54,52,1,107
WALKER,5/22/2020,56,53,1,110
WALKER,5/23/2020,58,53,1,112
WALKER,5/24/2020,59,55,1,115
WALKER,5/25/2020,62,56,1,119
WALKER,5/26/2020,65,59,1,125
WALKER,5/27/2020,79,66,1,146
WALKER,5/28/2020,82,67,1,150
WALKER,5/29/2020,90,69,1,160
WALKER,5/30/2020,91,74,1,166
WALKER,5/31/2020,96,76,1,173
WALKER,6/1/2020,104,77,1,182
WALKER,6/2/2020,106,80,1,187
WALKER,6/3/2020,109,83,1,193
WALKER,6/4/2020,111,85,1,197
WALKER,6/5/2020,118,88,1,207
WALKER,6/6/2020,120,91,1,212
WALKER,6/7/2020,122,97,1,220
WALKER,6/8/2020,128,106,1,235
WALKER,6/9/2020,130,108,1,239
WALKER,6/10/2020,136,110,1,247
WALKER,6/11/2020,140,113,1,254
WALKER,6/12/2020,144,115,1,260
WALKER,6/13/2020,145,118,1,264
WALKER,6/14/2020,148,119,1,268
WALKER,6/15/2020,154,122,1,277
WALKER,6/16/2020,164,124,1,289
WALKER,6/17/2020,168,125,1,294
WALKER,6/18/2020,171,128,1,300
WALKER,6/19/2020,172,128,1,301
WALKER,6/20/2020,173,130,1,304
WALKER,6/21/2020,176,130,1,307
WALKER,6/22/2020,183,134,1,318
WALKER,6/23/2020,184,134,1,319
WALKER,6/24/2020,188,136,1,325
WALKER,6/25/2020,193,140,1,334
WALKER,6/26/2020,194,143,1,338
WALKER,6/27/2020,195,149,1,345
WALKER,6/28/2020,197,150,2,349
WALKER,6/29/2020,202,153,2,357
WALKER,6/30/2020,206,156,2,364
WALKER,7/1/2020,208,164,2,374
WALKER,7/2/2020,220,170,4,394
WALKER,7/3/2020,223,172,5,400
WALKER,7/4/2020,223,172,5,400
WALKER,7/5/2020,225,174,5,404
WALKER,7/6/2020,228,184,5,417
WALKER,7/7/2020,239,187,5,431
WALKER,7/8/2020,245,195,5,445
WALKER,7/9/2020,252,197,5,454
WALKER,7/10/2020,256,199,5,460
WALKER,7/11/2020,257,203,5,465
WALKER,7/12/2020,259,205,5,469
WALKER,7/13/2020,269,215,7,491
WALKER,7/14/2020,280,222,7,509
WALKER,7/15/2020,284,227,7,518
WALKER,7/16/2020,291,236,8,535
WALKER,7/17/2020,301,241,8,550
WALKER,7/18/2020,303,247,8,558
WALKER,7/19/2020,308,248,8,564
WALKER,7/20/2020,318,257,9,584
WALKER,7/21/2020,327,265,9,601
WALKER,7/22/2020,335,271,10,616
WALKER,7/23/2020,340,280,10,630
WALKER,7/24/2020,350,289,11,650
WALKER,7/25/2020,354,292,11,657
WALKER,7/26/2020,360,297,11,668
WALKER,7/27/2020,370,299,11,680
WALKER,7/28/2020,378,307,11,696
WALKER,7/29/2020,383,319,11,713
WALKER,7/30/2020,389,323,11,723
WALKER,7/31/2020,394,325,11,730
WALKER,8/1/2020,398,329,11,738
WALKER,8/2/2020,401,331,11,743
WALKER,8/3/2020,412,341,12,765
WALKER,8/4/2020,416,348,13,777
WALKER,8/5/2020,425,359,15,799
WALKER,8/6/2020,430,367,16,813
WALKER,8/7/2020,440,375,16,831
WALKER,8/8/2020,442,383,16,841
WALKER,8/9/2020,447,387,17,851
WALKER,8/10/2020,458,390,17,865
WALKER,8/11/2020,462,400,17,879
WALKER,8/12/2020,467,408,18,893
WALKER,8/13/2020,478,419,18,915
WALKER,8/14/2020,483,427,18,928
WALKER,8/15/2020,487,428,18,933
WALKER,8/16/2020,489,430,18,937
WALKER,8/17/2020,497,439,18,954
WALKER,8/18/2020,501,447,18,966
WALKER,8/19/2020,509,454,18,981
WALKER,8/20/2020,522,463,18,1003
WALKER,8/21/2020,533,470,18,1021
WALKER,8/22/2020,536,474,18,1028
WALKER,8/23/2020,540,482,18,1040
WALKER,8/24/2020,551,497,19,1067
WALKER,8/25/2020,558,516,19,1093
WALKER,8/26/2020,564,550,19,1133
WALKER,8/27/2020,574,560,20,1154
WALKER,8/28/2020,577,573,20,1170
WALKER,8/29/2020,583,576,20,1179
WALKER,8/30/2020,588,585,20,1193
WALKER,8/31/2020,605,590,21,1216
WALKER,9/1/2020,615,602,22,1239
WALKER,9/2/2020,630,610,22,1262
WALKER,9/3/2020,646,618,22,1286
WALKER,9/4/2020,655,629,23,1307
WALKER,9/5/2020,659,633,23,1315